Zip,Total Households:,Family households:,Family households: - Householder 15 to 34 years,Family households: - Householder 35 to 54 years,Family households: - Householder 55 to 74 years,Family households: - Householder 75 years or older,Family households:- Married-couple with own children under 18 years,Family households:- Married-couple without own children under 18 years,Family households:- Other with own children under 18 years,Family households:- Other without own children under 18 years,Nonfamily households:,Nonfamily households: - Householder 15 to 34 years,Nonfamily households: - Householder 35 to 54 years,Nonfamily households: - Householder 55 to 74 years,Nonfamily households: - Householder 75 years or older,Nonfamily households:- 1-person household,Nonfamily households:- 2-or-more persons household
601,5915,4964,1085,2290,1189,400,2193,1534,557,680,951,47,163,481,260,916,35
602,13529,11336,2656,5368,2661,651,5074,3676,1217,1369,2193,204,732,833,424,2101,92
603,19153,14890,3463,6032,4244,1151,4670,5348,2239,2633,4263,482,1281,1721,779,4036,227
604,1091,890,151,550,156,33,428,283,98,81,201,58,67,50,26,172,29
606,2015,1648,385,778,355,130,667,534,220,227,367,33,107,150,77,347,20
610,9266,7482,1565,3353,2058,506,2649,2659,918,1256,1784,121,504,799,360,1662,122
612,25342,19934,4426,7960,5816,1732,6206,7530,2623,3575,5408,521,1474,2327,1086,5037,371
616,3569,2878,540,1261,856,221,898,1176,311,493,691,48,243,283,117,648,43
617,7805,6354,1822,2549,1599,384,2129,2201,912,1112,1451,128,400,638,285,1344,107
622,3143,2285,369,937,815,164,713,1114,174,284,858,157,212,341,148,822,36
623,14011,10846,2668,4119,3127,932,3453,4429,1287,1677,3165,342,902,1308,613,2870,295
624,7731,6610,1609,3093,1474,434,2880,2020,893,817,1121,118,301,522,180,1066,55
627,11457,9608,2610,3998,2296,704,3750,3481,1146,1231,1849,202,499,741,407,1744,105
631,712,554,92,223,192,47,216,220,37,81,158,5,57,74,22,158,0
637,8878,7029,1698,2940,1814,577,2467,2620,904,1038,1849,142,503,777,427,1736,113
638,6021,5016,1210,2174,1305,327,2063,1571,665,717,1005,49,311,451,194,965,40
641,11093,9074,1858,4074,2392,750,3352,3178,1105,1439,2019,185,509,859,466,1888,131
646,10913,9142,1967,4212,2451,512,3237,3288,1189,1428,1771,237,500,750,284,1627,144
647,1861,1444,207,560,478,199,391,606,160,287,417,5,107,243,62,397,20
650,3946,3371,772,1516,809,274,1271,1145,412,543,575,87,154,279,55,552,23
652,1062,838,166,371,268,33,305,340,57,136,224,10,85,81,48,215,9
653,5413,4304,1207,1740,1044,313,1480,1555,582,687,1109,69,378,516,146,1025,84
656,7187,6031,1284,2648,1630,469,2305,1963,720,1043,1156,64,370,479,243,1101,55
659,12693,10646,2526,4466,2870,784,4036,3810,1264,1536,2047,218,575,869,385,1903,144
660,5817,4731,983,1828,1546,374,1482,2050,424,775,1086,79,285,546,176,1033,53
662,14297,11602,2726,4870,3056,950,4190,4216,1330,1866,2695,313,659,1106,617,2528,167
664,5077,4260,1128,2005,832,295,1816,1287,627,530,817,51,266,345,155,786,31
667,9156,7372,1638,3037,2062,635,2362,2916,901,1193,1784,162,564,750,308,1666,118
669,10288,8664,2003,3813,2122,726,3555,2960,911,1238,1624,152,388,714,370,1550,74
670,3623,2974,647,1359,794,174,1060,1084,397,433,649,43,185,277,144,620,29
674,15442,12576,2823,5461,3496,796,4166,4480,1808,2122,2866,255,892,1184,535,2755,111
676,12743,10790,2987,4715,2398,690,4797,3544,1119,1330,1953,220,663,704,366,1838,115
677,5150,4056,800,1716,1185,355,1400,1665,416,575,1094,122,258,554,160,1010,84
678,8838,7342,1756,3179,1967,440,3010,2543,801,988,1496,120,369,638,369,1424,72
680,26549,19252,3773,8213,5593,1673,5803,7711,2276,3462,7297,2158,1308,2462,1369,5735,1562
682,8816,6571,1236,2641,2212,482,1487,2339,1210,1535,2245,292,644,972,337,1905,340
683,12130,9373,1666,4068,2783,856,3023,3598,1134,1618,2757,267,731,1105,654,2615,142
685,15084,12431,2530,5320,3556,1025,4514,4901,1231,1785,2653,229,533,1164,727,2492,161
687,8793,7650,2145,3316,1788,401,3355,2395,1027,873,1143,99,303,477,264,1104,39
688,4129,3486,852,1513,913,208,1210,1311,446,519,643,124,132,274,113,623,20
690,1839,1514,285,729,375,125,544,469,233,268,325,30,131,138,26,298,27
692,10991,9225,2221,4066,2441,497,3482,2964,1342,1437,1766,120,462,813,371,1662,104
693,20502,17080,3716,7578,4693,1093,5949,5959,2271,2901,3422,317,1035,1402,668,3120,302
698,15028,12411,2689,5551,3133,1038,4579,4064,1599,2169,2617,192,727,1139,559,2513,104
703,9123,7627,1719,3456,2009,443,2941,2670,888,1128,1496,146,411,662,277,1412,84
704,2452,2019,588,811,505,115,718,606,341,354,433,53,145,135,100,421,12
705,8415,7021,1425,3293,1735,568,2772,2345,866,1038,1394,113,309,594,378,1358,36
707,4011,3310,702,1448,863,297,1145,1114,479,572,701,52,156,320,173,664,37
714,6160,5042,1117,2284,1312,329,1673,1624,913,832,1118,56,335,467,260,1049,69
715,820,555,112,249,134,60,200,176,67,112,265,15,61,140,49,265,0
716,12597,10313,2129,4394,3024,766,3100,3512,1675,2026,2284,272,636,932,444,2182,102
717,8866,6018,1303,2123,1670,922,1469,1939,1037,1573,2848,522,595,1067,664,2691,157
718,7878,6228,1540,2517,1650,521,2150,2189,864,1025,1650,124,509,682,335,1535,115
719,8977,7715,1687,3451,1995,582,3312,2541,874,988,1262,145,366,509,242,1176,86
720,7109,6096,1581,2662,1347,506,2983,1828,517,768,1013,49,240,498,226,974,39
723,6595,5333,1197,2314,1330,492,2028,1835,646,824,1262,87,356,575,244,1194,68
725,48185,39295,8413,17395,10879,2608,13303,13564,5553,6875,8890,943,2543,3780,1624,8220,670
728,15271,13080,2952,5882,3543,703,4703,4429,2039,1909,2191,241,721,920,309,2026,165
729,15740,13320,3254,6323,3112,631,5001,4500,1855,1964,2420,297,738,1039,346,2239,181
730,12785,9644,2268,3949,2668,759,2940,2964,1737,2003,3141,304,862,1296,679,2946,195
731,6334,5429,987,2645,1524,273,2094,1844,777,714,905,80,284,413,128,846,59
735,5731,4609,1407,1811,1118,273,1815,1567,580,647,1122,273,224,429,196,1050,72
736,16392,13411,3035,5780,3589,1007,4676,4601,1866,2268,2981,266,794,1277,644,2818,163
738,13257,10357,2692,3882,3024,759,3211,3687,1579,1880,2900,375,759,1281,485,2691,209
739,12477,10792,2740,5025,2402,625,4703,3479,1285,1325,1685,153,462,719,351,1570,115
740,881,614,117,264,163,70,174,169,133,138,267,33,88,89,57,252,15
741,1898,1587,377,716,439,55,407,555,328,297,311,7,124,139,41,285,26
745,16465,13797,3273,6006,3798,720,4908,5089,1934,1866,2668,322,749,1175,422,2441,227
751,7867,6245,1553,2614,1615,463,2015,1988,1093,1149,1622,140,532,680,270,1537,85
754,13131,10770,2459,4953,2576,782,4139,3501,1433,1697,2361,269,733,935,424,2147,214
757,6777,5562,1494,2373,1280,415,1880,1657,952,1073,1215,129,376,482,228,1155,60
765,3330,2397,473,977,727,220,681,867,450,399,933,69,188,493,183,877,56
766,7719,6627,1642,3090,1475,420,3001,1916,809,901,1092,95,271,445,281,1057,35
767,12209,10119,2383,4696,2381,659,3975,3378,1266,1500,2090,202,573,809,506,1951,139
769,11761,9770,2359,4353,2410,648,3721,3255,1300,1494,1991,135,434,933,489,1877,114
771,11170,9431,2518,4118,2248,547,3555,3337,1162,1377,1739,250,592,593,304,1637,102
772,7349,6153,1517,2831,1391,414,2036,1479,1381,1257,1196,124,487,377,208,1093,103
773,6577,5284,1288,2199,1434,363,1685,1798,836,965,1293,95,381,587,230,1200,93
775,704,488,147,175,135,31,214,160,50,64,216,17,80,83,36,193,23
777,11941,9965,2850,4204,2296,615,3637,3487,1424,1417,1976,246,596,768,366,1845,131
778,11764,9950,2367,4641,2339,603,3890,3480,1083,1497,1814,158,649,802,205,1691,123
780,3040,2557,544,1239,579,195,993,841,370,353,483,33,146,194,110,466,17
782,5999,4937,1083,2316,1231,307,1983,1491,697,766,1062,72,294,432,264,1011,51
783,11237,9562,2255,4294,2387,626,4124,3103,1132,1203,1675,131,488,762,294,1599,76
784,14101,11303,2831,4952,2771,749,4178,3510,1848,1767,2798,300,769,1153,576,2679,119
791,17396,14110,3145,6308,3739,918,4688,4828,2110,2484,3286,265,989,1462,570,2994,292
794,8654,7443,2046,3316,1625,456,3520,1913,1043,967,1211,151,277,516,267,1117,94
795,14949,12558,3123,5536,3076,823,4916,3898,1786,1958,2391,192,738,993,468,2197,194
901,3323,1705,519,620,388,178,327,486,456,436,1618,291,644,388,295,1486,132
906,192,129,25,75,29,0,29,22,43,35,63,16,36,11,0,63,0
907,10763,5489,1028,2099,1578,784,1225,2320,743,1201,5274,909,1825,1698,842,4777,497
909,3155,1860,449,797,460,154,394,450,427,589,1295,197,467,400,231,1146,149
911,4746,2259,428,832,686,313,457,853,308,641,2487,582,818,675,412,2239,248
912,3320,1989,361,963,499,166,446,618,384,541,1331,234,364,498,235,1165,166
913,3851,2842,800,1228,585,229,466,512,1051,813,1009,122,364,362,161,921,88
915,13659,9168,2276,3754,2305,833,2022,2438,2321,2387,4491,559,1439,1690,803,4016,475
917,10354,6578,1471,2666,1793,648,1386,2062,1457,1673,3776,636,1217,1216,707,3413,363
918,8114,4687,1208,1893,942,644,938,1777,1060,912,3427,624,1040,1039,724,3056,371
920,7964,5367,886,2014,1401,1066,1217,2078,673,1399,2597,395,788,828,586,2317,280
921,15177,11092,2590,4391,2815,1296,2486,3166,2731,2709,4085,735,1083,1484,783,3638,447
923,11794,8191,1863,3381,2110,837,1714,2596,1900,1981,3603,484,1207,1229,683,3242,361
924,21154,16234,4147,6443,4405,1239,3937,4913,3969,3415,4920,640,1481,1886,913,4469,451
925,3053,1372,491,569,225,87,290,276,320,486,1681,717,431,379,154,1286,395
926,35079,28178,5833,12730,7927,1688,9077,10377,4203,4521,6901,1113,2194,2490,1104,6234,667
927,6701,4442,665,1878,1294,605,1013,1979,559,891,2259,626,604,727,302,1810,449
934,142,142,38,104,0,0,108,34,0,0,0,0,0,0,0,0,0
949,26556,21974,4908,10217,5783,1066,7720,7366,3239,3649,4582,643,1529,1716,694,4233,349
952,3805,3132,583,1388,904,257,941,1011,496,684,673,79,154,354,86,630,43
953,18967,16645,4428,8272,3292,653,7373,5101,2373,1798,2322,391,786,854,291,2112,210
956,26746,21992,4166,9607,6717,1502,7297,8128,2882,3685,4754,610,1182,2127,835,4311,443
957,16160,13767,2845,5782,4318,822,4132,4959,2233,2443,2393,265,639,1112,377,2222,171
959,18739,14694,3053,6272,4053,1316,4795,4920,2105,2874,4045,478,1079,1668,820,3688,357
961,12078,9846,1611,4761,2887,587,2828,3601,1650,1767,2232,247,789,893,303,2041,191
962,9643,7762,1632,3769,1899,462,2482,2133,1486,1661,1881,194,587,769,331,1719,162
965,2818,2176,533,864,583,196,532,687,455,502,642,44,171,286,141,609,33
966,5855,4368,551,1968,1436,413,1408,1880,437,643,1487,220,473,575,219,1317,170
968,1905,1038,106,472,304,156,200,532,90,216,867,103,325,253,186,804,63
969,16441,13468,2885,6670,3216,697,4957,4537,2178,1796,2973,501,1092,987,393,2668,305
971,9559,7865,1857,3341,2065,602,2690,2825,1137,1213,1694,309,565,575,245,1563,131
976,23583,19823,4594,9361,4863,1005,7204,6952,2917,2750,3760,580,1178,1490,512,3473,287
979,8414,4995,854,2236,1553,352,1280,2156,658,901,3419,631,1343,1083,362,3008,411
982,5358,4173,658,1448,1636,431,936,1743,511,983,1185,149,289,579,168,1041,144
983,16206,12945,2862,5260,4059,764,3404,4619,2373,2549,3261,477,820,1488,476,2980,281
985,19437,16254,3361,6930,5107,856,4798,6106,2065,3285,3183,423,1000,1302,458,2873,310
987,12813,10937,2667,5612,2224,434,4138,3324,1847,1628,1876,336,648,661,231,1643,233
1001,6947,4219,589,1997,1230,403,1389,2055,348,427,2728,472,975,535,746,2290,438
1002,9876,5081,819,2883,1107,272,1964,1923,848,346,4795,2554,959,683,599,2781,2014
1005,1900,1400,232,719,296,153,548,613,137,102,500,78,166,142,114,434,66
1007,4913,3547,696,2168,557,126,1521,1444,368,214,1366,317,416,410,223,991,375
1008,463,348,55,194,82,17,138,160,18,32,115,9,49,40,17,90,25
1010,1256,887,89,553,206,39,388,399,54,46,369,51,110,117,91,293,76
1011,785,562,69,332,135,26,228,239,62,33,223,24,100,57,42,162,61
1012,189,139,18,76,37,8,51,57,23,8,50,3,36,11,0,40,10
1013,9544,5902,1456,2536,1397,513,1431,2365,1334,772,3642,685,1154,948,855,3069,573
1020,12622,7857,1382,3559,2100,816,2414,3501,1002,940,4765,818,1531,1145,1271,4074,691
1022,949,492,98,208,137,49,165,260,39,28,457,27,196,171,63,407,50
1026,422,285,38,160,65,22,94,161,16,14,137,31,48,40,18,103,34
1027,7414,4612,792,2455,971,394,1427,2203,571,411,2802,706,987,614,495,2177,625
1028,5255,3997,418,2062,1155,362,1556,1887,249,305,1258,152,250,344,512,1121,137
1029,253,172,24,92,44,12,51,91,23,7,81,11,20,27,23,71,10
1030,4324,3228,430,1782,812,204,1199,1413,375,241,1096,229,457,224,186,864,232
1031,490,310,63,160,57,30,125,124,41,20,180,22,57,56,45,137,43
1032,86,48,6,19,21,2,14,32,0,2,38,9,20,8,1,20,18
1033,2276,1695,200,982,409,104,610,801,181,103,581,51,280,161,89,453,128
1034,722,525,38,305,157,25,202,275,29,19,197,20,74,55,48,161,36
1035,1895,1240,111,632,368,129,405,638,72,125,655,171,148,142,194,473,182
1036,1804,1448,141,830,396,81,590,690,91,77,356,37,115,125,79,295,61
1037,241,196,27,98,63,8,83,95,7,11,45,3,23,3,16,37,8
1038,1067,727,69,376,226,56,265,380,56,26,340,56,102,91,91,274,66
1039,465,307,18,199,64,26,88,147,31,41,158,27,66,47,18,106,52
1040,15000,9530,2736,4035,2098,661,2452,3129,2631,1318,5470,855,1716,1617,1282,4645,825
1050,889,677,112,371,150,44,241,323,77,36,212,31,85,66,30,165,47
1053,548,340,50,212,69,9,121,140,68,11,208,34,92,47,35,188,20
1054,550,379,35,216,93,35,134,171,47,27,171,41,56,63,11,111,60
1056,7640,5492,825,2596,1631,440,1855,2527,528,582,2148,256,568,724,600,1857,291
1057,3065,2212,353,1275,455,129,914,982,208,108,853,130,352,236,135,678,175
1060,7003,2740,419,1426,667,228,834,1182,401,323,4263,1595,1499,650,519,3162,1101
1062,4296,2820,353,1640,638,189,964,1201,385,270,1476,276,570,374,256,1075,401
1068,593,480,49,321,91,19,218,201,33,28,113,10,60,25,18,87,26
1069,4083,2630,533,1327,561,209,910,1081,417,222,1453,207,464,385,397,1232,221
1070,234,154,7,83,57,7,60,83,8,3,80,12,43,11,14,65,15
1071,596,477,66,270,113,28,158,227,61,31,119,26,43,29,21,94,25
1072,543,395,39,279,71,6,185,136,60,14,148,39,76,19,14,94,54
1073,1966,1536,208,896,345,87,573,766,105,92,430,30,148,146,106,336,94
1075,6593,4212,614,1946,1153,499,1445,1996,346,425,2381,328,879,652,522,2001,380
1077,3312,2419,400,1362,525,132,977,1029,200,213,893,127,309,237,220,723,170
1080,1009,715,146,345,178,46,206,282,145,82,294,54,78,74,88,251,43
1081,620,452,71,253,116,12,167,192,42,51,168,26,76,56,10,127,41
1082,4100,2664,493,1257,709,205,812,1135,454,263,1436,331,492,312,301,1188,248
1083,864,663,135,368,111,49,200,258,142,63,201,37,59,65,40,173,28
1084,53,45,4,17,13,11,11,25,4,5,8,0,8,0,0,3,5
1085,15057,10230,1901,5159,2426,744,3741,4318,1107,1064,4827,1109,1383,1258,1077,3882,945
1088,274,134,16,80,34,4,42,69,13,10,140,14,35,57,34,120,20
1089,11866,7193,1407,3434,1733,619,2356,2984,996,857,4673,1176,1308,1314,875,4012,661
1092,459,311,106,93,91,21,94,151,39,27,148,13,40,50,45,129,19
1095,5009,4067,293,2271,1147,356,1602,1877,286,302,942,30,195,403,314,869,73
1096,1092,696,98,400,139,59,277,312,64,43,396,77,169,99,51,259,137
1098,465,323,42,185,74,22,120,160,24,19,142,13,55,41,33,108,34
1103,1493,563,218,201,125,19,108,98,220,137,930,310,339,197,84,849,81
1104,8977,5555,1472,2597,1008,478,1478,1870,1415,792,3422,348,719,1299,1056,3084,338
1105,5376,2785,1224,1090,423,48,390,520,1362,513,2591,700,1096,524,271,2263,328
1106,5905,4525,291,2389,1406,439,1875,2170,221,259,1380,50,238,390,702,1242,138
1107,3800,2631,1042,1022,487,80,730,560,1021,320,1169,186,388,481,114,1015,154
1108,9898,6108,1874,2783,1082,369,1542,1752,1851,963,3790,1267,1152,840,531,2975,815
1109,9950,6888,1789,3271,1440,388,1390,1691,2401,1406,3062,486,953,1040,583,2553,509
1118,5714,4009,824,1851,901,433,1256,1718,617,418,1705,251,499,515,440,1409,296
1119,4658,3277,763,1547,712,255,945,1173,726,433,1381,234,397,463,287,1097,284
1128,1044,824,116,410,197,101,275,420,47,82,220,30,106,30,54,172,48
1129,2782,1899,319,990,419,171,559,838,245,257,883,115,375,257,136,741,142
1151,3319,2135,703,831,446,155,540,640,573,382,1184,291,336,273,284,998,186
1201,20382,12341,2114,5709,3303,1215,3373,5508,2184,1276,8041,1539,2548,2118,1836,6838,1203
1220,4251,2658,429,1244,681,304,711,1275,419,253,1593,250,362,500,481,1431,162
1222,292,246,51,144,31,20,104,109,15,18,46,0,0,25,21,37,9
1223,678,513,54,266,167,26,191,258,28,36,165,25,53,52,35,137,28
1225,1107,815,88,435,239,53,278,404,61,72,292,73,60,109,50,274,18
1226,3057,2114,290,1110,538,176,781,967,227,139,943,123,316,258,246,792,151
1230,3721,2294,248,1183,685,178,700,1059,295,240,1427,294,508,384,241,1164,263
1235,975,698,100,401,144,53,240,314,85,59,277,56,104,78,39,224,53
1236,841,578,61,262,170,85,153,289,65,71,263,55,108,60,40,246,17
1237,983,702,85,392,174,51,256,326,65,55,281,59,79,79,64,230,51
1238,2562,1741,257,858,482,144,506,876,219,140,821,173,195,251,202,671,150
1240,2288,1326,110,599,424,193,393,781,70,82,962,117,269,247,329,851,111
1242,41,41,0,23,9,9,15,18,8,0,0,0,0,0,0,0,0
1244,0,0,0,0,0,0,0,0,0,0,0,0,0,0,0,0,0
1245,397,258,24,119,96,19,73,142,22,21,139,32,57,33,17,100,39
1247,7265,4349,899,1917,1132,401,1314,1991,686,358,2916,576,728,849,763,2531,385
1253,267,182,26,92,57,7,62,97,13,10,85,13,25,40,7,64,21
1254,405,287,10,149,109,19,92,161,12,22,118,12,31,44,31,98,20
1255,324,213,20,118,54,21,71,122,8,12,111,11,54,24,22,99,12
1256,291,203,32,106,54,11,50,114,22,17,88,10,46,18,14,70,18
1257,981,607,42,333,185,47,204,283,56,64,374,36,150,137,51,297,77
1258,68,44,0,14,26,4,8,30,0,6,24,0,11,10,3,21,3
1259,216,170,21,77,54,18,51,89,8,22,46,5,12,18,11,39,7
1262,373,180,27,69,70,14,46,94,28,12,193,25,57,62,49,171,22
1264,95,66,7,14,39,6,12,43,5,6,29,5,9,9,6,23,6
1266,714,470,37,282,105,46,196,216,33,25,244,28,73,78,65,202,42
1267,2895,1849,151,877,554,267,569,972,137,171,1046,236,232,288,290,930,116
1301,8066,4496,898,2145,933,520,1376,1869,856,395,3570,776,1259,780,755,2943,627
1330,636,435,69,246,92,28,148,193,59,35,201,33,88,58,22,154,47
1331,5051,3449,674,1717,824,234,1145,1549,525,230,1602,284,519,372,427,1379,223
1337,1020,736,70,429,172,65,257,384,65,30,284,45,86,95,58,220,64
1338,10,4,0,4,0,0,0,4,0,0,6,0,0,6,0,3,3
1339,772,554,86,264,173,31,181,252,67,54,218,42,80,61,35,170,48
1340,726,499,84,265,120,30,209,210,45,35,227,29,79,69,50,174,53
1341,672,499,51,312,111,25,194,237,52,16,173,24,88,38,23,126,47
1342,393,266,52,109,95,10,87,142,13,24,127,47,10,54,16,97,30
1344,340,259,47,141,60,11,74,138,34,13,81,12,30,17,22,66,15
1346,115,82,6,55,14,7,40,33,5,4,33,2,21,8,2,27,6
1349,684,402,94,189,80,39,147,146,72,37,282,47,109,45,81,233,49
1350,28,16,4,3,7,2,4,6,4,2,12,0,3,5,4,12,0
1351,942,665,66,403,167,29,301,246,56,62,277,74,108,45,50,196,81
1355,368,255,36,142,73,4,95,123,23,14,113,16,47,28,22,83,30
1360,1168,827,110,454,213,50,300,383,105,39,341,41,122,91,87,291,50
1364,3061,1985,305,1035,496,149,630,864,327,164,1076,196,320,261,299,876,200
1366,431,297,21,170,81,25,103,151,18,25,134,3,42,40,49,117,17
1367,160,110,8,55,40,7,38,55,6,11,50,5,12,20,13,45,5
1368,429,313,41,185,63,24,117,128,29,39,116,14,55,37,10,86,30
1370,1746,1130,101,617,307,105,357,556,149,68,616,128,205,156,127,459,157
1373,2216,1442,154,790,375,123,479,678,115,170,774,128,359,126,161,611,163
1375,1621,795,152,426,179,38,276,355,80,84,826,559,168,71,28,416,410
1376,2796,1702,287,808,409,198,410,800,334,158,1094,182,360,310,242,936,158
1378,282,203,27,103,56,17,64,96,22,21,79,9,39,25,6,58,21
1379,362,214,34,132,45,3,72,93,25,24,148,23,82,37,6,105,43
1380,17,11,4,7,0,0,3,0,5,3,6,0,0,6,0,6,0
1420,14982,9456,2416,4250,1988,802,2905,3650,1865,1036,5526,1251,1700,1331,1244,4534,992
1430,1944,1549,227,944,314,64,684,636,133,96,395,64,176,85,70,300,95
1431,980,780,93,455,221,11,324,333,42,81,200,23,109,32,36,148,52
1432,2983,1797,465,902,332,98,649,695,259,194,1186,313,358,374,141,967,219
1436,1045,780,140,460,123,57,289,327,79,85,265,55,53,82,75,200,65
1438,47,38,8,25,5,0,13,11,14,0,9,0,9,0,0,9,0
1440,8456,5209,1106,2484,1156,463,1642,2170,885,512,3247,659,1023,823,742,2729,518
1450,3268,2549,354,1653,457,85,1376,900,220,53,719,127,299,192,101,561,158
1451,1777,1457,77,894,463,23,687,604,98,68,320,28,109,92,91,255,65
1452,1321,1111,208,694,186,23,592,414,44,61,210,25,92,42,51,177,33
1453,16552,11042,2705,5360,2271,706,3942,4384,1731,985,5510,1214,1822,1349,1125,4601,909
1460,2960,2255,273,1293,564,125,970,997,150,138,705,108,269,188,140,582,123
1462,3555,2674,360,1471,700,143,953,1260,273,188,881,128,333,205,215,710,171
1463,3845,3018,550,1836,565,67,1440,1119,292,167,827,174,327,220,106,676,151
1464,2061,1418,231,851,301,35,530,618,145,125,643,81,238,251,73,533,110
1467,40,40,0,40,0,0,35,5,0,0,0,0,0,0,0,0,0
1468,1184,927,106,555,237,29,370,379,109,69,257,8,108,116,25,220,37
1469,2055,1662,215,1099,308,40,748,688,152,74,393,57,139,115,82,303,90
1473,2526,1935,289,1112,441,93,799,900,160,76,591,49,253,111,178,454,137
1474,1037,821,152,510,148,11,415,273,67,66,216,51,104,46,15,183,33
1475,3462,2521,560,1383,464,114,1069,818,404,230,941,162,226,359,194,764,177
1501,6284,4392,558,2206,1225,403,1475,2232,295,390,1892,229,509,535,619,1610,282
1503,870,659,86,344,201,28,266,299,42,52,211,20,88,79,24,159,52
1504,3228,2326,453,1288,443,142,997,906,255,168,902,207,301,245,149,722,180
1505,1568,1143,167,618,313,45,469,529,84,61,425,70,119,141,95,347,78
1506,1212,868,130,465,191,82,317,421,80,50,344,56,82,140,66,287,57
1507,3786,3048,640,1796,507,105,1481,1086,290,191,738,98,334,245,61,554,184
1510,5599,3406,772,1527,845,262,1184,1412,422,388,2193,401,783,488,521,1855,338
1515,775,598,90,317,150,41,209,309,45,35,177,17,52,52,56,149,28
1516,2487,1955,492,1079,306,78,877,765,219,94,532,66,246,141,79,430,102
1518,881,633,127,364,114,28,273,257,70,33,248,33,94,72,49,221,27
1519,2047,1587,303,909,279,96,794,625,94,74,460,111,210,97,42,366,94
1520,4673,3643,425,1914,957,347,1567,1663,183,230,1030,87,280,329,334,885,145
1521,900,676,114,388,142,32,266,300,77,33,224,35,107,64,18,157,67
1522,1072,820,81,487,204,48,373,362,46,39,252,50,114,48,40,219,33
1523,2014,1549,199,817,421,112,630,675,116,128,465,53,215,97,100,381,84
1524,2205,1596,230,843,388,135,620,696,124,156,609,89,196,201,123,509,100
1527,4930,3471,563,1783,872,253,1173,1623,361,314,1459,255,445,423,336,1208,251
1529,926,733,152,428,124,29,347,265,89,32,193,41,92,29,31,140,53
1531,314,267,29,164,53,21,109,106,21,31,47,5,19,15,8,38,9
1532,4936,3936,494,2376,925,141,1801,1537,357,241,1000,207,343,289,161,833,167
1534,1633,1245,259,644,249,93,520,544,102,79,388,74,144,98,72,318,70
1535,1822,1241,197,712,254,78,486,520,139,96,581,110,132,188,151,470,111
1536,2502,1651,331,814,378,128,658,762,82,149,851,153,289,285,124,705,146
1537,787,484,120,208,135,21,155,221,89,19,303,59,168,56,20,249,54
1540,4264,3092,596,1623,691,182,1066,1358,407,261,1172,171,458,364,179,934,238
1541,1173,967,97,625,205,40,444,455,38,30,206,19,89,60,38,154,52
1542,631,484,97,267,82,38,224,180,44,36,147,8,57,50,32,129,18
1543,2244,1687,325,996,290,76,830,659,136,62,557,107,217,134,99,450,107
1545,12425,8755,1579,4695,1916,565,3707,3779,693,576,3670,783,1035,925,927,3122,548
1550,7097,4594,1272,1978,923,421,1407,1746,919,522,2503,520,884,550,549,2094,409
1560,1142,714,188,315,140,71,257,249,101,107,428,163,113,81,71,333,95
1562,4579,3107,601,1590,736,180,1017,1414,388,288,1472,363,427,409,273,1185,287
1564,2579,2078,205,1264,519,90,902,951,90,135,501,126,151,99,125,397,104
1566,2185,1614,251,795,406,162,637,789,59,129,571,101,180,200,90,501,70
1568,2039,1565,188,1028,302,47,685,659,152,69,474,54,173,139,108,389,85
1569,3954,2993,560,1719,541,173,1400,1171,242,180,961,157,300,294,210,764,197
1570,6555,4080,883,1918,942,337,1352,1722,587,419,2475,511,782,552,630,2045,430
1571,4086,2879,557,1483,641,198,1059,1296,352,172,1207,245,301,281,380,1001,206
1581,6508,4491,716,2720,835,220,2231,1726,258,276,2017,508,616,430,463,1648,369
1583,2402,1772,233,871,478,190,717,794,138,123,630,77,164,203,186,547,83
1585,2128,1446,188,727,410,121,510,693,156,87,682,125,186,204,167,576,106
1588,3195,2275,527,1102,496,150,857,876,309,233,920,200,222,230,268,774,146
1590,2800,2294,339,1393,490,72,1038,949,158,149,506,78,168,145,115,417,89
1602,9294,5992,1140,2719,1511,622,2059,2657,701,575,3302,591,1099,823,789,2801,501
1603,6761,4200,1115,2014,851,220,1476,1207,883,634,2561,698,749,595,519,2030,531
1604,14065,8084,2160,3262,1770,892,2271,3228,1316,1269,5981,1627,1864,1373,1117,4908,1073
1605,9494,5706,1819,2569,943,375,1656,1578,1668,804,3788,713,1283,880,912,3112,676
1606,7884,4966,1034,2310,1138,484,1581,2041,734,610,2918,739,926,576,677,2435,483
1607,3234,1887,705,742,311,129,575,519,562,231,1347,352,473,305,217,1106,241
1608,1241,729,350,342,29,8,216,113,317,83,512,164,213,121,14,412,100
1609,7525,3855,871,1768,916,300,1321,1445,563,526,3670,1272,1129,769,500,2840,830
1610,7646,4327,1461,1922,688,256,1087,1109,1405,726,3319,1256,1066,644,353,2521,798
1611,852,611,147,252,197,15,230,252,64,65,241,60,99,35,47,186,55
1612,1425,1161,118,610,324,109,486,549,60,66,264,21,70,96,77,223,41
1701,12065,8706,1350,4341,2403,612,3274,4296,472,664,3359,816,1036,895,612,2760,599
1702,14175,7940,2521,3501,1462,456,2637,3049,1325,929,6235,1781,2421,1218,815,4811,1424
1718,179,117,21,80,16,0,66,39,5,7,62,0,35,20,7,47,15
1719,1867,1296,154,910,196,36,758,397,75,66,571,167,259,128,17,476,95
1720,7259,5399,718,3282,1289,110,2836,1981,315,267,1860,483,739,399,239,1540,320
1721,5729,4072,651,2376,826,219,1776,1735,331,230,1657,319,730,368,240,1298,359
1730,4625,3456,355,1785,1015,301,1342,1702,175,237,1169,102,377,366,324,1008,161
1731,812,790,388,402,0,0,558,178,54,0,22,9,13,0,0,15,7
1740,1427,1193,140,745,289,19,587,514,42,50,234,29,107,64,34,159,75
1741,1628,1406,89,892,402,23,757,535,65,49,222,16,76,76,54,185,37
1742,5988,4451,264,2421,1346,420,1990,1942,269,250,1537,173,479,528,357,1326,211
1745,175,95,0,66,29,0,16,79,0,0,80,18,10,20,32,80,0
1746,4803,3835,423,2321,981,110,1880,1487,240,228,968,135,329,308,196,786,182
1747,2181,1531,279,809,309,134,687,575,99,170,650,38,247,171,194,576,74
1748,4423,3670,575,2383,603,109,1898,1383,281,108,753,87,364,199,103,675,78
1749,6984,4880,902,2495,1235,248,1821,2231,394,434,2104,417,675,609,403,1764,340
1752,14516,9374,2023,4818,2036,497,3700,4110,809,755,5142,1413,1912,1064,753,4129,1013
1754,4278,2806,522,1406,715,163,1028,1286,244,248,1472,324,543,343,262,1224,248
1756,1817,1475,194,937,289,55,725,622,81,47,342,68,111,79,84,289,53
1757,10478,7316,1494,3634,1659,529,2831,2979,724,782,3162,675,1138,777,572,2661,501
1760,12957,8544,1474,4431,2017,622,3433,3889,561,661,4413,1045,1392,1235,741,3622,791
1770,1427,1233,60,752,357,64,611,515,77,30,194,8,36,70,80,175,19
1772,2753,2322,245,1472,530,75,1290,861,73,98,431,80,150,99,102,329,102
1773,1995,1489,83,750,509,147,618,697,86,88,506,27,231,152,96,429,77
1775,2089,1682,188,1002,443,49,783,713,88,98,407,66,208,68,65,312,95
1776,5523,4836,503,2964,1241,128,2672,1773,256,135,687,40,257,216,174,571,116
1778,4673,3754,263,2082,1185,224,1795,1536,178,245,919,80,300,358,181,749,170
1801,15029,9695,1768,4518,2681,728,3322,4410,842,1121,5334,1459,1663,1300,912,4305,1029
1803,8315,6428,952,3040,2074,362,2436,2994,366,632,1887,458,588,506,335,1593,294
1810,11346,8594,846,5070,2175,503,4043,3441,553,557,2752,469,791,874,618,2450,302
1821,9980,7972,1282,4344,2043,303,3202,3427,628,715,2008,422,716,592,278,1618,390
1824,9375,7076,855,3787,2014,420,2992,3155,385,544,2299,335,636,760,568,2005,294
1826,10450,7756,1429,3967,1916,444,3049,3053,632,1022,2694,679,980,595,440,2190,504
1827,932,800,91,474,212,23,407,302,38,53,132,6,63,38,25,95,37
1830,9351,5852,1351,2870,1314,317,2110,2326,884,532,3499,686,1123,717,973,2902,597
1832,8455,5621,1566,2752,1047,256,1880,2163,1102,476,2834,716,939,696,483,2283,551
1833,2572,2013,225,1287,409,92,963,848,130,72,559,56,206,177,120,409,150
1834,2076,1743,259,1020,405,59,826,694,124,99,333,46,142,59,86,286,47
1835,5193,3493,756,1887,619,231,1372,1289,458,374,1700,360,740,347,253,1387,313
1840,2001,922,292,403,177,50,179,300,278,165,1079,160,354,362,203,970,109
1841,14089,10276,3250,5192,1388,446,3004,2117,3610,1545,3813,672,1343,955,843,3118,695
1843,8366,5758,1590,2729,1059,380,1727,1782,1511,738,2608,595,865,661,487,2127,481
1844,16548,11635,2114,5818,2685,1018,4196,4897,1259,1283,4913,829,1479,1277,1328,4169,744
1845,9699,7012,863,4143,1549,457,3158,2865,489,500,2687,399,845,704,739,2364,323
1850,5705,3824,1302,1703,597,222,1271,1081,1023,449,1881,524,713,421,223,1433,448
1851,10179,6930,2027,3387,1242,274,2572,2044,1341,973,3249,1045,1247,585,372,2452,797
1852,12997,7817,2189,3548,1711,369,2383,2691,1630,1113,5180,1132,1878,1211,959,4307,873
1854,9111,5676,1558,2726,1119,273,1861,1730,1300,785,3435,1028,1066,820,521,2761,674
1860,2230,1702,240,978,398,86,737,681,163,121,528,55,157,165,151,441,87
1862,3183,2452,362,1328,689,73,973,1070,186,223,731,136,213,255,127,611,120
1863,3451,2285,390,1235,553,107,862,938,238,247,1166,290,424,229,223,964,202
1864,4799,3750,495,2176,936,143,1794,1561,194,201,1049,124,445,290,190,868,181
1867,8669,6479,870,3488,1641,480,2900,2789,366,424,2190,331,737,537,585,1932,258
1876,9753,7646,1243,4249,1838,316,3188,3389,486,583,2107,276,786,630,415,1761,346
1879,3745,2965,547,1847,505,66,1464,1129,192,180,780,167,333,214,66,602,178
1880,9776,6643,969,3338,1769,567,2519,2933,422,769,3133,690,1037,771,635,2585,548
1886,6836,5824,726,3730,1184,184,3059,2207,321,237,1012,135,426,299,152,797,215
1887,7011,5810,864,3222,1454,270,2575,2407,346,482,1201,227,389,319,266,980,221
1890,7723,5831,569,2938,1811,513,2536,2517,302,476,1892,239,576,533,544,1694,198
1902,18622,10668,3025,4969,2131,543,3217,3200,2697,1554,7954,1710,2858,2010,1376,6727,1227
1904,6668,4846,607,2576,1206,457,1608,2165,506,567,1822,190,592,538,502,1563,259
1905,8348,5633,1477,2701,1047,408,1793,1589,1307,944,2715,414,960,864,477,2267,448
1906,9796,7140,853,3395,2213,679,2325,3402,469,944,2656,313,736,931,676,2252,404
1907,5717,3996,450,2128,1045,373,1621,1773,347,255,1721,154,588,460,519,1489,232
1908,1638,988,113,450,290,135,314,531,47,96,650,74,253,187,136,547,103
1913,6425,4269,928,2323,853,165,1697,1735,492,345,2156,414,739,560,443,1751,405
1915,15736,9929,1737,5107,2345,740,3671,4459,926,873,5807,1517,1847,1341,1102,4699,1108
1921,2560,2253,158,1414,591,90,1125,940,95,93,307,16,99,100,92,247,60
1922,935,767,80,504,171,12,355,297,54,61,168,11,42,78,37,125,43
1923,9544,6602,672,3504,1855,571,2427,3014,597,564,2942,561,868,919,594,2531,411
1929,1314,940,142,500,227,71,339,467,63,71,374,22,167,113,72,351,23
1930,12588,7912,1249,3868,2227,568,2571,3533,972,836,4676,861,1774,1205,836,3857,819
1938,5288,3484,381,1884,977,242,1279,1496,296,413,1804,215,646,559,384,1494,310
1940,4180,3352,238,1707,1075,332,1374,1605,135,238,828,77,167,275,309,729,99
1944,2175,1459,41,803,511,104,531,680,111,137,716,170,132,205,209,597,119
1945,8548,5692,556,2981,1649,506,2238,2535,477,442,2856,515,911,917,513,2455,401
1949,2325,1778,173,1083,456,66,858,723,107,90,547,74,162,197,114,459,88
1950,8051,4684,613,2606,1174,291,1656,2129,506,393,3367,763,1321,863,420,2714,653
1951,1005,771,66,471,181,53,322,346,48,55,234,16,45,86,87,200,34
1952,3086,2025,346,978,612,89,693,836,245,251,1061,138,461,296,166,820,241
1960,18578,12997,1953,6095,3811,1138,4498,6021,1025,1453,5581,889,1669,1592,1431,4725,856
1966,3472,2035,209,981,618,227,713,969,119,234,1437,192,480,417,348,1259,178
1969,1960,1438,202,882,310,44,675,597,85,81,522,84,207,130,101,395,127
1970,17477,9750,2187,4564,2196,803,2830,4211,1430,1279,7727,2018,2805,1560,1344,6113,1614
1982,2668,2152,325,1164,513,150,1029,893,92,138,516,64,126,234,92,418,98
1983,2101,1718,102,1018,470,128,820,758,41,99,383,37,69,160,117,340,43
1984,1278,952,64,496,295,97,462,410,34,46,326,0,63,103,160,290,36
1985,1401,1192,75,778,291,48,591,503,58,40,209,18,78,83,30,166,43
2019,5577,4306,744,2390,1040,132,1902,1750,295,359,1271,218,477,347,229,1013,258
2021,7949,5562,751,2810,1444,557,2225,2480,331,526,2387,448,605,700,634,2015,372
2025,2677,2060,165,1086,648,161,886,847,113,214,617,104,197,147,169,579,38
2026,8716,6169,939,2781,1800,649,2264,2723,438,744,2547,438,791,765,553,2104,443
2030,1842,1571,78,965,432,96,778,662,69,62,271,27,54,142,48,233,38
2032,1375,1044,139,535,272,98,478,478,36,52,331,40,117,82,92,297,34
2035,6143,4413,571,2410,1190,242,1912,1791,335,375,1730,333,664,439,294,1437,293
2038,10153,7894,1473,4756,1320,345,4112,2752,514,516,2259,482,700,649,428,1856,403
2043,7197,5493,465,2988,1687,353,2419,2381,341,352,1704,172,482,598,452,1510,194
2045,4526,2851,296,1514,880,161,848,1314,312,377,1675,236,718,466,255,1332,343
2048,7970,5939,1295,3575,896,173,3216,1919,444,360,2031,571,757,337,366,1670,361
2050,9123,6746,973,3759,1670,344,2805,2674,550,717,2377,401,945,681,350,1953,424
2052,4016,3316,320,2079,766,151,1827,1103,204,182,700,122,199,231,148,622,78
2053,4160,3337,439,2084,670,144,1751,1181,184,221,823,183,276,223,141,720,103
2054,3013,2193,380,1210,501,102,969,852,176,196,820,153,296,246,125,683,137
2056,2822,2433,248,1590,509,86,1320,849,111,153,389,38,112,159,80,305,84
2061,3231,2732,228,1515,874,115,1264,1175,116,177,499,36,158,162,143,460,39
2062,11628,7441,1347,3472,1998,624,2752,3259,543,887,4187,972,1278,987,950,3399,788
2066,6455,4812,442,2574,1502,294,1949,2220,325,318,1643,157,529,602,355,1405,238
2067,5947,4953,353,3114,1179,307,2463,1963,214,313,994,66,268,356,304,868,126
2071,288,277,33,122,114,8,134,99,5,39,11,11,0,0,0,0,11
2072,10270,7309,1181,3566,2059,503,2622,3415,504,768,2961,463,1083,802,613,2500,461
2081,6398,4672,499,2501,1279,393,2021,2046,174,431,1726,230,561,428,507,1521,205
2090,5104,3880,345,1984,1095,456,1767,1704,163,246,1224,45,220,333,626,1143,81
2093,3402,2650,352,1681,517,100,1339,992,138,181,752,101,298,221,132,579,173
2108,1889,592,110,171,311,0,154,417,10,11,1297,503,494,230,70,1103,194
2109,2075,634,153,255,179,47,118,411,10,95,1441,552,430,343,116,1170,271
2110,883,309,105,93,97,14,63,223,11,12,574,139,242,142,51,518,56
2111,2009,925,165,347,275,138,246,512,29,138,1084,255,211,288,330,922,162
2113,4053,926,326,277,204,119,142,491,32,261,3127,1907,698,262,260,2230,897
2114,6590,1570,636,618,232,84,353,927,158,132,5020,2601,1273,697,449,4034,986
2115,10454,2268,850,822,405,191,334,1323,267,344,8186,4893,1674,1012,607,5867,2319
2116,10852,3085,916,1173,800,196,585,1989,226,285,7767,3595,2577,1182,413,6331,1436
2118,10426,3343,1127,1348,705,163,526,1311,847,659,7083,2766,2597,1339,381,5162,1921
2119,8997,5528,1342,2853,1059,274,1032,1011,2115,1370,3469,733,1122,1122,492,3026,443
2120,4080,1998,626,1008,301,63,468,362,640,528,2082,1206,480,317,79,1100,982
2121,8856,6090,1824,2785,1174,307,959,956,2725,1450,2766,544,1145,850,227,2361,405
2122,8244,5268,1348,2592,1059,269,1647,1317,1311,993,2976,839,1097,637,403,2193,783
2124,17396,12098,3179,5999,2419,501,2953,2503,3981,2661,5298,1159,1831,1568,740,4079,1219
2125,11467,7286,2061,3619,1297,309,1944,1639,2280,1423,4181,1409,1251,1068,453,3001,1180
2126,9378,7035,1483,3600,1719,233,1887,1538,1969,1641,2343,367,903,853,220,1957,386
2127,13859,6267,1665,2743,1362,497,1511,2063,1293,1400,7592,2823,2184,1751,834,5789,1803
2128,14322,8768,2661,3925,1557,625,2683,2603,1760,1722,5554,1260,1713,1395,1186,4525,1029
2129,7341,3295,910,1479,772,134,811,1350,613,521,4046,1659,1290,746,351,3141,905
2130,14608,6967,1680,3623,1219,445,1938,2338,1411,1280,7641,2880,3069,1168,524,4689,2952
2131,12100,7667,1844,3838,1506,479,2537,2393,1447,1290,4433,1086,1575,1043,729,3241,1192
2132,10090,6131,918,2746,1709,758,2003,2711,369,1048,3959,816,1243,1025,875,3274,685
2134,9369,2859,1166,1025,507,161,714,1119,271,755,6510,5045,955,377,133,3230,3280
2135,20227,7165,2444,2415,1558,748,1721,3345,775,1324,13062,8010,2515,1153,1384,7381,5681
2136,10737,6996,1420,3643,1440,493,2183,2222,1433,1158,3741,680,1203,1010,848,3184,557
2138,14134,5631,1540,2342,1307,442,1739,2704,578,610,8503,3586,2609,1581,727,6612,1891
2139,14306,5815,1696,2855,948,316,1766,2184,1108,757,8491,3858,2776,1268,589,5627,2864
2140,7778,3577,894,1752,706,225,1192,1335,543,507,4201,1526,1369,867,439,2962,1239
2141,5630,2552,773,1043,536,200,622,1094,466,370,3078,1438,780,544,316,2103,975
2142,798,369,227,74,47,21,79,277,6,7,429,213,144,38,34,312,117
2143,11004,4641,1438,1791,1080,332,1246,2157,413,825,6363,3293,1768,699,603,3826,2537
2144,10511,4316,1211,1698,1045,362,1188,1904,402,822,6195,3463,1451,718,563,3190,3005
2145,9999,5987,1756,2790,1055,386,1965,2014,881,1127,4012,1653,1155,779,425,2731,1281
2148,23028,13673,3076,6648,2962,987,4395,5716,1456,2106,9355,3004,2523,2250,1578,7400,1955
2149,15433,9610,2256,4287,2340,727,2854,3835,1529,1392,5823,1439,1802,1416,1166,4816,1007
2150,11908,7686,2379,3533,1311,463,2512,2091,1826,1257,4222,904,1320,1261,737,3422,800
2151,19422,11863,2450,5127,3117,1169,3380,4818,1640,2025,7559,1540,2487,2031,1501,6341,1218
2152,7843,4596,741,2191,1200,464,1413,1978,430,775,3247,753,1098,767,629,2547,700
2155,22102,13556,2086,6203,3734,1533,4137,6037,1048,2334,8546,2421,2309,2046,1770,6363,2183
2163,373,139,126,13,0,0,67,63,9,0,234,230,0,4,0,170,64
2169,23771,12259,2987,5493,2756,1023,3555,5268,1523,1913,11512,3122,3253,2779,2358,9311,2201
2170,7931,4458,767,1976,1242,473,1504,2081,244,629,3473,1043,1089,698,643,2685,788
2171,7191,3971,628,1933,1098,312,1214,1749,312,696,3220,1014,1116,650,440,2600,620
2176,10971,7101,1079,3629,1717,676,2741,3273,431,656,3870,756,1109,981,1024,3255,615
2180,9059,5880,876,2847,1567,590,2056,2760,413,651,3179,536,944,977,722,2729,450
2184,12623,8888,1170,4151,2694,873,3158,3963,701,1066,3735,595,1149,1091,900,3091,644
2186,8993,6777,709,3669,1698,701,2932,2523,487,835,2216,182,517,748,769,1906,310
2188,6119,3747,731,1671,1055,290,1229,1735,468,315,2372,496,655,730,491,2048,324
2189,6058,3839,713,1838,1080,208,1258,1601,492,488,2219,504,747,596,372,1895,324
2190,6310,4068,775,1899,1115,279,1557,1733,338,440,2242,553,823,514,352,1818,424
2191,3541,2391,315,1022,786,268,681,1165,240,305,1150,246,382,307,215,981,169
2199,719,184,42,54,73,15,27,142,8,7,535,115,160,177,83,514,21
2210,194,85,5,73,7,0,6,73,6,0,109,13,69,27,0,86,23
2215,8015,1179,509,366,181,123,165,764,78,172,6836,5051,1096,482,207,4585,2251
2222,0,0,0,0,0,0,0,0,0,0,0,0,0,0,0,0,0
2301,22507,14523,3626,7213,2799,885,4482,4743,3516,1782,7984,1707,2769,2076,1432,6563,1421
2302,11165,8207,1539,4049,2149,470,2619,3006,1377,1205,2958,477,933,956,592,2392,566
2322,1712,1223,132,592,382,117,346,490,119,268,489,80,98,176,135,403,86
2324,7518,5641,1088,3132,1172,249,2536,2191,434,480,1877,404,524,553,396,1466,411
2330,4006,3036,518,1572,689,257,1272,1390,237,137,970,67,309,262,332,790,180
2332,4931,3964,273,2358,1145,188,1891,1724,138,211,967,26,244,293,404,873,94
2333,4344,3439,590,1973,755,121,1515,1365,253,306,905,152,285,225,243,756,149
2338,2753,2063,312,1149,476,126,799,891,180,193,690,70,177,303,140,585,105
2339,4355,3558,294,2198,882,184,1713,1329,197,319,797,133,142,301,221,663,134
2341,3122,2560,383,1473,624,80,1109,1102,175,174,562,58,170,246,88,460,102
2343,4074,2887,433,1368,839,247,997,1307,260,323,1187,189,334,408,256,1013,174
2346,6980,5161,1077,2808,1024,252,2073,1865,736,487,1819,353,619,482,365,1409,410
2347,3307,2667,384,1532,612,139,1265,1117,130,155,640,80,253,206,101,486,154
2351,5260,3768,557,2007,932,272,1500,1602,314,352,1492,289,555,318,330,1217,275
2356,3878,2990,304,1945,629,112,1411,1205,179,195,888,112,307,298,171,780,108
2358,8,8,0,8,0,0,0,8,0,0,0,0,0,0,0,0,0
2359,5744,4571,734,2580,1136,121,2104,1772,294,401,1173,201,360,373,239,955,218
2360,18499,13422,2324,7388,2925,785,5393,5484,1367,1178,5077,1002,1735,1297,1043,4001,1076
2364,4250,3155,571,1813,547,224,1377,1359,281,138,1095,116,276,379,324,928,167
2366,0,0,0,0,0,0,0,0,0,0,0,0,0,0,0,0,0
2367,845,726,103,407,198,18,338,317,12,59,119,9,36,32,42,91,28
2368,11335,8087,1071,4090,2272,654,2749,3429,832,1077,3248,523,1156,810,759,2686,562
2370,6557,4637,986,2271,1123,257,1747,1771,533,586,1920,345,606,557,412,1631,289
2375,3626,2620,382,1475,693,70,1135,1089,126,270,1006,179,365,347,115,762,244
2379,2452,1788,216,873,511,188,651,765,152,220,664,65,231,173,195,534,130
2382,5013,3638,730,1950,790,168,1481,1339,398,420,1375,381,391,341,262,1122,253
2420,5048,3910,246,2088,1164,412,1761,1693,198,258,1138,87,334,417,300,982,156
2421,6081,4564,295,2479,1376,414,2059,1925,224,356,1517,128,293,452,644,1341,176
2445,10883,6199,839,3235,1702,423,2433,2650,532,584,4684,1884,1329,997,474,3337,1347
2446,14293,5839,1573,2743,1131,392,2014,2755,472,598,8454,3852,2055,1438,1109,5960,2494
2451,7274,4282,867,1976,1146,293,1391,2120,306,465,2992,921,1009,694,368,2185,807
2452,4392,2428,400,1050,733,245,580,1254,145,449,1964,551,599,531,283,1566,398
2453,11491,5851,1454,2493,1314,590,1966,2445,352,1088,5640,2405,1532,975,728,4189,1451
2458,5024,2822,496,1358,719,249,985,1220,260,357,2202,793,667,387,355,1582,620
2459,6187,4518,264,2499,1294,461,2006,2008,211,293,1669,232,407,433,597,1282,387
2460,3817,2354,359,1236,562,197,1069,954,132,199,1463,413,439,299,312,1018,445
2461,2403,1861,257,991,462,151,767,858,133,103,542,90,208,149,95,424,118
2462,625,360,31,178,87,64,126,147,29,58,265,28,52,56,129,230,35
2464,1230,646,112,349,132,53,225,272,55,94,584,208,197,98,81,416,168
2465,4168,2968,379,1489,793,307,1177,1428,141,222,1200,354,205,370,271,852,348
2466,2721,1650,264,863,394,129,743,668,49,190,1071,245,322,215,289,830,241
2467,3412,2090,283,894,565,348,837,965,175,113,1322,300,234,442,346,1081,241
2468,2002,1677,31,1018,489,139,865,669,54,89,325,36,107,100,82,288,37
2472,14645,7416,1463,3411,1661,881,2068,3562,584,1202,7229,2637,2013,1452,1127,5013,2216
2474,11358,6702,1188,3213,1708,593,2199,3072,491,940,4656,1205,1490,1053,908,3667,989
2476,7632,4204,678,1974,1168,384,1517,2043,204,440,3428,744,1323,746,615,2821,607
2478,9706,6512,724,3203,1919,666,2607,2783,490,632,3194,723,958,731,782,2513,681
2481,4834,3866,270,2225,994,377,1923,1546,156,241,968,91,249,374,254,809,159
2482,3780,2688,221,1523,711,233,1235,1111,159,183,1092,117,308,309,358,969,123
2492,7118,5330,450,2931,1477,472,2528,2389,155,258,1788,114,390,466,818,1625,163
2493,3702,3035,139,1671,986,239,1375,1393,145,122,667,28,125,262,252,634,33
2494,3477,2470,270,1324,604,272,1078,1068,170,154,1007,162,287,220,338,845,162
2532,5813,3883,667,1744,1162,310,1094,1908,549,332,1930,283,598,631,418,1561,369
2534,373,276,9,95,137,35,35,194,15,32,97,12,0,61,24,83,14
2535,530,322,38,164,95,25,92,153,48,29,208,38,87,51,32,172,36
2536,7865,5567,633,2633,1700,601,1674,2732,666,495,2298,265,729,909,395,1877,421
2537,2165,1687,131,913,492,151,704,803,102,78,478,27,156,197,98,394,84
2538,1114,787,195,444,90,58,330,281,94,82,327,18,121,117,71,272,55
2539,1585,962,128,513,279,42,310,470,109,73,623,106,290,151,76,475,148
2540,4323,2323,122,873,934,394,502,1499,162,160,2000,203,548,770,479,1765,235
2542,516,428,302,126,0,0,299,81,42,6,88,63,25,0,0,39,49
2543,349,185,40,59,73,13,62,90,6,27,164,30,54,36,44,134,30
2554,3701,2114,378,1116,482,138,802,943,204,165,1587,462,630,308,187,1111,476
2556,1333,963,94,417,358,94,312,567,46,38,370,19,95,144,112,349,21
2558,819,497,51,238,190,18,69,197,131,100,322,47,98,77,100,263,59
2559,1476,866,47,432,306,81,230,453,68,115,610,71,142,214,183,556,54
2563,4135,3001,311,1702,745,243,1197,1342,286,176,1134,72,438,361,263,938,196
2568,4088,2408,319,1401,535,153,855,965,362,226,1680,291,654,482,253,1342,338
2571,4137,2735,446,1415,721,153,775,1170,510,280,1402,222,419,464,297,1205,197
2575,197,125,0,65,33,27,29,55,26,15,72,2,46,18,6,60,12
2576,1226,875,139,395,236,105,256,441,99,79,351,12,74,144,121,345,6
2601,6933,3841,886,1688,922,345,995,1404,843,599,3092,444,1056,838,754,2576,516
2630,772,521,7,272,171,71,148,307,14,52,251,0,72,122,57,218,33
2631,4066,2814,195,1363,915,341,838,1532,242,202,1252,113,453,406,280,1002,250
2632,4624,3177,285,1358,994,540,953,1669,224,331,1447,156,404,484,403,1223,224
2633,2037,1226,72,447,485,222,269,812,58,87,811,95,211,261,244,695,116
2635,1486,1007,114,408,362,123,294,634,24,55,479,26,186,131,136,384,95
2638,1783,1184,81,412,536,155,255,748,73,108,599,65,155,184,195,504,95
2639,1557,892,143,312,318,119,174,480,134,104,665,120,183,229,133,564,101
2642,2383,1631,135,651,583,262,362,950,172,147,752,121,199,284,148,605,147
2644,1257,1005,190,596,188,31,533,361,91,20,252,30,102,78,42,191,61
2645,4039,2712,227,1204,957,324,723,1484,231,274,1327,183,351,418,375,1059,268
2646,984,540,40,131,241,128,83,404,41,12,444,59,134,105,146,411,33
2647,33,20,0,0,12,8,0,20,0,0,13,7,0,6,0,6,7
2648,2657,2125,239,1208,546,132,935,803,243,144,532,114,184,144,90,421,111
2649,5256,3638,572,1664,1072,330,1201,1736,455,246,1618,170,619,570,259,1316,302
2650,459,246,31,57,118,40,26,191,0,29,213,11,56,87,59,181,32
2652,568,331,27,171,105,28,97,167,39,28,237,27,80,91,39,173,64
2653,3089,1786,60,655,743,328,378,1206,107,95,1303,79,332,401,491,1141,162
2655,1850,1274,102,438,490,244,274,816,76,108,576,10,186,188,192,512,64
2657,1842,457,42,209,166,40,91,234,83,49,1385,118,796,336,135,976,409
2659,564,360,10,155,115,80,78,225,39,18,204,8,57,77,62,177,27
2660,3359,2181,237,772,817,355,543,1263,206,169,1178,110,267,412,389,1057,121
2661,7,0,0,0,0,0,0,0,0,0,7,0,0,7,0,7,0
2664,4670,2681,238,862,1049,532,550,1558,281,292,1989,231,484,531,743,1719,270
2666,353,189,21,82,56,30,42,110,19,18,164,13,81,39,31,126,38
2667,1289,741,79,337,252,73,210,388,74,69,548,51,218,173,106,447,101
2668,1211,981,70,560,298,53,454,451,62,14,230,41,55,80,54,182,48
2669,97,55,12,13,15,15,13,23,0,19,42,0,0,12,30,42,0
2670,812,380,66,77,171,66,73,236,28,43,432,24,136,132,140,368,64
2671,500,307,31,115,114,47,58,173,16,60,193,13,43,59,78,180,13
2672,85,64,0,17,38,9,17,47,0,0,21,6,7,0,8,8,13
2673,3661,2264,312,972,643,337,589,1136,240,299,1397,167,335,484,411,1141,256
2675,3186,2094,150,764,811,369,451,1405,81,157,1092,61,223,393,415,929,163
2702,1377,1134,168,675,242,49,497,472,68,97,243,33,61,85,64,204,39
2703,16021,11035,2418,5637,2350,630,4100,4658,1264,1013,4986,1173,1729,1183,901,4119,867
2713,31,21,3,6,10,2,2,12,4,3,10,6,0,2,2,10,0
2715,734,577,91,302,164,20,262,260,28,27,157,27,49,21,60,107,50
2717,1544,1279,157,737,335,50,496,597,93,93,265,69,73,81,42,213,52
2718,2350,1833,379,1061,300,93,862,572,241,158,517,70,195,138,114,431,86
2719,6631,4288,623,2028,1204,433,1414,1955,464,455,2343,278,709,677,679,2008,335
2720,13169,7958,2092,3580,1607,679,2227,3245,1564,922,5211,1237,1410,1420,1144,4475,736
2721,11042,6849,2120,2691,1473,565,2006,2417,1541,885,4193,750,1091,1135,1217,3711,482
2723,6711,4191,1271,1636,974,310,1130,1638,947,476,2520,468,731,692,629,2247,273
2724,7668,4602,1341,1895,977,389,1343,1577,996,686,3066,620,851,867,728,2763,303
2725,996,817,98,346,269,104,241,435,39,102,179,46,30,50,53,163,16
2726,5961,4452,555,1915,1502,480,1358,2445,233,416,1509,157,266,515,571,1330,179
2738,1990,1444,164,716,431,133,535,718,99,92,546,90,176,162,118,477,69
2739,2530,1773,194,869,540,170,601,895,139,138,757,93,221,294,149,644,113
2740,17779,10869,2642,4849,2397,981,2913,3888,2566,1502,6910,1171,1915,2145,1679,5965,945
2743,3760,2808,361,1447,789,211,1054,1361,208,185,952,147,234,303,268,794,158
2744,4739,3048,945,1151,732,220,806,1163,772,307,1691,328,444,453,466,1475,216
2745,9715,6610,1464,2854,1615,677,1968,2840,1141,661,3105,578,878,843,806,2650,455
2746,6062,3795,1335,1575,665,220,1053,1005,1201,536,2267,502,689,641,435,1966,301
2747,6011,4655,667,2372,1184,432,1721,2186,362,386,1356,217,432,445,262,1146,210
2748,4539,3192,297,1587,1001,307,1099,1682,200,211,1347,66,272,408,601,1215,132
2760,9617,6613,1450,3616,1165,382,2715,2727,751,420,3004,887,1033,689,395,2463,541
2762,3010,2039,368,1021,505,145,839,935,154,111,971,220,322,305,124,788,183
2763,796,670,86,426,135,23,322,263,53,32,126,14,40,64,8,99,27
2764,1462,1136,135,644,265,92,411,513,100,112,326,7,94,130,95,308,18
2766,5861,4449,866,2594,860,129,2024,1664,476,285,1412,233,513,451,215,1142,270
2767,4041,3185,497,1636,843,209,1256,1393,222,314,856,154,258,250,194,703,153
2769,3501,2870,324,1700,702,144,1204,1278,144,244,631,71,232,202,126,488,143
2770,1512,1253,149,778,271,55,557,568,23,105,259,31,106,69,53,205,54
2771,4830,3879,484,2049,1110,236,1558,1851,181,289,951,94,264,309,284,817,134
2777,5949,4583,599,2359,1307,318,1481,2396,399,307,1366,158,358,379,471,1164,202
2779,1848,1572,314,939,275,44,803,608,86,75,276,30,95,97,54,199,77
2780,19832,12815,3157,5698,3006,954,4208,5183,2004,1420,7017,1571,2335,1773,1338,5813,1204
2790,5536,4232,585,2138,1231,278,1393,2232,269,338,1304,166,372,442,324,1090,214
2804,1010,805,199,343,236,27,293,360,90,62,205,44,90,52,19,147,58
2806,6023,4746,407,2665,1204,470,2133,2054,280,279,1277,190,335,387,365,1125,152
2807,473,251,28,118,90,15,81,131,22,17,222,51,84,56,31,163,59
2808,776,559,165,269,125,0,230,172,132,25,217,71,77,47,22,121,96
2809,8311,5664,951,2570,1665,478,1856,2755,483,570,2647,582,732,655,678,2192,455
2812,420,371,76,225,70,0,161,170,34,6,49,0,21,15,13,34,15
2813,3161,2263,399,1094,627,143,756,1199,171,137,898,135,262,301,200,683,215
2814,2671,2110,284,1341,433,52,898,920,155,137,561,78,194,191,98,417,144
2815,92,82,14,19,34,15,24,38,0,20,10,10,0,0,0,0,10
2816,11799,8643,1546,4513,2155,429,3265,4058,708,612,3156,514,1026,894,722,2571,585
2817,1778,1461,227,891,287,56,629,646,124,62,317,83,129,47,58,241,76
2818,7414,5093,446,2797,1543,307,1941,2485,337,330,2321,450,801,597,473,1942,379
2822,1956,1476,244,850,328,54,603,621,141,111,480,78,229,141,32,347,133
2825,1830,1458,155,950,293,60,623,637,104,94,372,39,142,141,50,280,92
2827,768,652,43,459,138,12,266,277,74,35,116,0,66,29,21,88,28
2828,2810,1976,172,1029,611,164,658,1011,171,136,834,100,163,227,344,765,69
2830,2609,1961,288,1167,404,102,790,904,125,142,648,108,238,165,137,526,122
2831,1071,925,152,477,224,72,341,472,52,60,146,23,71,16,36,112,34
2832,1800,1300,216,720,288,76,589,525,141,45,500,58,142,105,195,442,58
2833,251,191,31,109,51,0,74,98,12,7,60,9,23,5,23,31,29
2835,2342,1618,151,847,504,116,552,838,106,122,724,80,283,235,126,606,118
2836,33,33,0,24,9,0,24,9,0,0,0,0,0,0,0,0,0
2837,1481,1046,126,492,330,98,348,559,75,64,435,48,137,155,95,364,71
2838,1401,900,214,347,274,65,231,408,156,105,501,110,186,128,77,430,71
2839,432,352,15,218,111,8,120,184,19,29,80,8,12,60,0,60,20
2840,11590,5764,1448,2511,1338,467,1543,2289,1214,718,5826,1779,1959,1293,795,4580,1246
2842,6968,4684,840,2411,1123,310,1848,2007,495,334,2284,372,824,533,555,1978,306
2852,9136,6532,1138,3474,1535,385,2383,2748,922,479,2604,449,981,801,373,2077,527
2857,3226,2416,229,1411,622,154,972,1194,114,136,810,48,305,267,190,709,101
2858,250,228,40,174,14,0,103,78,41,6,22,10,12,0,0,12,10
2859,2373,1814,299,1133,260,122,752,705,223,134,559,64,223,157,115,446,113
2860,19020,11298,3381,5178,2076,663,3254,3664,2927,1453,7722,1667,2502,1979,1574,6560,1162
2861,11064,7233,1464,3216,1756,797,2210,3368,964,691,3831,639,1167,1151,874,3206,625
2863,6722,4433,1607,1963,637,226,1365,1197,1335,536,2289,510,649,642,488,1958,331
2864,12185,9064,1380,4593,2386,705,3386,4246,629,803,3121,539,867,830,885,2700,421
2865,6840,4901,579,2644,1255,423,1879,2259,403,360,1939,356,467,538,578,1719,220
2871,6766,4866,630,2702,1213,321,1832,2342,416,276,1900,311,504,684,401,1576,324
2874,1805,1342,187,770,291,94,652,511,61,118,463,50,195,100,118,347,116
2875,110,86,20,36,24,6,21,59,0,6,24,9,0,15,0,15,9
2878,6065,4419,609,2141,1267,402,1509,2150,270,490,1646,169,524,527,426,1404,242
2879,7480,5037,601,2934,1139,363,2006,2024,517,490,2443,529,717,615,582,1984,459
2881,1147,832,68,451,238,75,358,406,40,28,315,162,23,95,35,181,134
2882,6163,3466,365,1687,1187,227,982,1759,379,346,2697,1183,685,504,325,1693,1004
2885,4717,3031,564,1387,815,265,974,1385,379,293,1686,380,553,398,355,1449,237
2886,13064,8034,1296,3736,2223,779,2648,3848,701,837,5030,756,1456,1462,1356,4432,598
2888,8635,5562,951,2793,1300,518,1828,2599,448,687,3073,473,806,897,897,2603,470
2889,11393,7931,1473,4135,1851,472,2804,3377,966,784,3462,603,1077,1093,689,2796,666
2891,8881,5741,987,2720,1556,478,1964,2637,576,564,3140,639,955,772,774,2662,478
2892,1477,1133,215,646,216,56,558,476,22,77,344,76,113,134,21,230,114
2893,12490,7712,1744,3804,1645,519,2331,3351,1239,791,4778,1223,1424,1269,862,3900,878
2894,194,145,46,77,18,4,64,52,23,6,49,0,15,34,0,49,0
2895,17771,10819,3249,4620,2259,691,3084,4215,2526,994,6952,1516,2201,1704,1531,5807,1145
2896,3875,2916,299,1611,823,183,992,1562,182,180,959,24,265,346,324,837,122
2898,609,529,77,328,118,6,225,235,56,13,80,22,40,0,18,65,15
2903,4249,996,305,367,191,133,233,464,176,123,3253,1273,790,773,417,2635,618
2904,13264,7350,1558,3034,2006,752,1763,3376,1298,913,5914,1228,2034,1414,1238,5123,791
2905,8701,5781,1482,2681,1240,378,1740,1577,1515,949,2920,695,1107,644,474,2330,590
2906,12180,5193,1135,2398,1268,392,1751,2402,551,489,6987,3674,1559,964,790,4802,2185
2907,8567,6340,1938,3327,876,199,1835,1086,2437,982,2227,325,940,635,327,1858,369
2908,13147,8299,2505,3589,1521,684,2398,2423,2066,1412,4848,1594,1213,1079,962,3626,1222
2909,14535,9373,3585,3935,1310,543,2702,2077,3117,1477,5162,1396,1684,1218,864,4064,1098
2910,8623,5618,1024,2701,1303,590,1812,2368,783,655,3005,674,1100,528,703,2545,460
2911,6021,3754,618,1718,974,444,1086,1687,455,526,2267,466,645,567,589,1940,327
2914,9314,5853,1367,2383,1571,532,1631,2474,994,754,3461,665,957,1036,803,3016,445
2915,7703,4751,755,2344,1233,419,1549,2064,523,615,2952,450,901,735,866,2549,403
2916,3521,2263,288,1067,626,282,717,1022,204,320,1258,168,346,376,368,1095,163
2917,4402,3055,358,1635,850,212,1056,1370,270,359,1347,285,501,217,344,1177,170
2919,11199,7769,1287,3663,2088,731,2541,3604,717,907,3430,441,897,1123,969,2977,453
2920,14638,9363,1259,4206,2652,1246,2597,4377,1016,1373,5275,942,1244,1473,1616,4660,615
2921,3620,2993,389,1800,611,193,1444,1216,132,201,627,43,221,198,165,538,89
3031,3584,3054,312,1894,757,91,1588,1234,116,116,530,60,209,192,69,424,106
3032,1573,1305,184,861,216,44,648,541,56,60,268,33,136,61,38,185,83
3033,1346,1147,152,780,194,21,644,387,75,41,199,21,83,77,18,139,60
3034,1360,1113,172,677,239,25,509,522,66,16,247,41,122,70,14,173,74
3036,1212,1014,147,643,197,27,489,397,73,55,198,14,85,72,27,140,58
3037,1229,996,161,623,196,16,486,435,50,25,233,31,129,22,51,153,80
3038,12420,8886,1851,5504,1386,145,4071,2855,1299,661,3534,1075,1289,800,370,2702,832
3042,2053,1488,325,811,256,96,595,655,145,93,565,93,214,178,80,429,136
3043,666,494,57,304,102,31,211,220,32,31,172,20,76,43,33,128,44
3044,1172,996,206,593,175,22,481,410,60,45,176,31,93,41,11,117,59
3045,5191,3904,645,2237,815,207,1726,1690,275,213,1287,210,520,324,233,989,298
3047,383,289,62,180,41,6,124,119,34,12,94,14,44,33,3,68,26
3048,1306,885,143,519,181,42,353,415,60,57,421,79,138,141,63,336,85
3049,2436,2013,141,1260,542,70,982,889,77,65,423,81,151,94,97,326,97
3051,8039,6288,1298,3493,1268,229,2611,2644,678,355,1751,378,809,393,171,1305,446
3052,2370,2036,412,1288,319,17,1133,606,179,118,334,72,162,74,26,225,109
3053,7555,6384,909,4175,1134,166,3272,2147,625,340,1171,178,580,329,84,942,229
3054,8883,7088,1256,4164,1512,156,3183,3000,636,269,1795,362,843,415,175,1399,396
3055,5225,3673,910,2005,603,155,1587,1401,491,194,1552,319,492,477,264,1291,261
3057,742,615,58,386,153,18,265,276,37,37,127,15,59,35,18,92,35
3060,12133,7094,2134,3095,1380,485,2239,2873,1209,773,5039,1472,1507,1078,982,4049,990
3062,10004,7005,1208,3780,1777,240,2926,3041,652,386,2999,699,1184,745,371,2362,637
3063,6767,4310,959,2102,1090,159,1660,1896,409,345,2457,704,935,563,255,1875,582
3064,5726,3790,747,1902,889,252,1404,1501,501,384,1936,549,669,421,297,1517,419
3070,1419,1156,211,682,218,45,537,456,92,71,263,59,174,9,21,179,84
3071,1343,1093,240,620,180,53,574,405,56,58,250,50,71,97,32,203,47
3076,3614,2995,476,1736,702,81,1316,1239,227,213,619,94,229,160,136,460,159
3077,3481,2557,544,1441,429,143,1100,993,293,171,924,243,369,235,77,661,263
3079,10393,7609,1155,4087,2020,347,2950,3518,556,585,2784,420,1113,835,416,2200,584
3082,416,311,36,179,82,14,130,156,17,8,105,20,49,19,17,71,34
3084,285,229,19,149,46,15,104,97,17,11,56,7,24,14,11,45,11
3086,1576,1155,213,641,244,57,425,528,133,69,421,71,126,161,63,300,121
3087,3579,3053,356,1957,686,54,1561,1257,140,95,526,71,248,138,69,404,122
3101,1594,467,171,189,73,34,97,165,148,57,1127,291,326,256,254,1014,113
3102,12844,7355,1967,3279,1559,550,2274,2947,1341,793,5489,1766,1592,1192,939,4244,1245
3103,14268,8969,2535,4058,1817,559,3105,3364,1653,847,5299,1172,2005,1289,833,4179,1120
3104,13384,7833,1709,3824,1675,625,2647,3330,1070,786,5551,1773,1720,1239,819,4170,1381
3106,4140,3072,558,1698,636,180,1249,1315,265,243,1068,170,501,287,110,802,266
3109,3431,2529,564,1365,486,114,1126,945,217,241,902,219,328,193,162,722,180
3110,6269,5134,597,3083,1278,176,2485,2249,241,159,1135,212,378,306,239,877,258
3215,119,73,4,41,22,6,18,33,19,3,46,10,22,10,4,41,5
3216,811,597,109,303,154,31,212,294,59,32,214,22,89,68,35,168,46
3217,1161,737,150,355,180,52,239,328,105,65,424,109,144,125,46,319,105
3218,388,318,68,135,80,35,113,163,25,17,70,10,24,14,22,67,3
3220,2811,2006,453,1045,406,102,738,918,231,119,805,109,324,254,118,614,191
3221,702,509,70,296,124,19,177,249,62,21,193,23,67,76,27,143,50
3222,1993,1411,244,692,375,100,450,722,155,84,582,85,223,184,90,446,136
3223,1663,1073,206,542,250,75,339,547,137,50,590,162,192,170,66,419,171
3224,748,595,60,355,148,32,205,305,45,40,153,11,72,48,22,111,42
3225,1203,911,171,458,234,48,336,440,74,61,292,45,148,72,27,203,89
3226,197,128,6,62,46,14,33,74,12,9,69,13,11,32,13,41,28
3227,453,314,24,136,105,49,94,175,28,17,139,9,54,42,34,122,17
3229,2084,1560,201,824,444,91,655,721,105,79,524,18,234,159,113,421,103
3230,509,369,48,210,90,21,122,185,41,21,140,20,57,43,20,100,40
3233,103,69,0,48,15,6,36,28,5,0,34,0,22,6,6,25,9
3234,2305,1730,321,933,391,85,660,839,143,88,575,72,266,154,83,437,138
3235,3359,2232,524,1110,447,151,659,910,423,240,1127,233,274,431,189,901,226
3237,572,433,51,247,113,22,153,261,15,4,139,19,50,50,20,100,39
3240,419,291,44,149,81,17,101,139,33,18,128,24,58,34,12,97,31
3241,347,247,27,110,91,19,63,157,19,8,100,15,17,43,25,81,19
3242,1588,1036,156,668,166,46,489,340,114,93,552,141,180,126,105,417,135
3243,388,278,50,150,67,11,98,135,28,17,110,14,45,32,19,78,32
3244,2593,1796,306,939,458,93,609,860,243,84,797,175,264,251,107,614,183
3246,9652,6335,1063,2863,1880,529,2054,3007,799,475,3317,639,1027,965,686,2655,662
3251,584,325,64,153,77,31,95,156,39,35,259,49,75,91,44,212,47
3253,2688,1897,222,956,611,108,532,1018,208,139,791,147,254,171,219,671,120
3254,1859,1357,145,549,553,110,360,830,111,56,502,56,182,150,114,444,58
3255,728,515,53,265,163,34,173,275,29,38,213,26,76,71,40,163,50
3256,393,293,55,151,72,15,111,127,42,13,100,15,24,37,24,80,20
3257,1721,1190,52,426,498,214,254,831,67,38,531,58,124,146,203,489,42
3259,87,60,2,31,18,9,11,43,5,1,27,2,11,10,4,23,4
3260,182,136,5,76,46,9,40,72,10,14,46,2,18,24,2,35,11
3261,1403,1023,161,589,225,48,416,412,100,95,380,88,138,116,38,257,123
3262,402,213,55,107,42,9,77,86,37,13,189,49,76,49,15,134,55
3263,1504,1069,239,574,210,46,369,482,172,46,435,106,97,154,78,338,97
3264,2933,1905,308,989,463,145,727,837,224,117,1028,387,247,285,109,708,320
3266,813,560,91,275,161,33,201,271,56,32,253,28,100,72,53,186,67
3268,391,294,41,166,80,7,111,164,10,9,97,3,45,38,11,70,27
3269,974,750,85,436,196,33,245,399,66,40,224,33,82,83,26,163,61
3273,89,74,5,39,25,5,26,42,3,3,15,2,12,0,1,13,2
3275,4569,3170,641,1768,638,123,1259,1276,434,201,1399,268,515,354,262,1111,288
3276,3050,2097,402,1080,490,125,747,875,302,173,953,195,377,214,167,726,227
3278,1148,816,121,450,202,43,301,386,95,34,332,34,123,93,82,274,58
3279,338,235,42,119,65,9,76,112,26,21,103,19,40,30,14,83,20
3280,335,246,25,105,101,15,77,151,11,7,89,24,28,26,11,69,20
3281,2638,2150,415,1394,258,83,1134,779,157,80,488,107,216,119,46,349,139
3282,273,187,19,92,56,20,77,93,6,11,86,9,33,26,18,63,23
3284,143,110,23,52,29,6,38,56,16,0,33,7,10,9,7,28,5
3287,380,270,35,141,71,23,98,128,30,14,110,12,38,46,14,87,23
3290,1272,1037,187,617,212,21,469,425,80,63,235,0,150,65,20,178,57
3291,21,15,0,11,4,0,0,15,0,0,6,0,0,6,0,6,0
3301,12736,7337,1476,3689,1580,592,2503,3001,1273,560,5399,1392,1787,1137,1083,4436,963
3303,5432,3786,809,2044,742,191,1458,1465,503,360,1646,456,576,407,207,1228,418
3304,2291,2044,166,1322,509,47,1021,836,112,75,247,9,108,98,32,194,53
3307,1610,1269,245,752,246,26,534,496,157,82,341,27,181,90,43,245,96
3431,9884,5717,955,2785,1462,515,1751,2682,817,467,4167,1348,1048,1029,742,3082,1085
3440,1008,693,100,419,154,20,265,308,101,19,315,36,104,101,74,263,52
3441,123,72,4,34,29,5,17,48,0,7,51,16,25,6,4,27,24
3442,544,356,79,197,67,13,145,144,45,22,188,40,82,51,15,143,45
3443,227,178,29,81,52,16,67,82,12,17,49,5,29,8,7,41,8
3444,435,322,29,173,91,29,115,169,26,12,113,15,41,38,19,97,16
3445,198,158,27,89,38,4,53,77,18,10,40,9,11,12,8,28,12
3446,2189,1620,283,849,364,124,579,732,175,134,569,96,253,149,71,431,138
3447,795,572,62,324,147,39,225,268,42,37,223,40,91,62,30,164,59
3448,294,201,28,110,51,12,64,104,10,23,93,14,39,29,11,74,19
3449,700,486,47,249,134,56,187,247,26,26,214,30,65,76,43,183,31
3450,233,167,16,91,43,17,52,82,22,11,66,6,38,11,11,58,8
3451,1622,1079,178,575,266,60,366,489,153,71,543,89,154,184,116,402,141
3452,2113,1475,276,734,354,111,543,652,167,113,638,120,222,166,130,520,118
3455,1169,790,120,405,197,68,268,374,80,68,379,65,131,106,77,320,59
3456,286,226,34,107,79,6,82,122,12,10,60,14,23,11,12,46,14
3457,164,111,17,47,37,10,38,57,5,11,53,6,24,6,17,44,9
3458,2722,1828,287,930,455,156,689,800,226,113,894,129,333,254,178,740,154
3461,1514,1158,196,616,281,65,482,532,88,56,356,53,169,111,23,278,78
3462,699,499,55,268,153,23,158,281,50,10,200,51,72,44,33,161,39
3464,339,224,26,102,89,7,55,133,26,10,115,25,51,27,12,80,35
3465,816,557,89,308,121,39,211,238,55,53,259,79,77,68,35,185,74
3466,447,351,29,227,79,16,153,152,19,27,96,13,30,40,13,83,13
3467,579,448,60,241,119,28,168,236,17,27,131,19,54,43,15,100,31
3470,1787,1301,231,682,311,77,489,543,142,127,486,64,145,160,117,407,79
3561,2513,1607,260,861,375,111,519,709,246,133,906,153,252,305,196,783,123
3570,4660,2999,557,1316,844,282,800,1441,426,332,1661,219,386,521,535,1468,193
3574,924,589,108,330,137,14,203,263,94,29,335,68,154,72,41,248,87
3576,1585,997,212,462,252,71,308,484,135,70,588,99,195,164,130,489,99
3579,158,109,16,32,50,11,27,69,7,6,49,7,22,11,9,38,11
3580,535,338,27,141,144,26,99,181,34,24,197,35,66,66,30,159,38
3581,1447,906,99,479,245,83,337,424,69,76,541,113,117,132,179,464,77
3582,1155,792,140,378,221,53,230,373,125,64,363,47,108,114,94,297,66
3583,406,290,41,128,93,28,91,166,15,18,116,14,53,32,17,87,29
3584,1380,940,195,477,225,43,334,396,159,51,440,105,134,101,100,360,80
3585,1226,833,147,387,236,63,297,415,82,39,393,56,160,111,66,306,87
3588,679,504,80,283,113,28,163,273,44,24,175,22,72,51,30,144,31
3590,526,320,60,143,95,22,85,156,58,21,206,24,66,92,24,162,44
3592,510,350,41,176,122,11,102,202,30,16,160,22,38,72,28,135,25
3595,278,184,26,82,74,2,38,108,26,12,94,20,35,23,16,74,20
3598,1193,806,141,409,205,51,287,394,88,37,387,48,114,140,85,306,81
3601,149,114,12,73,25,4,47,42,14,11,35,12,5,16,2,25,10
3602,860,606,87,319,153,47,216,282,69,39,254,42,115,62,35,204,50
3603,2150,1509,309,744,342,114,476,752,188,93,641,67,206,277,91,505,136
3605,350,255,50,121,60,24,98,123,18,16,95,7,35,30,23,74,21
3607,113,71,4,30,27,10,20,46,2,3,42,0,7,33,2,36,6
3608,1219,860,96,424,281,59,296,441,81,42,359,55,98,105,101,287,72
3609,348,208,57,99,52,0,58,83,43,24,140,19,27,43,51,126,14
3741,1221,876,147,503,187,39,373,367,79,57,345,29,155,94,67,263,82
3743,5834,3578,710,1693,885,290,1084,1698,473,323,2256,370,714,639,533,1846,410
3745,649,465,47,257,131,30,154,249,42,20,184,16,67,52,49,145,39
3748,2480,1680,346,779,463,92,530,874,147,129,800,200,315,165,120,618,182
3750,319,255,0,141,90,24,108,136,11,0,64,0,14,36,14,47,17
3751,184,128,40,48,32,8,35,50,38,5,56,24,19,0,13,51,5
3752,292,230,29,113,67,21,68,124,27,11,62,5,23,29,5,49,13
3753,858,650,83,262,239,66,185,414,29,22,208,23,78,69,38,164,44
3755,2504,1512,144,834,372,162,687,669,105,51,992,418,208,216,150,679,313
3765,139,100,11,40,40,9,34,52,9,5,39,0,0,5,34,39,0
3766,3759,2117,462,1064,465,126,732,907,313,165,1642,504,513,331,294,1314,328
3768,786,548,72,276,170,30,202,274,41,31,238,42,82,66,48,191,47
3770,115,91,10,47,34,0,34,49,2,6,24,0,9,10,5,24,0
3771,300,232,12,124,76,20,62,153,12,5,68,8,17,17,26,57,11
3773,3003,2070,474,1001,470,125,713,920,269,168,933,155,288,311,179,731,202
3774,508,421,83,222,59,57,134,217,30,40,87,8,25,36,18,87,0
3777,355,243,52,114,60,17,81,130,19,13,112,28,20,42,22,86,26
3779,284,181,29,98,44,10,61,94,17,9,103,20,33,40,10,85,18
3780,179,135,34,50,43,8,50,68,1,16,44,0,0,27,17,28,16
3781,741,580,71,332,154,23,234,266,52,28,161,33,55,44,29,116,45
3782,1140,772,101,377,220,74,249,422,62,39,368,43,128,163,34,293,75
3784,1594,1021,281,469,202,69,394,381,207,39,573,270,173,85,45,480,93
3785,1368,805,159,359,261,26,256,410,91,48,563,92,149,169,153,447,116
3801,10226,5156,1132,2294,1282,448,1392,2640,694,430,5070,1438,1783,1151,698,3932,1138
3809,1465,1027,154,517,263,93,341,514,113,59,438,63,137,156,82,371,67
3810,216,168,32,56,59,21,18,109,28,13,48,8,24,16,0,40,8
3811,2326,1781,187,994,513,87,694,856,85,146,545,34,230,226,55,443,102
3812,362,228,25,122,71,10,77,101,28,22,134,28,59,30,17,105,29
3813,1119,747,102,449,159,37,313,304,60,70,372,45,129,120,78,306,66
3814,1438,1001,172,424,335,70,291,457,143,110,437,64,178,129,66,337,100
3815,161,137,23,80,28,6,66,56,4,11,24,4,17,3,0,18,6
3816,646,464,45,222,151,46,145,263,31,25,182,14,62,70,36,151,31
3817,268,160,25,78,45,12,49,84,14,13,108,17,43,30,18,83,25
3818,1327,869,194,322,282,71,252,400,134,83,458,81,188,143,46,361,97
3819,1387,1084,212,619,202,51,486,445,78,75,303,77,116,79,31,225,78
3820,12143,6971,1569,3461,1520,421,2380,2953,992,646,5172,2058,1555,917,642,3698,1474
3824,4356,2659,417,1476,605,161,1196,1112,305,46,1697,1013,316,218,150,792,905
3825,2571,1968,346,1166,415,41,830,798,232,108,603,120,259,195,29,417,186
3826,779,542,95,321,106,20,243,242,32,25,237,72,101,43,21,220,17
3827,925,743,97,425,194,27,324,337,31,51,182,25,96,36,25,124,58
3830,484,340,35,181,79,45,121,170,32,17,144,29,33,61,21,104,40
3832,150,110,11,60,31,8,35,68,2,5,40,3,21,10,6,37,3
3833,7460,5017,780,2749,1121,367,2042,2153,446,376,2443,366,760,701,616,2032,411
3835,1857,1358,322,708,235,93,519,558,179,102,499,77,137,216,69,401,98
3836,609,416,47,167,158,44,97,272,24,23,193,16,54,77,46,169,24
3837,355,273,16,184,44,29,103,140,19,11,82,12,32,30,8,60,22
3838,415,265,41,110,104,10,74,143,37,11,150,29,63,45,13,109,41
3839,1304,938,249,498,173,18,371,385,119,63,366,110,134,79,43,258,108
3840,1211,920,111,513,246,50,396,390,58,76,291,54,100,91,46,222,69
3841,2286,1782,238,1153,347,44,835,724,157,66,504,19,113,251,121,415,89
3842,6408,4020,651,1990,1114,265,1293,1949,424,354,2388,408,1036,627,317,1931,457
3844,719,555,61,304,153,37,223,283,25,24,164,26,51,68,19,118,46
3845,452,278,44,152,64,18,59,149,59,11,174,29,59,77,9,133,41
3846,371,231,18,87,97,29,60,146,12,13,140,32,47,37,24,108,32
3848,2132,1653,242,947,343,121,652,769,102,130,479,67,229,100,83,372,107
3849,597,418,61,243,96,18,173,187,26,32,179,33,88,40,18,135,44
3852,172,122,0,63,46,13,16,78,19,9,50,0,12,29,9,44,6
3853,265,182,11,67,78,26,34,133,6,9,83,15,24,21,23,70,13
3854,413,297,7,145,112,33,102,150,21,24,116,9,26,49,32,92,24
3855,805,630,98,355,148,29,260,294,52,24,175,23,74,50,28,131,44
3856,517,433,57,275,81,20,218,167,27,21,84,6,35,32,11,51,33
3857,3373,1955,471,1095,297,92,795,858,214,88,1418,729,332,232,125,926,492
3858,1509,1183,228,690,225,40,465,513,138,67,326,58,151,80,37,235,91
3860,1686,938,151,455,274,58,258,433,167,80,748,200,254,125,169,595,153
3862,1660,1232,87,666,394,85,441,628,48,115,428,56,147,141,84,332,96
3864,822,579,79,265,202,33,171,340,48,20,243,12,106,72,53,222,21
3865,2873,2157,374,1166,507,110,875,895,195,192,716,103,309,220,84,549,167
3867,9195,6177,1386,2927,1489,375,2119,2732,891,435,3018,667,922,794,635,2345,673
3868,2096,1409,279,750,320,60,463,625,215,106,687,65,303,241,78,545,142
3869,956,683,136,318,189,40,274,312,51,46,273,86,97,55,35,200,73
3870,2174,1458,112,715,473,158,463,834,88,73,716,127,256,187,146,593,123
3872,1115,832,177,401,230,24,268,405,115,44,283,8,91,130,54,219,64
3873,1706,1409,222,968,194,25,714,494,131,70,297,45,158,50,44,219,78
3874,3471,2217,423,958,665,171,679,1127,234,177,1254,191,397,421,245,1001,253
3875,184,136,19,66,32,19,56,60,11,9,48,7,23,12,6,34,14
3878,4685,3104,930,1427,580,167,1041,1294,564,205,1581,283,564,453,281,1235,346
3882,71,45,10,20,13,2,18,16,7,4,26,2,5,10,9,19,7
3883,100,68,4,33,27,4,26,34,4,4,32,2,18,8,4,24,8
3884,698,561,102,344,98,17,253,218,59,31,137,11,57,54,15,99,38
3885,2308,1766,223,1089,386,68,896,701,93,76,542,66,296,148,32,424,118
3886,759,492,76,232,141,43,146,247,64,35,267,53,81,82,51,204,63
3887,1578,1154,186,649,272,47,406,510,174,64,424,82,191,116,35,302,122
3894,2576,1739,186,749,575,229,497,994,177,71,837,86,239,264,248,727,110
3897,29,16,6,6,2,2,8,4,4,0,13,3,2,6,2,13,0
3901,2309,1695,347,958,310,80,798,623,186,88,614,166,198,181,69,472,142
3902,830,598,71,300,192,35,241,328,29,0,232,0,123,77,32,183,49
3903,2314,1726,180,970,468,108,695,832,85,114,588,74,229,177,108,477,111
3904,3292,1950,473,813,531,133,701,904,222,123,1342,226,525,319,272,1054,288
3905,782,559,55,286,142,76,198,315,23,23,223,54,96,34,39,139,84
3906,1609,1185,195,680,262,48,467,563,106,49,424,92,126,140,66,320,104
3907,668,346,21,110,171,44,47,259,21,19,322,22,120,120,60,263,59
3908,2418,1847,323,1117,322,85,869,749,170,59,571,122,170,192,87,445,126
3909,4403,3129,249,1627,996,257,1129,1625,166,209,1274,150,406,442,276,1075,199
4001,857,620,76,308,187,49,189,348,58,25,237,31,85,85,36,197,40
4002,2366,1806,291,952,467,96,632,945,140,89,560,75,164,220,101,434,126
4003,197,92,16,35,31,10,34,43,7,8,105,11,46,32,16,69,36
4005,8981,5587,1322,2579,1313,373,1690,2458,969,470,3394,926,1015,881,572,2603,791
4008,1043,760,130,467,129,34,294,359,73,34,283,36,117,94,36,222,61
4009,1929,1309,222,632,388,67,366,622,210,111,620,58,204,225,133,500,120
4010,496,339,40,176,91,32,118,166,25,30,157,17,78,38,24,112,45
4011,8158,5179,1048,2482,1186,463,1872,2327,682,298,2979,650,779,759,791,2514,465
4015,1345,974,159,528,257,30,358,451,107,58,371,93,152,70,56,280,91
4017,163,100,0,39,53,8,26,49,0,25,63,0,20,7,36,63,0
4019,46,39,9,11,11,8,5,22,6,6,7,0,0,3,4,7,0
4020,531,350,57,170,111,12,124,152,43,31,181,18,56,62,45,153,28
4021,1936,1571,156,1003,341,71,780,583,136,72,365,27,136,138,64,269,96
4022,427,292,39,151,86,16,96,139,43,14,135,13,43,49,30,101,34
4024,208,162,6,98,48,10,44,90,18,10,46,6,15,17,8,35,11
4027,1838,1441,227,835,304,75,508,641,204,88,397,41,155,129,72,309,88
4029,614,445,61,226,133,25,127,251,41,26,169,13,62,65,29,133,36
4030,547,452,90,261,93,8,148,217,66,21,95,0,13,38,44,77,18
4032,3103,2202,367,1231,501,103,818,971,272,141,901,145,327,265,164,691,210
4037,1317,899,141,455,246,57,308,440,90,61,418,57,114,169,78,344,74
4038,5586,4124,720,2414,756,234,1703,1645,487,289,1462,235,481,462,284,1150,312
4039,2471,1770,304,1034,329,103,700,889,146,35,701,217,235,162,87,489,212
4040,909,654,114,340,169,31,212,311,81,50,255,37,87,94,37,206,49
4041,527,380,64,204,94,18,140,155,59,26,147,20,57,48,22,105,42
4042,1521,1142,269,612,251,10,494,512,99,37,379,89,157,94,39,245,134
4043,4219,2902,415,1544,710,233,1097,1331,290,184,1317,115,364,432,406,1120,197
4046,2977,2117,296,1076,597,148,752,1071,164,130,860,98,330,273,159,703,157
4047,625,437,88,203,112,34,129,216,64,28,188,27,80,52,29,146,42
4048,856,603,144,297,123,39,215,268,77,43,253,49,88,73,43,182,71
4049,1116,880,159,516,174,31,358,352,102,68,236,43,96,50,47,165,71
4050,86,60,1,35,24,0,21,20,13,6,26,2,12,10,2,22,4
4051,551,398,54,205,120,19,132,206,30,30,153,11,56,45,41,116,37
4055,1271,955,159,480,260,56,307,465,129,54,316,35,108,79,94,280,36
4061,969,756,239,391,98,28,418,212,94,32,213,42,127,34,10,117,96
4062,5543,4027,899,2151,812,165,1564,1800,386,277,1516,262,478,494,282,1113,403
4064,4264,2230,481,1037,579,133,659,1100,327,144,2034,411,892,455,276,1665,369
4066,289,211,7,72,95,37,72,125,5,9,78,0,50,18,10,69,9
4068,570,420,73,210,111,26,126,191,64,39,150,25,45,54,26,118,32
4069,570,454,54,224,138,38,147,251,20,36,116,13,58,30,15,88,28
4071,1765,1366,272,710,331,53,543,636,111,76,399,67,161,131,40,280,119
4072,7642,5220,1139,2581,1162,338,1851,2470,651,248,2422,517,889,604,412,1856,566
4073,6378,4167,939,2014,920,294,1432,1679,693,363,2211,320,764,746,381,1786,425
4074,6424,4687,658,2665,1093,271,1892,2131,397,267,1737,286,728,484,239,1305,432
4076,923,683,78,364,199,42,219,377,53,34,240,46,80,37,77,174,66
4079,1849,1213,176,496,415,126,357,650,90,116,636,143,179,255,59,498,138
4083,1851,1231,306,598,229,98,467,475,197,92,620,115,175,179,151,495,125
4084,2607,2031,339,1144,463,85,792,879,202,158,576,149,171,151,105,402,174
4085,571,424,105,260,53,6,194,168,32,30,147,56,55,36,0,130,17
4086,3445,2508,510,1300,560,138,1009,1065,296,138,937,175,338,239,185,767,170
4087,694,522,148,245,98,31,214,234,57,17,172,17,101,41,13,141,31
4088,588,430,74,196,121,39,124,235,46,25,158,24,56,47,31,131,27
4090,3987,2670,326,1296,870,178,877,1447,150,196,1317,159,463,442,253,1052,265
4091,256,203,37,85,62,19,70,94,16,23,53,11,14,18,10,41,12
4092,6855,4298,943,2085,976,294,1443,1796,669,390,2557,518,785,645,609,2077,480
4093,1548,1156,206,710,198,42,464,476,109,107,392,67,164,107,54,260,132
4095,494,364,48,206,94,16,141,176,30,17,130,18,51,34,27,98,32
4096,3478,2367,275,1355,643,94,969,1027,224,147,1111,259,356,288,208,933,178
4097,1064,897,89,594,146,68,413,370,61,53,167,29,51,45,42,137,30
4101,9002,2652,992,1088,397,175,518,1006,693,435,6350,2526,2052,1136,636,4742,1608
4102,7808,3574,789,1730,800,255,1139,1447,620,368,4234,1661,1365,698,510,3081,1153
4103,12445,7185,1522,3650,1444,569,2515,3094,975,601,5260,1507,1716,984,1053,3920,1340
4105,3956,2841,250,1725,629,237,1321,1236,155,129,1115,156,239,371,349,902,213
4106,10089,6066,1152,3058,1465,391,2007,2792,723,544,4023,885,1254,998,886,3117,906
4107,3501,2606,211,1503,710,182,1062,1209,213,122,895,90,231,288,286,738,157
4108,421,220,30,147,43,0,85,78,43,14,201,30,102,52,17,162,39
4110,468,386,17,179,122,68,124,245,8,9,82,10,6,23,43,72,10
4210,9799,5961,1290,2913,1359,399,1905,2542,980,534,3838,908,1144,911,875,3116,722
4216,290,201,39,85,69,8,71,103,15,12,89,17,30,23,19,70,19
4217,1349,893,166,412,241,74,295,437,103,58,456,108,146,138,64,359,97
4219,596,429,66,228,109,26,168,206,33,22,167,28,58,47,34,133,34
4220,779,563,101,299,133,30,215,253,60,35,216,49,94,45,28,151,65
4221,601,432,55,236,115,26,177,176,37,42,169,14,73,44,38,140,29
4222,1232,993,186,586,187,34,430,447,77,39,239,43,136,40,20,151,88
4224,1223,880,140,420,243,77,278,438,82,82,343,28,112,113,90,280,63
4226,59,44,4,23,15,2,9,31,0,4,15,5,0,10,0,13,2
4228,254,198,45,110,31,12,90,57,37,14,56,8,25,13,10,46,10
4231,108,85,16,40,19,10,27,48,7,3,23,6,10,5,2,14,9
4236,1505,1189,187,750,220,32,443,555,145,46,316,53,91,139,33,230,86
4237,77,55,13,19,21,2,17,31,5,2,22,3,8,5,6,18,4
4238,391,301,36,189,61,15,124,113,33,31,90,14,41,25,10,72,18
4239,1973,1432,298,617,427,90,407,709,198,118,541,52,170,202,117,449,92
4240,15291,8713,2058,3636,2211,808,2333,4020,1567,793,6578,1445,2009,1826,1298,5494,1084
4250,1664,1084,240,557,235,52,378,468,152,86,580,167,131,185,97,463,117
4252,1950,1426,352,691,315,68,483,601,204,138,524,98,167,145,114,413,111
4253,848,612,92,295,188,37,220,302,48,42,236,47,98,74,17,199,37
4254,1074,660,159,258,198,45,175,259,159,67,414,91,112,120,91,355,59
4255,318,222,41,91,77,13,83,106,21,12,96,14,39,33,10,74,22
4256,1168,843,200,429,183,31,298,381,123,41,325,61,86,92,86,249,76
4257,1256,772,132,396,165,79,229,358,123,62,484,63,115,160,146,399,85
4258,801,649,115,376,137,21,273,285,59,32,152,32,50,47,23,96,56
4259,1108,844,166,503,147,28,375,355,67,47,264,61,74,96,33,194,70
4260,1772,1355,299,777,240,39,587,591,104,73,417,115,152,96,54,329,88
4261,186,125,6,70,39,10,34,75,14,2,61,13,25,15,8,41,20
4263,720,548,121,287,114,26,225,247,45,31,172,27,63,54,28,131,41
4265,341,239,19,136,68,16,77,82,48,32,102,5,23,55,19,96,6
4268,1985,1276,248,612,329,87,389,652,180,55,709,110,198,209,192,579,130
4270,2063,1520,301,761,358,100,548,718,175,79,543,44,260,143,96,390,153
4274,1843,1447,254,783,331,79,550,702,129,66,396,58,158,121,59,295,101
4275,210,173,12,87,61,13,45,100,16,12,37,0,15,16,6,33,4
4276,3001,1854,344,791,529,190,503,954,302,95,1147,183,322,304,338,1003,144
4280,2189,1761,421,923,345,72,571,864,287,39,428,65,175,130,58,372,56
4281,1989,1261,246,581,304,130,408,602,148,103,728,124,193,290,121,591,137
4282,1757,1396,258,761,323,54,598,593,125,80,361,93,118,92,58,265,96
4284,458,325,24,185,94,22,113,164,31,17,133,15,46,35,37,104,29
4285,180,135,8,76,45,6,47,72,11,5,45,6,13,12,14,39,6
4287,982,775,152,434,172,17,315,322,68,70,207,28,66,66,47,145,62
4289,656,468,99,221,123,25,145,222,73,28,188,37,55,58,38,142,46
4290,527,379,41,208,98,32,131,180,45,23,148,20,42,43,43,111,37
4292,337,262,33,148,64,17,71,136,31,24,75,9,30,20,16,60,15
4294,1770,1217,188,605,349,75,425,538,118,136,553,102,205,131,115,428,125
4330,10794,6347,1385,2879,1638,445,2001,2772,1036,538,4447,912,1494,1141,900,3675,772
4342,647,462,92,224,127,19,151,218,70,23,185,29,78,46,32,128,57
4344,1201,778,157,340,233,48,229,352,138,59,423,65,170,117,71,351,72
4345,4665,3148,653,1577,804,114,1156,1401,380,211,1517,284,543,398,292,1203,314
4346,909,591,146,263,126,56,179,265,119,28,318,57,75,124,62,242,76
4347,1146,610,60,359,146,45,197,262,102,49,536,118,192,122,104,473,63
4348,1124,816,123,439,200,54,261,407,101,47,308,59,124,98,27,242,66
4349,365,259,31,149,65,14,105,125,17,12,106,12,47,34,13,78,28
4350,1190,899,190,458,223,28,319,416,106,58,291,22,141,96,32,211,80
4351,952,717,80,381,197,59,261,360,65,31,235,30,100,47,58,196,39
4352,598,443,63,242,118,20,160,221,47,15,155,33,59,40,23,120,35
4353,865,625,131,298,168,28,244,286,53,42,240,33,111,58,38,180,60
4354,499,367,63,165,117,22,96,200,47,24,132,32,42,41,17,104,28
4355,916,709,100,387,182,40,289,306,84,30,207,31,99,53,24,167,40
4357,1290,905,224,443,219,19,307,432,144,22,385,85,168,76,56,313,72
4358,1444,1104,188,622,228,66,411,464,159,70,340,78,114,95,53,250,90
4360,209,153,13,87,42,11,58,81,3,11,56,5,17,16,18,49,7
4363,835,615,160,278,138,39,245,278,62,30,220,45,70,81,24,155,65
4364,2504,1740,259,868,466,147,580,777,223,160,764,110,283,232,139,589,175
4401,17179,9956,2317,5017,2074,548,3415,3978,1683,880,7223,1999,2344,1735,1145,5747,1476
4406,289,199,25,102,63,9,60,115,15,9,90,8,27,35,20,67,23
4408,69,42,13,18,10,1,16,13,11,2,27,7,6,11,3,22,5
4410,434,321,74,163,67,17,116,138,53,14,113,29,31,37,16,79,34
4411,511,362,72,164,105,21,132,180,17,33,149,34,54,43,18,111,38
4412,3879,2389,399,1179,588,223,814,1141,312,122,1490,342,522,356,270,1160,330
4413,74,58,7,26,19,6,13,31,10,4,16,5,4,4,3,13,3
4414,655,428,62,216,121,29,128,225,42,33,227,13,61,64,89,203,24
4416,1965,1312,291,589,363,69,428,666,162,56,653,124,216,173,140,539,114
4417,120,88,14,47,22,5,38,41,2,7,32,6,14,10,2,26,6
4418,521,389,87,220,73,9,150,188,43,8,132,38,56,33,5,88,44
4419,1345,1027,170,571,248,38,380,507,104,36,318,74,124,91,29,225,93
4421,374,220,13,87,73,47,50,136,11,23,154,53,27,47,27,114,40
4422,435,343,57,199,73,14,112,173,47,11,92,16,29,31,16,79,13
4423,117,80,13,44,23,0,25,38,12,5,37,6,23,8,0,27,10
4424,337,234,44,99,69,22,74,111,32,17,103,10,34,31,28,91,12
4426,2097,1460,273,697,377,113,502,676,176,106,637,64,217,182,174,525,112
4427,951,706,167,347,152,40,241,347,76,42,245,47,78,92,28,180,65
4428,1133,814,145,399,233,37,248,407,104,55,319,57,126,102,34,238,81
4429,1701,1212,132,746,275,59,427,617,109,59,489,84,166,180,59,368,121
4430,797,576,72,294,162,48,193,286,53,44,221,5,81,88,47,207,14
4431,63,49,5,24,18,2,13,25,3,8,14,2,5,6,1,11,3
4434,385,289,72,134,75,8,94,139,26,30,96,21,37,23,15,69,27
4435,384,293,61,135,80,17,98,161,18,16,91,5,41,27,18,72,19
4438,418,317,90,150,67,10,123,154,32,8,101,13,43,31,14,71,30
4441,637,384,48,197,117,22,103,203,66,12,253,23,71,82,77,219,34
4442,227,144,36,68,36,4,61,58,23,2,83,12,25,19,27,63,20
4443,1071,735,140,344,212,39,220,357,95,63,336,43,110,106,77,268,68
4444,2989,2196,300,1279,495,122,837,1031,209,119,793,167,269,228,129,604,189
4448,603,404,78,186,129,11,142,200,41,21,199,26,50,71,52,166,33
4449,494,384,84,201,90,9,151,175,37,21,110,28,57,17,8,72,38
4450,471,331,69,162,87,13,89,180,47,15,140,17,72,39,12,101,39
4451,90,61,2,36,23,0,19,40,2,0,29,2,4,17,6,27,2
4453,370,267,79,134,44,10,97,123,37,10,103,19,23,45,16,88,15
4455,326,266,41,124,76,25,98,136,23,9,60,10,21,18,11,48,12
4456,784,605,147,314,122,22,257,273,50,25,179,29,67,57,26,136,43
4457,2849,2053,353,995,563,142,603,1101,247,102,796,167,230,196,203,648,148
4459,339,232,32,109,82,9,87,105,18,22,107,8,32,34,33,91,16
4460,689,522,83,284,145,10,193,256,52,21,167,19,74,56,18,137,30
4461,1138,827,165,410,211,41,288,391,104,44,311,82,102,84,43,211,100
4462,2387,1613,219,740,527,127,412,901,191,109,774,101,232,220,221,675,99
4463,1170,770,136,351,219,64,187,405,137,41,400,48,79,144,129,328,72
4464,286,176,17,98,53,8,59,91,13,13,110,20,45,27,18,102,8
4468,4063,2517,574,1225,554,164,821,1126,351,219,1546,553,345,402,246,1116,430
4471,227,172,24,84,53,11,45,95,18,14,55,5,14,26,10,45,10
4472,1344,962,154,509,227,72,307,469,130,56,382,61,141,111,69,306,76
4473,2698,1326,229,606,363,128,380,608,200,138,1372,693,313,253,113,848,524
4474,1405,1072,197,567,258,50,410,525,78,59,333,62,126,96,49,279,54
4475,164,123,17,69,22,15,55,62,6,0,41,4,11,13,13,34,7
4476,319,219,24,103,70,22,81,117,13,8,100,13,38,28,21,81,19
4478,139,78,9,39,26,4,23,40,12,3,61,11,19,20,11,50,11
4479,546,357,56,164,106,31,97,182,48,30,189,18,57,53,61,157,32
4487,372,275,48,101,110,16,80,151,25,19,97,9,27,36,25,69,28
4488,384,275,54,139,68,14,105,118,32,20,109,24,40,36,9,82,27
4490,111,82,18,40,18,6,25,42,7,8,29,8,4,11,6,24,5
4493,306,223,33,122,59,9,79,124,12,8,83,6,27,42,8,67,16
4495,122,93,8,27,42,16,26,55,2,10,29,2,11,10,6,26,3
4496,1378,1038,188,570,220,60,383,481,110,64,340,88,121,100,31,255,85
4497,147,110,17,48,33,12,32,53,11,14,37,0,11,23,3,34,3
4530,5027,3032,622,1511,717,182,928,1329,562,213,1995,460,627,493,415,1608,387
4535,256,192,18,110,54,10,68,96,15,13,64,7,23,24,10,53,11
4537,878,638,104,297,184,53,228,293,51,66,240,36,73,81,50,180,60
4538,1204,691,84,295,251,61,189,384,76,42,513,52,104,178,179,432,81
4539,393,309,50,153,89,17,82,170,33,24,84,6,24,37,17,81,3
4541,7,7,0,0,0,7,0,7,0,0,0,0,0,0,0,0,0
4543,951,556,74,241,157,84,142,303,77,34,395,41,78,149,127,349,46
4544,281,193,12,79,84,18,38,135,5,15,88,5,23,34,26,88,0
4547,504,349,46,153,107,43,104,209,20,16,155,25,40,38,52,120,35
4548,429,280,51,125,87,17,93,154,20,13,149,33,47,42,27,124,25
4551,352,252,15,125,86,26,66,158,21,7,100,6,23,28,43,87,13
4553,737,511,56,258,141,56,164,271,46,30,226,37,49,84,56,189,37
4554,343,205,27,56,86,36,35,140,14,16,138,10,16,40,72,116,22
4555,675,461,46,251,136,28,155,221,57,28,214,26,84,60,44,176,38
4556,451,318,41,160,96,21,104,173,27,14,133,19,34,42,38,116,17
4558,213,146,18,56,48,24,38,73,23,12,67,15,15,28,9,57,10
4562,850,617,76,305,195,41,207,323,43,44,233,31,91,79,32,183,50
4563,539,380,81,157,107,35,104,214,43,19,159,36,54,42,27,125,34
4564,225,131,20,69,38,4,45,68,5,13,94,8,27,38,21,78,16
4568,238,153,9,64,57,23,27,104,17,5,85,7,25,34,19,66,19
4572,1987,1342,308,637,308,89,431,661,184,66,645,72,181,263,129,516,129
4573,167,128,14,48,52,14,43,77,6,2,39,5,9,13,12,35,4
4574,498,346,63,175,92,16,129,164,28,25,152,23,54,59,16,115,37
4576,337,216,24,76,69,47,52,148,10,6,121,4,36,41,40,104,17
4578,1793,1216,161,617,331,107,414,584,134,84,577,61,245,179,92,479,98
4579,1093,828,111,431,237,49,277,402,65,84,265,29,118,84,34,211,54
4605,4647,3096,525,1505,855,211,998,1514,383,201,1551,286,568,468,229,1249,302
4606,489,346,64,151,113,18,132,169,34,11,143,31,43,45,24,102,41
4607,757,527,107,220,148,52,170,271,54,32,230,51,68,71,40,176,54
4609,2109,1136,132,663,290,51,367,571,153,45,973,269,267,250,187,732,241
4611,229,188,30,84,53,21,57,101,18,12,41,3,23,13,2,31,10
4612,121,92,9,41,34,8,17,63,8,4,29,3,16,8,2,23,6
4613,159,128,35,50,39,4,53,58,15,2,31,5,7,8,11,25,6
4614,954,583,65,304,167,47,168,289,87,39,371,27,104,110,130,309,62
4615,74,56,5,30,9,12,22,28,3,3,18,7,0,11,0,18,0
4616,372,248,28,123,72,25,78,134,27,9,124,13,33,50,28,104,20
4617,373,250,30,109,84,27,73,149,21,7,123,5,42,45,31,98,25
4619,1495,905,153,437,233,82,292,452,107,54,590,89,132,188,181,498,92
4622,540,340,54,157,101,28,102,176,46,16,200,21,44,79,56,168,32
4623,447,295,69,133,84,9,99,145,36,15,152,24,51,54,23,126,26
4624,98,51,7,19,17,8,11,31,7,2,47,0,11,25,11,41,6
4625,28,14,1,6,5,2,2,11,1,0,14,2,3,7,2,7,7
4626,233,180,51,79,38,12,81,77,16,6,53,13,11,18,11,46,7
4627,481,318,48,143,98,29,99,171,39,9,163,8,50,65,40,141,22
4628,283,216,53,102,53,8,69,102,35,10,67,4,18,19,26,62,5
4629,23,18,0,15,0,3,4,12,2,0,5,0,0,5,0,0,5
4630,692,471,82,234,125,30,153,228,52,38,221,34,55,87,45,171,50
4631,754,445,67,194,147,37,107,214,63,61,309,40,116,91,62,248,61
4634,746,507,93,260,125,29,172,265,51,19,239,41,102,65,31,193,46
4635,13,6,2,1,3,0,0,6,0,0,7,0,2,5,0,7,0
4640,915,597,123,269,157,48,188,293,90,26,318,57,100,97,64,252,66
4642,33,25,2,5,14,4,2,23,0,0,8,3,2,0,3,5,3
4643,379,271,61,118,66,26,86,132,37,16,108,11,37,38,22,83,25
4645,34,20,3,10,7,0,11,9,0,0,14,6,8,0,0,8,6
4646,41,21,2,11,6,2,7,12,0,2,20,8,1,0,11,11,9
4648,233,167,25,81,46,15,74,76,5,12,66,9,19,32,6,60,6
4649,607,409,75,161,138,35,128,221,38,22,198,30,47,39,82,177,21
4650,105,78,8,34,26,10,22,40,10,6,27,5,7,8,7,25,2
4652,897,493,76,226,143,48,119,243,66,65,404,50,117,148,89,340,64
4653,248,144,27,70,37,10,39,86,16,3,104,17,51,20,16,76,28
4654,1499,865,154,394,234,83,231,417,143,74,634,164,136,200,134,517,117
4655,321,229,39,91,83,16,62,130,23,14,92,10,34,21,27,77,15
4657,143,96,15,38,36,7,22,56,6,12,47,2,29,7,9,40,7
4658,541,349,72,147,100,30,91,204,26,28,192,33,33,67,59,160,32
4660,591,379,52,173,126,28,126,211,18,24,212,46,83,36,47,177,35
4662,262,151,8,83,41,19,30,79,33,9,111,21,42,30,18,90,21
4664,184,132,27,67,38,0,41,65,18,8,52,7,20,13,12,42,10
4666,502,361,52,167,109,33,106,189,37,29,141,11,45,47,38,126,15
4667,543,379,85,209,70,15,119,140,85,35,164,32,54,49,29,129,35
4668,661,461,120,225,99,17,176,153,100,32,200,14,72,67,47,174,26
4669,66,46,8,17,21,0,15,28,0,3,20,2,5,6,7,20,0
4671,215,165,11,85,41,28,56,87,12,10,50,10,3,28,9,38,12
4672,14,9,9,0,0,0,0,9,0,0,5,0,0,0,5,5,0
4673,66,42,6,21,8,7,18,20,2,2,24,2,11,10,1,24,0
4674,193,138,27,67,36,8,45,71,20,2,55,5,26,15,9,44,11
4675,122,73,0,44,19,10,31,33,9,0,49,4,30,12,3,41,8
4676,411,267,47,127,80,13,100,127,25,15,144,26,43,34,41,124,20
4677,121,88,4,41,33,10,18,57,4,9,33,2,15,7,9,29,4
4679,992,611,61,329,182,39,233,261,64,53,381,62,95,120,104,332,49
4680,467,324,72,147,84,21,107,165,33,19,143,20,30,72,21,107,36
4681,702,453,70,206,139,38,145,221,60,27,249,40,67,73,69,200,49
4683,5,2,0,0,2,0,0,2,0,0,3,0,3,0,0,3,0
4684,550,396,87,166,109,34,122,203,53,18,154,12,55,60,27,117,37
4685,143,97,16,44,29,8,34,57,6,0,46,8,7,19,12,37,9
4691,133,92,15,37,32,8,22,59,6,5,41,10,9,15,7,40,1
4693,426,274,82,117,54,21,89,132,47,6,152,23,45,50,34,128,24
4694,1062,743,140,317,236,50,205,399,87,52,319,49,106,88,76,275,44
4730,4238,2858,544,1353,771,190,1021,1258,373,206,1380,172,354,446,408,1223,157
4732,711,468,79,240,112,37,163,239,37,29,243,43,53,105,42,204,39
4733,91,62,2,33,25,2,31,29,0,2,29,4,12,5,8,20,9
4735,258,185,20,86,63,16,61,108,8,8,73,8,26,23,16,65,8
4736,4282,2900,504,1332,855,209,904,1485,285,226,1382,206,425,444,307,1191,191
4739,420,271,45,123,80,23,63,142,47,19,149,29,29,41,50,129,20
4740,515,352,68,168,91,25,110,183,33,26,163,22,42,57,42,143,20
4742,1527,1036,178,495,288,75,288,543,153,52,491,64,139,157,131,442,49
4743,1971,1285,223,601,362,99,467,692,71,55,686,197,169,168,152,568,118
4745,484,354,57,176,103,18,145,168,21,20,130,23,42,43,22,124,6
4746,228,175,18,75,67,15,39,106,20,10,53,8,9,31,5,47,6
4747,543,377,46,169,113,49,114,207,27,29,166,32,46,47,41,128,38
4750,913,645,99,330,171,45,195,285,92,73,268,48,120,54,46,229,39
4756,1666,1039,132,489,336,82,321,571,91,56,627,92,222,208,105,555,72
4757,1126,824,132,417,226,49,278,449,74,23,302,67,118,64,53,240,62
4758,925,665,125,294,172,74,214,343,49,59,260,27,49,83,101,238,22
4759,76,50,4,20,23,3,15,35,0,0,26,4,11,11,0,18,8
4760,331,227,35,98,62,32,80,114,15,18,104,6,37,35,26,82,22
4762,214,152,10,86,49,7,45,82,12,13,62,8,18,12,24,52,10
4763,409,285,50,134,77,24,98,138,30,19,124,9,25,41,49,107,17
4764,30,22,0,13,7,2,2,17,3,0,8,0,0,6,2,6,2
4765,608,408,59,190,119,40,126,229,31,22,200,17,64,74,45,156,44
4766,162,116,6,54,38,18,36,64,10,6,46,12,8,9,17,28,18
4768,181,110,11,49,36,14,19,85,4,2,71,13,19,22,17,52,19
4769,3959,2448,513,1154,648,133,766,1199,375,108,1511,372,391,408,340,1238,273
4772,379,272,29,132,101,10,83,151,13,25,107,10,33,33,31,92,15
4773,336,274,32,140,102,0,88,152,34,0,62,10,21,21,10,55,7
4774,375,257,41,116,79,21,70,147,16,24,118,12,28,43,35,111,7
4776,371,295,33,152,85,25,98,175,22,0,76,6,18,22,30,68,8
4777,200,146,23,54,50,19,48,88,10,0,54,8,21,18,7,42,12
4779,73,49,4,26,16,3,13,28,6,2,24,3,9,12,0,20,4
4780,188,139,22,75,36,6,49,60,12,18,49,6,17,12,14,45,4
4781,210,163,32,89,32,10,65,74,14,10,47,10,10,23,4,41,6
4783,288,204,12,96,73,23,58,118,16,12,84,9,34,23,18,71,13
4785,1248,808,123,337,267,81,231,403,97,77,440,45,127,198,70,382,58
4786,712,500,90,215,158,37,147,276,52,25,212,16,69,79,48,187,25
4787,233,169,28,88,47,6,53,93,14,9,64,4,20,21,19,58,6
4841,3475,1985,440,938,437,170,566,865,389,165,1490,261,407,421,401,1264,226
4843,2386,1424,179,661,415,169,396,822,152,54,962,135,317,303,207,831,131
4847,512,381,77,200,86,18,141,182,44,14,131,18,59,29,25,106,25
4848,278,165,23,78,52,12,58,85,15,7,113,3,40,43,27,97,16
4849,1416,1002,170,469,308,55,331,544,86,41,414,37,173,128,76,330,84
4851,26,12,0,8,4,0,4,8,0,0,14,0,4,8,2,12,2
4852,46,19,4,12,3,0,6,11,2,0,27,15,8,2,2,22,5
4853,161,113,25,60,22,6,52,44,13,4,48,8,20,13,7,36,12
4854,700,460,60,184,157,59,107,274,49,30,240,32,74,59,75,201,39
4856,1388,939,143,484,220,92,354,456,116,13,449,71,128,152,98,381,68
4857,241,173,22,102,42,7,57,80,25,11,68,7,16,32,13,45,23
4858,585,416,57,199,115,45,115,250,33,18,169,41,45,59,24,130,39
4859,249,209,49,77,74,9,79,95,30,5,40,3,19,7,11,25,15
4860,633,373,32,166,130,45,99,222,39,13,260,27,68,88,77,231,29
4861,1421,882,142,435,218,87,255,438,131,58,539,91,140,161,147,458,81
4862,1345,986,177,512,233,64,355,453,115,63,359,61,135,100,63,282,77
4863,557,348,60,158,85,45,130,157,35,26,209,47,46,72,44,183,26
4864,1354,982,192,529,230,31,370,433,127,52,372,93,152,87,40,270,102
4901,10698,6494,1213,3129,1586,566,2016,2872,1080,526,4204,864,1256,1118,966,3480,724
4910,710,541,108,272,118,43,194,275,56,16,169,22,58,58,31,132,37
4911,751,493,140,203,122,28,187,205,76,25,258,23,75,103,57,200,58
4912,361,250,54,125,56,15,89,109,29,23,111,20,35,44,12,85,26
4915,3541,2259,469,1049,557,184,660,1081,352,166,1282,223,397,403,259,1048,234
4917,1186,879,153,472,216,38,310,424,113,32,307,61,92,95,59,229,78
4920,733,493,97,218,130,48,136,233,68,56,240,46,60,84,50,199,41
4921,614,400,102,185,102,11,143,189,49,19,214,36,72,69,37,174,40
4922,426,323,58,175,76,14,116,150,37,20,103,28,37,23,15,75,28
4923,207,157,15,79,45,18,52,85,16,4,50,14,19,17,0,39,11
4924,776,570,127,301,111,31,187,250,97,36,206,54,80,57,15,150,56
4925,46,30,2,17,7,4,16,14,0,0,16,7,4,3,2,7,9
4927,1285,964,203,499,217,45,301,503,141,19,321,88,102,78,53,248,73
4928,846,624,119,296,178,31,183,339,66,36,222,20,79,69,54,177,45
4929,319,222,63,91,57,11,73,113,23,13,97,18,49,19,11,68,29
4930,1783,1244,278,522,350,94,331,590,223,100,539,77,145,172,145,460,79
4932,417,313,50,169,79,15,96,163,33,21,104,24,45,21,14,73,31
4936,95,58,2,29,25,2,10,40,6,2,37,3,8,24,2,26,11
4937,2568,1782,373,948,385,76,713,753,208,108,786,170,294,199,123,595,191
4938,3525,2098,442,917,552,187,658,1004,318,118,1427,432,376,371,248,1034,393
4939,377,272,45,155,55,17,94,121,38,19,105,8,31,55,11,80,25
4941,604,434,84,221,106,23,173,184,51,26,170,35,82,34,19,129,41
4942,414,320,56,140,95,29,74,183,40,23,94,10,28,37,19,75,19
4943,696,484,81,241,135,27,138,246,72,28,212,37,69,71,35,168,44
4945,447,283,49,153,62,19,105,124,40,14,164,19,49,56,40,138,26
4947,769,495,84,254,133,24,186,219,48,42,274,76,88,58,52,209,65
4949,409,291,79,123,64,25,97,143,45,6,118,11,44,43,20,84,34
4950,1887,1267,233,579,373,82,419,631,147,70,620,94,187,174,165,518,102
4951,344,237,29,138,61,9,87,114,28,8,107,17,52,23,15,77,30
4952,663,497,110,233,121,33,155,263,49,30,166,34,38,61,33,138,28
4953,1271,851,175,416,202,58,277,398,113,63,420,60,102,148,110,344,76
4954,115,83,4,41,27,11,20,51,7,5,32,9,4,12,7,29,3
4955,529,364,49,197,100,18,127,181,35,21,165,28,53,60,24,119,46
4956,291,210,36,121,47,6,75,97,21,17,81,12,34,16,19,63,18
4957,1575,1175,228,574,311,62,437,544,118,76,400,82,141,88,89,282,118
4958,838,579,95,261,192,31,164,310,71,34,259,51,88,65,55,205,54
4961,343,229,33,115,69,12,64,107,41,17,114,10,56,32,16,85,29
4962,450,287,88,105,91,3,99,119,49,20,163,10,86,43,24,112,51
4963,2745,1949,406,956,509,78,701,882,285,81,796,167,266,195,168,627,169
4964,81,59,3,22,31,3,6,50,2,1,22,0,16,4,2,16,6
4965,775,549,103,235,179,32,186,265,57,41,226,23,89,74,40,187,39
4966,619,436,68,226,117,25,110,219,71,36,183,17,66,53,47,150,33
4967,1627,1150,290,507,287,66,445,480,151,74,477,87,147,135,108,398,79
4969,474,351,79,182,70,20,123,164,50,14,123,14,58,39,12,103,20
4970,565,364,49,180,105,30,113,200,36,15,201,34,57,71,39,157,44
4971,723,531,113,255,136,27,149,281,66,35,192,20,71,68,33,146,46
4973,475,322,73,154,66,29,101,163,44,14,153,29,72,33,19,113,40
4974,1153,751,148,348,212,43,211,389,114,37,402,36,138,138,90,331,71
4976,4184,2715,579,1279,662,195,838,1211,413,253,1469,247,511,472,239,1193,276
4978,372,287,41,138,94,14,92,157,29,9,85,16,31,22,16,64,21
4979,399,257,40,128,67,22,81,122,34,20,142,28,56,35,23,103,39
4981,888,630,108,317,181,24,182,331,75,42,258,40,87,90,41,203,55
4982,259,147,16,88,37,6,52,61,26,8,112,35,36,21,20,80,32
4983,695,483,86,254,123,20,140,235,71,37,212,30,50,76,56,162,50
4984,223,162,31,93,29,9,61,66,24,11,61,19,20,9,13,55,6
4985,52,33,0,11,19,3,3,27,3,0,19,8,9,2,0,8,11
4986,548,394,92,205,67,30,158,180,42,14,154,29,40,54,31,113,41
4987,362,276,55,145,72,4,95,133,30,18,86,14,34,27,11,67,19
4988,705,407,73,188,118,28,110,203,64,30,298,59,86,87,66,249,49
4989,1029,785,145,410,187,43,268,384,100,33,244,36,125,47,36,197,47
5001,3939,2492,433,1274,647,138,839,1138,326,189,1447,317,519,323,288,1181,266
5031,46,29,3,8,15,3,5,20,4,0,17,0,15,0,2,11,6
5032,1073,742,127,388,191,36,266,345,91,40,331,62,112,95,62,275,56
5033,1088,740,114,377,223,26,229,334,137,40,348,48,103,125,72,268,80
5034,119,76,18,34,22,2,26,33,15,2,43,1,12,18,12,35,8
5035,287,184,13,99,49,23,65,106,2,11,103,17,35,33,18,75,28
5036,407,307,44,158,95,10,97,167,30,13,100,11,36,36,17,73,27
5037,168,114,9,64,37,4,44,63,5,2,54,7,25,13,9,44,10
5038,517,339,53,167,89,30,97,155,56,31,178,25,53,54,46,144,34
5039,406,321,51,155,85,30,100,159,39,23,85,5,39,32,9,63,22
5040,167,132,29,70,27,6,54,52,18,8,35,0,17,9,9,29,6
5041,77,66,22,24,20,0,28,38,0,0,11,0,11,0,0,11,0
5042,234,178,29,82,57,10,50,94,16,18,56,0,14,29,13,47,9
5043,247,162,30,92,33,7,66,78,11,7,85,22,35,14,14,64,21
5045,653,457,87,240,112,18,166,206,50,35,196,25,70,69,32,142,54
5046,444,333,47,166,88,32,115,149,41,28,111,15,39,37,20,89,22
5048,741,512,82,304,94,32,216,236,48,12,229,40,95,65,29,152,77
5051,245,147,17,64,50,16,55,60,16,16,98,20,8,53,17,81,17
5052,86,70,13,32,14,11,24,31,11,4,16,4,12,0,0,16,0
5053,91,71,2,40,21,8,32,34,0,5,20,5,8,7,0,13,7
5054,82,66,9,47,5,5,30,24,12,0,16,2,4,8,2,14,2
5055,1348,942,97,596,200,49,470,378,88,6,406,73,87,169,77,328,78
5056,144,103,18,37,44,4,39,41,19,4,41,3,29,5,4,35,6
5058,36,27,4,4,19,0,7,20,0,0,9,3,0,0,6,9,0
5059,329,181,5,70,93,13,35,120,15,11,148,19,70,40,19,118,30
5060,1883,1224,187,604,305,128,417,525,146,136,659,113,194,150,202,537,122
5061,398,270,33,155,67,15,127,110,20,13,128,19,51,38,20,83,45
5062,300,203,24,109,51,19,72,108,10,13,97,19,36,18,24,79,18
5065,465,314,59,187,62,6,128,133,43,10,151,22,76,51,2,117,34
5067,84,60,8,32,18,2,23,26,6,5,24,7,7,5,5,15,9
5068,1300,757,122,425,160,50,266,367,90,34,543,260,156,71,56,421,122
5069,265,197,22,105,48,22,68,88,21,20,68,8,24,18,18,57,11
5070,178,130,24,68,32,6,55,58,15,2,48,5,19,17,7,45,3
5071,198,135,12,58,57,8,48,83,0,4,63,0,27,26,10,50,13
5072,199,144,10,83,37,14,40,75,15,14,55,10,28,14,3,49,6
5073,119,88,7,42,17,22,19,62,3,4,31,4,16,3,8,31,0
5074,49,46,5,28,9,4,19,16,5,6,3,0,3,0,0,3,0
5075,597,419,55,264,86,14,181,168,52,18,178,24,91,46,17,146,32
5076,201,142,35,64,29,14,54,71,16,1,59,10,19,18,12,40,19
5077,506,355,37,182,111,25,109,183,40,23,151,31,58,37,25,115,36
5079,254,169,30,100,24,15,74,67,22,6,85,21,49,12,3,61,24
5081,350,240,33,121,71,15,71,111,47,11,110,19,42,33,16,92,18
5083,87,55,14,24,15,2,15,25,10,5,32,2,12,14,4,32,0
5084,41,30,0,14,14,2,6,17,2,5,11,0,5,0,6,5,6
5085,80,65,12,34,14,5,17,37,3,8,15,3,7,2,3,12,3
5086,297,233,35,134,56,8,94,95,22,22,64,21,30,11,2,52,12
5088,316,203,20,121,43,19,89,60,21,33,113,50,22,21,20,102,11
5089,2310,1496,281,664,421,130,428,749,207,112,814,89,218,243,264,692,122
5091,1433,902,81,451,287,83,304,433,90,75,531,80,204,176,71,416,115
5101,2053,1325,245,638,311,131,449,573,182,121,728,156,187,213,172,631,97
5142,323,239,26,119,72,22,69,124,15,31,84,7,20,33,24,72,12
5143,1969,1331,156,694,383,98,413,675,166,77,638,95,227,180,136,506,132
5146,276,183,19,60,90,14,49,115,10,9,93,11,36,34,12,71,22
5148,326,213,17,104,80,12,67,121,23,2,113,26,29,34,24,80,33
5149,1161,719,114,316,221,68,187,377,83,72,442,69,125,166,82,373,69
5150,303,193,8,99,51,35,44,103,25,21,110,21,37,38,14,69,41
5151,513,373,73,188,83,29,153,176,23,21,140,9,51,58,22,115,25
5152,234,172,21,84,54,13,56,94,18,4,62,8,26,21,7,52,10
5153,342,221,34,109,60,18,68,111,23,19,121,22,42,41,16,81,40
5154,142,88,12,36,25,15,21,52,12,3,54,11,18,16,9,44,10
5155,459,282,55,118,77,32,86,142,34,20,177,44,68,44,21,129,48
5156,3888,2543,354,1188,727,274,784,1309,322,128,1345,211,397,392,345,1155,190
5158,345,235,48,119,51,17,101,94,24,16,110,14,25,46,25,87,23
5161,268,158,8,54,86,10,39,93,13,13,110,0,55,34,21,89,21
5201,6348,4095,818,1954,960,363,1329,1843,661,262,2253,482,688,678,405,1812,441
5250,1376,955,111,467,310,67,292,474,106,83,421,29,116,158,118,350,71
5251,773,537,40,227,215,55,176,274,52,35,236,19,79,77,61,183,53
5252,144,87,13,52,19,3,23,38,19,7,57,20,20,10,7,55,2
5253,250,176,16,108,37,15,55,87,22,12,74,25,19,10,20,66,8
5254,118,66,3,26,34,3,10,49,5,2,52,2,8,26,16,46,6
5255,1694,1096,148,560,326,62,374,512,144,66,598,112,167,178,141,504,94
5257,832,573,103,294,134,42,226,244,72,31,259,43,84,61,71,213,46
5260,89,83,8,46,12,17,8,30,28,17,6,0,0,6,0,6,0
5261,958,677,80,346,239,12,223,341,76,37,281,52,111,77,41,229,52
5262,969,700,87,348,223,42,288,333,33,46,269,31,105,76,57,215,54
5301,7130,4079,665,2234,922,258,1252,1819,766,242,3051,466,1223,799,563,2457,594
5340,298,202,27,96,65,14,71,104,12,15,96,28,28,29,11,67,29
5341,260,172,17,101,50,4,68,80,16,8,88,21,36,21,10,61,27
5342,229,165,35,65,59,6,77,71,11,6,64,10,12,25,17,52,12
5343,394,234,46,105,65,18,83,109,32,10,160,32,51,50,27,122,38
5344,37,25,6,13,6,0,7,8,6,4,12,0,6,6,0,8,4
5345,711,487,71,262,126,28,171,258,49,9,224,33,79,73,39,161,63
5346,2010,1342,191,777,302,72,537,576,154,75,668,123,315,155,75,518,150
5350,318,214,25,112,63,14,66,116,26,6,104,0,22,60,22,86,18
5351,57,42,2,30,10,0,17,20,5,0,15,4,8,3,0,12,3
5352,313,251,26,127,79,19,97,128,16,10,62,6,30,17,9,42,20
5353,419,292,30,152,86,24,103,125,28,36,127,12,53,40,22,98,29
5354,725,567,77,328,125,37,217,273,56,21,158,21,67,51,19,127,31
5355,278,179,31,95,49,4,68,80,23,8,99,10,41,27,21,76,23
5356,360,203,18,112,64,9,72,102,23,6,157,35,63,43,16,119,38
5358,57,39,8,16,6,9,16,19,2,2,18,2,2,7,7,8,10
5359,167,110,13,66,25,6,50,52,7,1,57,8,17,18,14,52,5
5360,110,73,7,40,23,3,35,35,1,2,37,10,13,11,3,31,6
5361,341,241,30,132,64,15,71,135,31,4,100,27,30,32,11,75,25
5362,132,91,4,51,30,6,30,43,8,10,41,7,21,6,7,31,10
5363,1001,618,71,299,205,43,183,303,87,45,383,82,153,102,46,319,64
5401,15891,7129,1785,3358,1507,479,2208,2926,1286,709,8762,4378,2320,1311,753,5657,3105
5403,6306,3748,627,2054,796,271,1481,1636,406,225,2558,775,628,632,523,1905,653
5404,2933,1509,487,611,324,87,451,629,292,137,1424,580,381,258,205,1084,340
5440,796,530,109,225,162,34,181,255,65,29,266,44,89,82,51,207,59
5441,167,134,17,86,21,10,40,53,23,18,33,6,10,17,0,22,11
5442,112,68,18,33,17,0,31,26,11,0,44,9,14,10,11,27,17
5443,2408,1719,310,1006,326,77,686,758,222,53,689,162,233,186,108,515,174
5444,524,412,91,215,83,23,188,194,24,6,112,37,54,15,6,71,41
5445,1262,1024,104,633,271,16,481,440,65,38,238,72,68,70,28,194,44
5446,6221,4260,1000,2333,824,103,1573,1892,575,220,1961,608,896,346,111,1401,560
5448,525,393,76,227,81,9,150,171,58,14,132,15,64,34,19,102,30
5450,1851,1316,267,670,321,58,514,551,166,85,535,112,180,138,105,401,134
5452,6974,5051,738,3034,1158,121,2229,2090,517,215,1923,595,721,409,198,1472,451
5454,1324,1031,236,642,139,14,503,397,73,58,293,42,142,39,70,221,72
5455,363,279,69,142,61,7,142,100,15,22,84,11,32,32,9,63,21
5456,474,345,74,168,89,14,145,141,32,27,129,15,52,32,30,93,36
5457,548,437,77,233,106,21,162,198,53,24,111,18,50,18,25,81,30
5458,788,581,85,304,161,31,221,285,42,33,207,33,81,68,25,159,48
5459,667,510,107,263,140,0,194,240,65,11,157,37,50,39,31,106,51
5461,1627,1217,213,753,225,26,547,470,116,84,410,125,194,59,32,273,137
5462,717,531,112,337,71,11,246,224,39,22,186,29,97,45,15,122,64
5463,217,155,18,60,71,6,49,79,15,12,62,17,21,19,5,49,13
5464,976,676,139,378,137,22,260,311,74,31,300,107,114,40,39,210,90
5465,1891,1508,204,939,344,21,783,586,77,62,383,81,175,80,47,273,110
5468,3977,3121,779,1745,517,80,1493,1138,327,163,856,171,440,154,91,576,280
5471,277,189,33,79,69,8,55,110,14,10,88,11,35,30,12,68,20
5472,619,461,70,259,110,22,187,203,40,31,158,35,59,46,18,97,61
5473,495,366,47,230,74,15,142,164,37,23,129,35,51,30,13,102,27
5474,332,237,22,124,70,21,67,138,21,11,95,20,46,22,7,63,32
5476,1242,884,192,423,198,71,277,393,143,71,358,68,97,124,69,287,71
5477,1705,1257,202,765,267,23,592,474,139,52,448,138,204,68,38,313,135
5478,5755,3959,958,1918,852,231,1453,1682,566,258,1796,335,584,549,328,1421,375
5482,2661,1883,189,1118,459,117,879,762,172,70,778,146,231,175,226,604,174
5483,466,371,73,196,93,9,162,156,43,10,95,25,35,25,10,68,27
5486,643,458,67,241,122,28,167,222,46,23,185,34,72,56,23,131,54
5487,548,404,98,232,52,22,197,142,45,20,144,41,57,36,10,93,51
5488,2720,1984,418,996,467,103,719,851,255,159,736,110,222,224,180,565,171
5489,1129,914,110,574,206,24,383,440,72,19,215,48,96,51,20,154,61
5491,2206,1620,283,848,401,88,602,749,159,110,586,100,190,169,127,465,121
5492,274,195,40,106,39,10,71,89,27,8,79,21,38,10,10,51,28
5494,636,492,84,297,100,11,226,200,49,17,144,32,69,33,10,90,54
5495,3183,2318,439,1296,454,129,1032,1009,176,101,865,110,327,314,114,648,217
5602,5421,3193,546,1723,698,226,1166,1385,454,188,2228,457,768,596,407,1820,408
5640,19,10,2,5,3,0,4,2,3,1,9,3,2,2,2,6,3
5641,7281,4552,968,2215,1099,270,1547,2073,669,263,2729,540,753,785,651,2296,433
5647,323,232,31,133,52,16,91,112,20,9,91,18,34,27,12,68,23
5648,177,125,10,70,35,10,60,49,8,8,52,5,27,16,4,43,9
5649,97,78,9,36,26,7,42,30,2,4,19,9,8,2,0,9,10
5650,365,237,38,156,43,0,82,105,38,12,128,24,62,29,13,87,41
5651,539,407,61,214,118,14,154,173,42,38,132,12,48,34,38,100,32
5652,245,185,39,98,41,7,73,69,35,8,60,10,17,31,2,47,13
5653,169,136,40,65,25,6,44,47,25,20,33,10,11,10,2,21,12
5654,474,332,93,162,67,10,119,129,72,12,142,17,49,51,25,100,42
5655,1122,759,139,364,194,62,255,344,101,59,363,72,124,98,69,289,74
5656,1185,680,184,329,118,49,249,253,116,62,505,197,151,93,64,323,182
5657,29,24,6,11,5,2,6,12,6,0,5,0,0,3,2,5,0
5658,579,392,74,216,93,9,159,154,60,19,187,30,74,60,23,136,51
5660,485,328,52,222,51,3,151,132,30,15,157,37,70,33,17,73,84
5661,2224,1401,215,767,333,86,474,611,207,109,823,222,251,220,130,608,215
5663,1978,1385,197,766,354,68,480,662,177,66,593,175,174,132,112,447,146
5664,139,100,7,56,26,11,39,37,18,6,39,7,14,6,12,39,0
5666,25,19,5,13,1,0,10,9,0,0,6,0,2,4,0,6,0
5667,947,620,134,341,112,33,229,231,111,49,327,78,139,78,32,234,93
5669,171,126,25,58,41,2,49,58,11,8,45,11,20,12,2,27,18
5672,1897,1128,110,649,305,64,384,587,115,42,769,192,244,219,114,556,213
5673,1054,667,91,366,167,43,219,359,77,12,387,117,122,101,47,289,98
5674,741,432,57,232,129,14,160,214,40,18,309,86,106,102,15,239,70
5675,359,263,30,155,63,15,93,139,23,8,96,28,20,38,10,68,28
5676,1949,1244,247,720,236,41,464,553,179,48,705,170,284,120,131,548,157
5677,730,551,68,323,119,41,204,272,40,35,179,52,34,93,0,128,51
5678,35,35,4,10,11,10,0,21,14,0,0,0,0,0,0,0,0
5679,1137,840,167,431,216,26,303,411,94,32,297,65,101,86,45,229,68
5680,741,556,150,292,96,18,228,214,83,31,185,35,80,50,20,130,55
5681,116,77,14,44,17,2,24,40,10,3,39,9,20,4,6,23,16
5682,455,329,40,199,85,5,111,165,38,15,126,15,61,41,9,99,27
5701,9408,5652,1037,2746,1372,497,1758,2423,915,556,3756,808,1135,969,844,3175,581
5730,136,99,24,49,21,5,39,41,14,5,37,5,18,9,5,31,6
5732,280,134,21,72,31,10,37,81,16,0,146,31,38,59,18,105,41
5733,2278,1564,292,772,402,98,520,751,192,101,714,113,209,244,148,538,176
5734,471,360,63,170,96,31,120,180,35,25,111,24,37,25,25,85,26
5735,1466,1035,144,599,255,37,335,462,133,105,431,129,130,122,50,294,137
5736,146,98,13,50,22,13,31,42,16,9,48,8,5,26,9,34,14
5737,264,197,13,106,69,9,78,94,12,13,67,12,35,12,8,45,22
5738,455,341,32,191,94,24,119,177,25,20,114,20,46,38,10,90,24
5739,509,362,80,145,111,26,126,170,33,33,147,27,60,33,27,115,32
5742,204,152,19,89,40,4,56,79,11,6,52,4,19,21,8,45,7
5743,1754,1196,255,562,310,69,401,517,186,92,558,83,200,159,116,450,108
5744,249,174,29,92,50,3,54,91,29,0,75,27,25,18,5,57,18
5746,28,23,0,16,7,0,8,13,0,2,5,3,0,2,0,2,3
5747,114,95,12,52,26,5,34,34,14,13,19,5,8,6,0,14,5
5748,154,106,10,49,19,28,18,62,16,10,48,5,7,27,9,46,2
5750,37,24,0,12,7,5,7,12,0,5,13,0,8,5,0,13,0
5751,506,281,31,138,97,15,95,147,28,11,225,75,94,56,0,173,52
5753,3397,2097,304,1050,584,159,782,942,239,134,1300,287,377,342,294,1077,223
5757,355,249,36,120,80,13,96,116,13,24,106,22,29,36,19,84,22
5758,321,221,42,99,60,20,81,104,26,10,100,13,33,32,22,73,27
5759,852,579,51,312,182,34,175,318,50,36,273,49,98,106,20,216,57
5760,430,337,49,174,103,11,137,155,28,17,93,6,36,31,20,72,21
5761,429,292,41,146,91,14,98,155,22,17,137,20,32,46,39,118,19
5762,188,124,26,55,26,17,42,65,12,5,64,14,28,20,2,47,17
5763,1145,792,154,414,175,49,298,355,101,38,353,58,120,89,86,263,90
5764,1306,870,121,417,250,82,306,398,92,74,436,74,136,130,96,354,82
5765,781,540,91,268,123,58,209,221,56,54,241,31,75,62,73,201,40
5766,232,165,34,96,29,6,60,70,27,8,67,13,29,18,7,53,14
5767,513,335,49,153,97,36,96,177,44,18,178,23,75,55,25,145,33
5769,432,303,58,146,80,19,100,140,43,20,129,28,46,39,16,106,23
5770,396,294,50,148,76,20,104,136,33,21,102,16,45,25,16,72,30
5772,233,155,20,66,64,5,49,77,14,15,78,8,19,21,30,66,12
5773,926,666,101,328,192,45,217,351,55,43,260,31,87,84,58,213,47
5774,438,296,33,146,94,23,93,170,16,17,142,20,39,52,31,118,24
5775,266,172,21,83,46,22,48,85,27,12,94,11,34,29,20,76,18
5776,66,53,15,18,17,3,22,24,6,1,13,0,2,0,11,13,0
5777,1415,994,167,517,246,64,376,403,117,98,421,80,135,117,89,339,82
5778,278,208,44,103,51,10,84,76,24,24,70,9,31,21,9,57,13
5819,3842,2442,473,1250,547,172,864,1107,320,151,1400,241,335,442,382,1168,232
5820,130,88,35,30,17,6,27,48,11,2,42,8,11,22,1,40,2
5821,580,388,40,210,92,46,154,196,34,4,192,11,68,72,41,164,28
5822,710,484,92,261,109,22,188,206,65,25,226,26,62,74,64,187,39
5824,292,186,43,82,48,13,65,93,17,11,106,21,31,39,15,73,33
5825,50,35,10,11,11,3,11,10,11,3,15,3,10,2,0,6,9
5826,342,251,37,117,81,16,86,137,20,8,91,11,33,28,19,70,21
5827,102,68,6,40,17,5,27,33,6,2,34,10,13,9,2,21,13
5828,787,563,84,281,152,46,230,264,50,19,224,23,77,68,56,187,37
5829,741,534,77,287,129,41,175,215,98,46,207,37,43,43,84,179,28
5830,592,422,99,160,131,32,157,181,51,33,170,22,61,47,40,136,34
5832,354,249,29,146,65,9,81,136,18,14,105,27,42,22,14,78,27
5833,67,44,10,24,10,0,10,19,15,0,23,12,4,5,2,15,8
5836,458,337,65,187,76,9,128,139,42,28,121,18,61,27,15,91,30
5837,113,87,19,38,18,12,36,34,9,8,26,4,6,13,3,18,8
5839,305,220,41,102,68,9,81,104,21,14,85,21,29,22,13,63,22
5840,31,31,3,14,11,3,13,18,0,0,0,0,0,0,0,0,0
5841,171,102,7,51,27,17,31,54,7,10,69,6,17,21,25,59,10
5842,149,117,31,43,26,17,45,53,8,11,32,3,9,16,4,32,0
5843,1012,698,152,357,140,49,238,266,135,59,314,47,108,86,73,241,73
5845,412,334,60,172,85,17,136,148,35,15,78,13,34,24,7,61,17
5846,541,364,73,171,90,30,109,171,58,26,177,13,51,59,54,146,31
5847,271,197,41,96,49,11,81,80,23,13,74,12,29,26,7,63,11
5851,2375,1594,259,828,403,104,548,707,243,96,781,186,176,235,184,611,170
5853,207,147,36,73,32,6,57,69,21,0,60,10,15,30,5,41,19
5855,3204,2040,402,955,526,157,643,926,332,139,1164,240,301,395,228,969,195
5857,566,411,73,197,116,25,125,218,51,17,155,31,53,55,16,118,37
5858,151,115,27,47,41,0,25,57,27,6,36,3,19,10,4,25,11
5859,707,491,108,225,123,35,183,212,63,33,216,46,55,78,37,142,74
5860,983,687,128,310,184,65,219,338,80,50,296,38,93,88,77,259,37
5866,257,190,55,84,44,7,78,89,19,4,67,8,30,22,7,40,27
5867,313,242,44,131,49,18,104,93,21,24,71,9,24,31,7,52,19
5868,46,38,7,19,9,3,16,15,3,4,8,0,0,2,6,8,0
5871,613,436,103,207,98,28,143,209,62,22,177,33,58,73,13,136,41
5872,273,207,37,118,37,15,46,101,42,18,66,16,18,25,7,53,13
5873,220,160,28,82,36,14,66,65,25,4,60,8,30,16,6,37,23
5874,194,139,14,77,41,7,38,78,14,9,55,13,26,8,8,40,15
5875,234,146,28,60,47,11,52,71,15,8,88,16,23,45,4,73,15
5902,93,61,11,34,10,6,15,31,12,3,32,9,7,14,2,27,5
5903,409,309,49,163,74,23,122,125,33,29,100,10,28,40,22,88,12
5904,172,112,23,60,22,7,38,45,19,10,60,5,18,26,11,46,14
5905,318,227,24,134,64,5,79,105,23,20,91,7,25,34,25,78,13
5906,419,304,50,148,85,21,98,139,37,30,115,35,30,26,24,88,27
5907,58,19,3,6,10,0,6,13,0,0,39,4,8,20,7,30,9
6001,6323,4509,374,2458,1282,395,1924,2201,200,184,1814,283,577,618,336,1527,287
6002,7914,5152,645,2263,1673,571,1349,2405,620,778,2762,219,804,851,888,2391,371
6010,24939,16230,3785,7488,3864,1093,5153,7154,2321,1602,8709,1941,2798,2132,1838,7197,1512
6013,2859,2444,384,1420,562,78,1113,1103,116,112,415,69,163,163,20,315,100
6016,2041,1396,251,720,332,93,567,616,106,107,645,143,203,189,110,521,124
6018,1131,738,144,342,188,64,234,322,118,64,393,78,92,85,138,381,12
6019,1677,1089,177,565,295,52,406,532,96,55,588,100,239,114,135,515,73
6020,130,113,11,81,14,7,66,41,6,0,17,0,13,4,0,13,4
6021,108,72,10,41,15,6,37,29,2,4,36,7,18,10,1,28,8
6022,1699,1286,143,750,313,80,489,618,88,91,413,137,130,99,47,324,89
6023,496,400,67,250,70,13,189,120,21,70,96,8,38,28,22,88,8
6024,215,138,34,76,24,4,83,52,0,3,77,32,0,30,15,22,55
6026,1858,1351,166,779,332,74,592,590,108,61,507,79,170,170,88,407,100
6027,503,430,48,256,98,28,183,180,35,32,73,9,27,25,12,59,14
6029,5170,3454,549,1967,713,225,1449,1584,225,196,1716,596,610,334,176,1388,328
6031,686,458,48,203,149,58,160,243,26,29,228,9,104,78,37,189,39
6032,6657,4278,493,2164,1217,404,1621,2134,247,276,2379,560,761,504,554,1955,424
6033,10495,7691,911,4382,1856,542,3399,3294,575,423,2804,464,844,789,707,2426,378
6035,2765,2089,296,1159,529,105,867,984,151,87,676,87,247,205,137,523,153
6037,6291,4769,536,2514,1309,410,1926,2249,262,332,1522,161,459,444,458,1319,203
6039,960,563,45,296,155,67,177,308,54,24,397,28,128,131,110,329,68
6040,23189,14152,3309,6643,3066,1134,4391,5907,2377,1477,9037,2578,3111,1700,1648,7194,1843
6043,1901,1438,121,804,408,105,545,730,99,64,463,85,194,117,67,377,86
6051,11635,6677,2163,2795,1237,482,1551,2008,2173,945,4958,996,1609,1216,1137,4204,754
6052,3242,1996,443,841,447,265,600,892,233,271,1246,303,400,334,209,982,264
6053,13727,8443,2051,3557,1822,1013,2244,3355,1492,1352,5284,1675,1433,1117,1059,4258,1026
6057,1910,1474,170,811,391,102,600,684,47,143,436,132,134,102,68,353,83
6058,710,485,62,234,159,30,170,247,32,36,225,21,87,65,52,172,53
6059,387,284,6,157,98,23,82,190,6,6,103,11,33,51,8,74,29
6060,762,682,57,429,167,29,352,287,18,25,80,7,44,29,0,63,17
6062,7339,4665,776,2297,1207,385,1457,2207,532,469,2674,735,866,615,458,2297,377
6063,259,200,17,112,59,12,75,101,7,17,59,27,10,7,15,46,13
6065,73,58,8,21,29,0,22,33,3,0,15,0,15,0,0,13,2
6066,12301,7354,1523,3462,1868,501,2373,3424,977,580,4947,1484,1583,1084,796,4050,897
6067,7555,4501,700,2254,1186,361,1565,2242,334,360,3054,965,997,682,410,2444,610
6068,554,349,52,159,110,28,136,143,52,18,205,10,47,69,79,190,15
6069,1146,717,74,323,238,82,233,366,67,51,429,67,166,122,74,348,81
6070,5356,4081,456,2341,1036,248,1899,1727,278,177,1275,166,369,400,340,1110,165
6071,2935,2331,236,1260,672,163,989,1030,129,183,604,75,188,228,113,464,140
6073,1752,1344,130,809,316,89,663,571,42,68,408,71,185,101,51,337,71
6074,8935,6808,816,3813,1813,366,3010,2820,397,581,2127,413,789,609,316,1753,374
6076,4633,3277,591,1802,693,191,1186,1397,428,266,1356,255,446,323,332,1079,277
6078,3503,2462,288,1291,620,263,979,1138,143,202,1041,145,245,339,312,900,141
6081,590,376,67,207,88,14,128,172,41,35,214,35,109,26,44,187,27
6082,16384,11417,1898,5478,3312,729,3983,5132,1268,1034,4967,1070,1638,1336,923,4100,867
6084,4583,3779,541,2199,936,103,1783,1710,155,131,804,170,361,191,82,597,207
6085,2637,1933,291,1176,393,73,918,755,187,73,704,126,229,226,123,572,132
6088,2039,1151,202,490,359,100,253,549,130,219,888,194,413,196,85,710,178
6089,1224,899,119,516,224,40,422,424,14,39,325,87,135,68,35,274,51
6090,267,210,33,113,46,18,106,92,0,12,57,8,32,17,0,30,27
6091,213,167,21,91,45,10,70,74,4,19,46,2,23,14,7,34,12
6092,1365,1236,64,699,392,81,615,514,68,39,129,0,64,51,14,95,34
6093,1142,900,96,483,286,35,318,436,52,94,242,31,93,68,50,186,56
6095,10582,7650,887,4152,1993,618,2646,3414,819,771,2932,523,953,887,569,2470,462
6096,4936,3325,546,1615,896,268,1006,1578,402,339,1611,280,536,473,322,1325,286
6098,5698,3955,704,2045,948,258,1420,1743,407,385,1743,250,630,437,426,1412,331
6103,363,88,16,56,8,8,22,36,30,0,275,74,111,90,0,254,21
6105,9806,4069,1591,1569,742,167,725,1094,1532,718,5737,1752,2201,1261,523,4889,848
6106,13976,8705,3066,3852,1372,415,1762,1954,3404,1585,5271,1240,1774,1475,782,4433,838
6107,7458,5229,560,2656,1417,596,2121,2475,279,354,2229,341,583,558,747,1978,251
6108,9295,5740,1448,2690,1209,393,1593,1916,1397,834,3555,765,1484,819,487,2893,662
6109,11210,7420,910,3248,2266,996,2300,3729,555,836,3790,532,956,1058,1244,3403,387
6110,4942,3196,665,1417,729,385,951,1322,541,382,1746,278,556,390,522,1508,238
6111,11999,8266,1163,3948,2313,842,2730,3995,667,874,3733,617,1154,1121,841,3205,528
6112,7741,5617,1433,2501,1411,272,776,1225,2227,1389,2124,319,713,759,333,1859,265
6114,9303,6293,2080,2843,1037,333,1536,1558,2234,965,3010,595,1127,744,544,2467,543
6117,5378,3841,266,1864,1167,544,1529,1888,213,211,1537,72,366,399,700,1358,179
6118,10929,7174,1251,3139,2057,727,1905,3146,1140,983,3755,674,1234,1096,751,3223,532
6119,6590,3602,600,1945,772,285,1404,1434,370,394,2988,991,823,574,600,2339,649
6120,4071,2832,961,1266,530,75,248,403,1484,697,1239,146,400,454,239,1090,149
6226,6521,3809,1158,1711,667,273,1077,1270,991,471,2712,765,836,618,493,2139,573
6231,1188,978,145,596,220,17,387,461,60,70,210,66,75,58,11,147,63
6232,1140,862,129,533,172,28,365,383,67,47,278,78,130,36,34,215,63
6234,1710,1361,271,656,359,75,522,646,126,67,349,62,152,76,59,264,85
6235,216,140,17,92,27,4,71,53,4,12,76,6,39,9,22,63,13
6237,1874,1465,185,826,339,115,562,712,93,98,409,51,165,147,46,323,86
6238,4292,3266,494,1953,715,104,1358,1433,303,172,1026,255,322,275,174,796,230
6239,4951,3288,689,1633,716,250,1116,1261,552,359,1663,366,471,471,355,1347,316
6241,2560,1714,434,773,425,82,475,808,301,130,846,160,251,312,123,647,199
6242,508,372,43,205,89,35,143,187,24,18,136,27,36,41,32,114,22
6247,872,658,89,380,151,38,270,307,49,32,214,29,114,39,32,153,61
6248,1796,1482,223,978,242,39,785,599,68,30,314,67,72,73,102,256,58
6249,2456,1954,275,1106,460,113,829,806,149,170,502,50,272,92,88,385,117
6250,1769,1182,156,662,270,94,474,613,71,24,587,126,241,161,59,423,164
6254,680,522,86,291,129,16,201,256,35,30,158,19,45,52,42,133,25
6255,1937,1377,246,715,342,74,432,640,191,114,560,73,163,184,140,461,99
6256,1320,943,188,515,181,59,259,484,123,77,377,77,127,117,56,260,117
6259,1528,1141,173,616,266,86,492,509,73,67,387,78,137,117,55,306,81
6260,3637,2273,491,1065,560,157,729,980,349,215,1364,322,345,365,332,1110,254
6262,191,132,11,44,54,23,25,102,5,0,59,0,6,15,38,53,6
6264,60,33,2,23,6,2,14,15,4,0,27,4,15,8,0,17,10
6266,137,122,16,67,39,0,16,71,26,9,15,0,15,0,0,8,7
6268,3293,1886,300,896,514,176,700,908,154,124,1407,655,249,264,239,862,545
6269,64,38,4,20,9,5,20,18,0,0,26,0,9,10,7,26,0
6277,1379,1004,165,524,260,55,506,355,54,89,375,50,120,127,78,310,65
6278,1601,1119,217,629,227,46,487,465,91,76,482,143,125,165,49,329,153
6279,2352,1439,292,770,345,32,573,653,133,80,913,488,252,114,59,482,431
6280,1287,847,108,440,248,51,268,449,65,65,440,99,146,120,75,327,113
6281,2276,1689,183,935,455,116,626,851,121,91,587,89,185,139,174,471,116
6282,499,375,103,176,52,44,195,97,40,43,124,31,57,28,8,106,18
6320,10193,5423,1680,2305,1013,425,1256,1734,1654,779,4770,1373,1691,980,726,3834,936
6330,1397,1021,201,558,214,48,400,442,114,65,376,81,113,118,64,291,85
6331,1731,1353,210,776,300,67,583,609,94,67,378,36,159,118,65,287,91
6333,2062,1702,102,1112,436,52,821,688,106,87,360,54,79,145,82,278,82
6334,856,656,85,326,193,52,242,318,47,49,200,40,94,41,25,164,36
6335,2493,1948,269,1056,545,78,802,862,167,117,545,79,226,167,73,434,111
6336,19,11,4,3,0,4,4,7,0,0,8,3,5,0,0,5,3
6339,2796,2177,382,1154,560,81,821,985,237,134,619,150,244,165,60,440,179
6340,12219,7769,2840,3126,1339,464,3075,2903,1203,588,4450,1167,1401,995,887,3706,744
6351,4449,3152,516,1802,663,171,1087,1366,443,256,1297,285,397,416,199,1040,257
6354,2121,1499,374,732,302,91,487,604,278,130,622,144,223,173,82,476,146
6355,4915,3347,455,1620,1007,265,1146,1743,198,260,1568,318,555,455,240,1274,294
6357,4250,2837,470,1260,896,211,878,1498,294,167,1413,212,544,345,312,1193,220
6359,1827,1421,159,787,428,47,501,676,163,81,406,59,174,135,38,302,104
6360,15716,9841,2245,4805,2130,661,2969,3824,1947,1101,5875,1230,1944,1529,1172,4778,1097
6365,504,370,79,175,83,33,103,217,28,22,134,36,50,41,7,100,34
6370,2364,1860,286,1112,414,48,750,876,137,97,504,46,202,211,45,377,127
6371,3816,2788,257,1331,940,260,941,1502,208,137,1028,78,348,373,229,862,166
6373,101,70,27,27,8,8,20,34,12,4,31,4,18,5,4,27,4
6374,3132,2317,512,1225,503,77,872,956,311,178,815,116,320,245,134,642,173
6375,1138,818,111,352,260,95,235,431,63,89,320,20,91,106,103,280,40
6376,22,15,0,0,15,0,0,15,0,0,7,0,0,7,0,7,0
6377,894,682,160,377,123,22,329,211,89,53,212,54,84,43,31,160,52
6378,2408,1572,138,718,584,132,473,827,133,139,836,174,246,242,174,705,131
6379,3630,2358,386,1156,597,219,817,1016,234,291,1272,240,396,337,299,1116,156
6380,1266,758,211,356,119,72,223,277,172,86,508,111,144,145,108,444,64
6382,4047,2822,581,1276,736,229,940,1252,345,285,1225,239,483,287,216,994,231
6384,1514,1116,205,580,269,62,446,515,102,53,398,122,116,97,63,292,106
6385,6402,4406,429,2226,1292,459,1417,2192,390,407,1996,252,636,618,490,1713,283
6390,135,67,7,38,15,7,18,36,13,0,68,7,38,15,8,53,15
6401,7520,5023,1062,2434,1138,389,1669,1982,793,579,2497,532,744,567,654,2142,355
6403,2032,1446,314,752,316,64,631,648,84,83,586,155,246,108,77,460,126
6405,12558,7750,1015,3902,2062,771,2597,3620,704,829,4808,996,1632,1206,974,4063,745
6409,253,132,27,36,69,0,12,83,11,26,121,31,21,51,18,110,11
6410,9275,7260,724,4188,1914,434,3344,3148,371,397,2015,305,516,501,693,1766,249
6412,1501,997,152,517,259,69,390,458,74,75,504,76,201,91,136,427,77
6413,5101,3570,511,1906,898,255,1401,1666,258,245,1531,296,608,405,222,1224,307
6415,5465,4211,915,2442,717,137,1987,1630,363,231,1254,270,471,285,228,993,261
6416,5205,3226,524,1690,760,252,1155,1454,302,315,1979,468,748,396,367,1579,400
6417,1824,1275,208,626,284,157,415,584,134,142,549,106,181,169,93,435,114
6418,5258,3261,792,1368,783,318,932,1404,480,445,1997,429,691,518,359,1701,296
6419,2199,1774,188,976,511,99,807,854,58,55,425,56,183,94,92,349,76
6420,1345,1077,143,661,245,28,506,450,78,43,268,61,116,39,52,211,57
6422,2283,1889,264,1092,474,59,838,799,119,133,394,53,155,114,72,328,66
6423,1698,1265,192,726,285,62,567,589,63,46,433,38,190,151,54,279,154
6424,4170,3040,428,1811,698,103,1341,1183,292,224,1130,161,577,207,185,858,272
6426,1425,813,63,392,238,120,241,473,60,39,612,45,194,133,240,532,80
6430,11351,8373,1073,4344,2149,807,3701,3674,376,622,2978,557,856,875,690,2356,622
6432,7468,5347,776,2636,1384,551,2148,2325,321,553,2121,355,634,580,552,1765,356
6437,8136,6044,532,3481,1698,333,2494,2880,397,273,2092,232,749,622,489,1761,331
6438,748,570,77,327,154,12,237,269,32,32,178,27,86,45,20,144,34
6441,1806,1455,126,897,340,92,605,672,75,103,351,59,114,70,108,284,67
6442,1117,807,102,483,167,55,369,372,41,25,310,83,85,91,51,251,59
6443,6528,5118,430,2868,1458,362,2310,2360,231,217,1410,114,447,495,354,1216,194
6447,2026,1629,202,1020,360,47,734,749,78,68,397,58,179,94,66,277,120
6450,13705,8897,1970,4252,1958,717,2601,3686,1565,1045,4808,1022,1777,1188,821,4039,769
6451,9253,6190,1467,2977,1290,456,2087,2506,1051,546,3063,470,1001,868,724,2583,480
6455,1122,814,96,439,217,62,306,404,65,39,308,26,117,84,81,248,60
6457,18542,10453,2614,4750,2282,807,3402,4437,1444,1170,8089,2455,2961,1558,1115,6484,1605
6460,20909,14093,2044,7146,3809,1094,4991,6510,1191,1401,6816,1405,2310,1649,1452,5562,1254
6468,6476,5377,653,3101,1375,248,2623,2149,191,414,1099,76,460,352,211,961,138
6469,1199,784,145,420,175,44,308,307,82,87,415,65,179,81,90,335,80
6470,4897,3930,362,2447,1005,116,1917,1602,207,204,967,108,316,300,243,786,181
6471,3003,2164,280,1185,482,217,892,895,170,207,839,133,224,209,273,729,110
6472,2161,1752,205,951,511,85,740,836,101,75,409,52,144,126,87,319,90
6473,8680,6560,661,3195,1983,721,2455,3208,308,589,2120,354,594,541,631,1810,310
6475,4197,2929,265,1376,1047,241,994,1499,233,203,1268,83,406,445,334,1071,197
6477,4751,3912,306,1905,1267,434,1523,1977,143,269,839,56,182,291,310,745,94
6478,3342,2778,312,1756,630,80,1182,1245,139,212,564,60,267,148,89,428,136
6479,3793,2851,545,1469,665,172,1131,1281,259,180,942,201,376,221,144,730,212
6480,3484,2521,397,1323,639,162,904,1155,269,193,963,140,355,196,272,839,124
6481,519,377,54,176,119,28,128,177,48,24,142,24,32,47,39,122,20
6482,3416,2884,524,1698,603,59,1541,1064,145,134,532,87,244,134,67,430,102
6483,6165,4277,792,2184,984,317,1618,1943,388,328,1888,413,530,498,447,1644,244
6484,14180,10557,1313,5513,3032,699,3878,5058,648,973,3623,648,1150,950,875,3100,523
6488,7229,4874,440,2354,1356,724,1909,2432,173,360,2355,150,379,783,1043,2148,207
6489,11296,8465,1197,4122,2455,691,3012,4118,707,628,2831,370,779,1039,643,2396,435
6490,1597,1164,76,587,377,124,467,569,64,64,433,43,133,138,119,367,66
6492,16744,11687,1770,6202,2927,788,4600,5081,956,1050,5057,1104,1671,1064,1218,4278,779
6498,2635,1718,236,791,520,171,562,857,113,186,917,129,312,272,204,731,186
6504,0,0,0,0,0,0,0,0,0,0,0,0,0,0,0,0,0
6510,1195,283,170,87,26,0,60,127,70,26,912,644,181,72,15,753,159
6511,20424,9911,3214,4353,1894,450,2327,2745,2895,1944,10513,4816,2997,1906,794,8287,2226
6512,11625,7437,1230,3470,1985,752,2310,3247,787,1093,4188,834,1373,1053,928,3458,730
6513,13490,8674,2631,3908,1625,510,2283,2574,2504,1313,4816,925,1280,1392,1219,4131,685
6514,9862,6353,1232,2953,1435,733,1961,2814,822,756,3509,824,993,966,726,2926,583
6515,6315,3806,1050,1747,696,313,1013,1254,1099,440,2509,744,837,499,429,2039,470
6516,21105,13158,2930,6095,3022,1111,3864,5223,2223,1848,7947,2118,2600,1920,1309,6544,1403
6517,6181,3684,537,1825,910,412,1201,1634,435,414,2497,319,683,665,830,2191,306
6518,6307,3971,606,1979,1064,322,1447,2018,183,323,2336,640,542,573,581,1829,507
6519,5331,3612,1191,1639,664,118,864,748,1358,642,1719,272,515,477,455,1476,243
6524,1755,1459,140,814,397,108,599,690,118,52,296,13,122,103,58,231,65
6525,3113,2633,133,1483,786,231,1213,1186,95,139,480,6,108,170,196,435,45
6604,10732,6450,2126,2739,1097,488,1667,1723,1841,1219,4282,873,1316,1180,913,3622,660
6605,8646,5340,1901,2237,937,265,1383,1390,1623,944,3306,922,1200,749,435,2673,633
6606,15646,10842,2259,5415,2285,883,3438,3691,2008,1705,4804,907,1595,1251,1051,4060,744
6607,2688,1891,557,838,455,41,357,379,695,460,797,143,297,272,85,673,124
6608,4143,3162,1100,1389,569,104,744,534,1260,624,981,171,280,370,160,822,159
6610,8442,5349,1526,2344,1018,461,1395,1455,1393,1106,3093,454,914,903,822,2718,375
6611,11957,9759,904,5062,2876,917,4283,4458,389,629,2198,215,512,776,695,1926,272
6612,2463,2079,128,1209,557,185,991,961,52,75,384,26,113,145,100,308,76
6614,12951,9130,1232,4095,2678,1125,3038,4446,588,1058,3821,433,928,1157,1303,3381,440
6615,6938,4549,861,2131,1136,421,1450,1698,722,679,2389,325,872,578,614,1999,390
6702,1757,635,220,251,113,51,114,138,270,113,1122,51,274,527,270,1032,90
6704,9996,6681,1988,2928,1256,509,1750,1963,1975,993,3315,627,1098,846,744,2852,463
6705,10329,6287,1715,2661,1347,564,1724,2428,1191,944,4042,1014,1256,968,804,3488,554
6706,5234,3639,887,1646,762,344,1052,1282,764,541,1595,269,487,455,384,1327,268
6708,11590,7392,1733,3282,1736,641,2108,3192,1225,867,4198,928,1219,1023,1028,3539,659
6710,3738,2353,664,1154,417,118,577,661,733,382,1385,264,629,290,202,1166,219
6712,3010,2446,299,1273,716,158,973,1152,82,239,564,52,238,150,124,449,115
6716,5404,4238,653,2196,1125,264,1691,1848,341,358,1166,126,393,353,294,969,197
6750,587,351,41,177,100,33,141,152,36,22,236,21,72,57,86,211,25
6751,1311,1018,99,594,271,54,458,480,43,37,293,16,99,88,90,245,48
6752,703,523,27,262,209,25,174,298,24,27,180,10,61,68,41,152,28
6754,528,348,35,208,83,22,129,166,35,18,180,26,51,59,44,155,25
6755,382,319,58,194,67,0,132,135,43,9,63,6,29,9,19,59,4
6756,1033,792,80,399,252,61,259,462,41,30,241,17,114,73,37,218,23
6757,905,566,72,311,165,18,197,306,27,36,339,41,85,136,77,273,66
6759,2332,1633,140,785,513,195,591,810,121,111,699,61,249,231,158,607,92
6762,2606,1937,162,1012,592,171,721,1004,98,114,669,62,189,257,161,548,121
6763,850,586,71,308,160,47,233,284,39,30,264,33,115,51,65,212,52
6770,11693,8203,1708,4310,1641,544,3201,3083,1120,799,3490,835,1028,917,710,2913,577
6776,9570,6928,1079,4125,1479,245,3097,2682,566,583,2642,563,977,630,472,2053,589
6777,798,544,42,325,148,29,186,294,40,24,254,34,64,111,45,217,37
6778,19,13,0,13,0,0,13,0,0,0,6,0,0,0,6,6,0
6779,3154,2273,378,1157,569,169,897,988,162,226,881,149,223,303,206,766,115
6782,737,572,69,354,104,45,189,270,77,36,165,37,59,59,10,124,41
6783,826,606,62,295,216,33,243,316,19,28,220,13,97,78,32,169,51
6784,1500,1134,76,653,330,75,460,530,86,58,366,41,112,145,68,277,89
6785,231,159,24,98,31,6,72,61,13,13,72,0,41,11,20,48,24
6786,3712,2654,542,1348,579,185,1011,1190,273,180,1058,167,382,302,207,894,164
6787,3373,2448,405,1318,558,167,954,1131,206,157,925,148,336,278,163,751,174
6790,14773,9169,1792,4601,1800,976,3070,4103,1145,851,5604,971,1664,1576,1393,4739,865
6791,1958,1550,135,799,489,127,641,743,21,145,408,48,139,134,87,339,69
6793,503,337,15,180,134,8,98,166,24,49,166,31,35,30,70,133,33
6794,394,274,47,100,101,26,96,118,25,35,120,8,35,55,22,90,30
6795,4905,3752,434,2037,1026,255,1565,1657,208,322,1153,206,379,304,264,973,180
6796,382,267,16,144,73,34,98,120,30,19,115,14,33,44,24,100,15
6798,3715,2577,241,1400,756,180,933,1149,245,250,1138,166,473,299,200,944,194
6801,6500,4853,754,2746,1074,279,2119,1976,415,343,1647,335,625,382,305,1328,319
6804,5722,4515,389,2662,1289,175,1963,1908,295,349,1207,167,505,307,228,982,225
6807,2633,1943,181,1016,585,161,812,849,134,148,690,186,247,168,89,568,122
6810,16324,10253,2931,4898,1912,512,3890,3759,1169,1435,6071,1560,2051,1494,966,4698,1373
6811,10760,7809,1316,3993,2055,445,2989,3530,523,767,2951,691,1095,787,378,2399,552
6812,4651,3912,511,2274,1016,111,1926,1620,152,214,739,71,220,256,192,585,154
6820,6624,5409,575,3079,1414,341,2921,2059,236,193,1215,97,289,399,430,1030,185
6830,10000,6212,745,3101,1800,566,2517,2660,479,556,3788,857,1199,1069,663,3082,706
6831,5404,4109,260,2069,1367,413,1715,1934,113,347,1295,175,355,485,280,1075,220
6840,6809,5234,370,2985,1482,397,2595,2128,256,255,1575,133,477,570,395,1332,243
6850,6858,4406,966,2102,1039,299,1703,1832,412,459,2452,654,900,542,356,1944,508
6851,10512,6830,1174,3339,1736,581,2535,3081,485,729,3682,822,1207,1090,563,2981,701
6853,1454,980,135,459,333,53,399,480,39,62,474,60,148,179,87,393,81
6854,10656,6931,1561,3350,1690,330,2100,2230,1354,1247,3725,1023,1447,833,422,2884,841
6855,3217,1962,423,851,529,159,602,857,211,292,1255,346,431,247,231,998,257
6870,2691,2019,266,1033,556,164,1005,766,134,114,672,102,214,224,132,609,63
6877,8449,6638,662,4016,1661,299,3415,2708,318,197,1811,265,607,566,373,1587,224
6878,2601,2087,164,1145,609,169,1030,852,122,83,514,23,119,220,152,431,83
6880,9577,7182,468,4016,2132,566,3340,3073,405,364,2395,257,765,835,538,1995,400
6883,3327,2836,166,1724,821,125,1576,1108,113,39,491,21,216,109,145,373,118
6896,2924,2416,206,1458,652,100,1167,1043,122,84,508,40,220,172,76,398,110
6897,5898,4858,406,2904,1318,230,2495,1925,266,172,1040,97,377,326,240,913,127
6901,3312,1171,370,491,257,53,252,509,212,198,2141,775,575,490,301,1841,300
6902,22248,14315,3375,6837,3053,1050,4462,5132,2402,2319,7933,1810,2718,1990,1415,6319,1614
6903,4861,4222,413,2148,1440,221,1793,2123,117,189,639,34,165,322,118,493,146
6905,8205,5003,991,2458,1197,357,1828,2156,281,738,3202,1061,919,596,626,2547,655
6906,3090,1947,446,931,449,121,640,934,227,146,1143,464,316,190,173,851,292
6907,3668,2521,412,1185,715,209,983,1103,116,319,1147,314,435,235,163,957,190
7001,4587,3408,732,1754,758,164,1435,1244,327,402,1179,286,347,341,205,970,209
7002,25581,16237,3048,7576,3972,1641,5210,6101,2213,2713,9344,1670,2589,2721,2364,8395,949
7003,19022,12174,2279,6070,2790,1035,4415,4887,1232,1640,6848,1918,2012,1596,1322,5786,1062
7004,2303,1988,198,918,750,122,716,1048,42,182,315,32,74,119,90,252,63
7005,5531,4004,556,2162,1012,274,1583,1786,278,357,1527,317,550,365,295,1190,337
7006,9403,6822,849,3426,1918,629,2803,3017,398,604,2581,527,579,691,784,2222,359
7008,7057,5294,941,2607,1219,527,1811,1954,717,812,1763,176,488,587,512,1542,221
7009,4392,3222,338,1578,1007,299,1163,1583,176,300,1170,156,291,378,345,1012,158
7010,10014,6014,1100,2488,1843,583,1740,2794,485,995,4000,958,1129,1030,883,3386,614
7011,13161,9076,1911,4681,1749,735,3244,3130,1300,1402,4085,694,1157,951,1283,3403,682
7012,5479,3288,516,1428,890,454,1057,1577,168,486,2191,345,579,622,645,1963,228
7013,9776,6834,823,3036,1978,997,2222,3458,279,875,2942,388,728,834,992,2590,352
7014,1695,1105,172,589,233,111,427,478,46,154,590,97,203,179,111,492,98
7016,8401,6366,784,3246,1756,580,2567,2859,290,650,2035,420,469,580,566,1837,198
7017,14734,9022,2462,3995,2084,481,1857,2110,2780,2275,5712,1100,1888,1819,905,5006,706
7018,11341,7146,1877,3246,1693,330,1369,1690,2323,1764,4195,833,1446,1306,610,3604,591
7020,3834,2010,518,965,446,81,564,966,188,292,1824,695,730,260,139,1495,329
7021,731,603,47,314,197,45,293,263,14,33,128,6,22,51,49,110,18
7022,4868,3217,817,1431,721,248,1125,1216,326,550,1651,336,461,441,413,1378,273
7023,2564,2044,290,1093,487,174,924,881,50,189,520,65,126,159,170,467,53
7024,16533,9460,1542,4331,2555,1032,3227,4707,602,924,7073,1390,2292,1988,1403,6448,625
7026,11240,7446,1605,3603,1580,658,2621,2859,790,1176,3794,888,1032,931,943,3081,713
7027,1724,1121,229,478,254,160,355,461,88,217,603,131,188,149,135,495,108
7028,2529,2042,205,1237,439,161,1087,666,130,159,487,46,155,183,103,418,69
7029,5893,4343,1086,2200,809,248,1619,1431,488,805,1550,415,458,433,244,1267,283
7030,19462,6986,2286,2844,1401,455,1388,3427,967,1204,12476,7854,2489,1300,833,8111,4365
7031,6405,4154,756,1772,1128,498,1228,1918,352,656,2251,460,601,593,597,1974,277
7032,13561,9982,2152,5091,2202,537,3690,3648,1120,1524,3579,854,1024,872,829,2955,624
7033,2871,2114,331,954,575,254,671,962,174,307,757,115,191,192,259,631,126
7034,3726,2444,368,1305,657,114,922,1125,141,256,1282,458,480,263,81,1076,206
7035,4038,2700,417,1484,622,177,1048,1240,157,255,1338,295,531,333,179,1074,264
7036,15713,10511,1926,4902,2617,1066,3444,4227,1155,1685,5202,901,1343,1501,1457,4463,739
7039,9230,7932,725,4168,2385,654,3505,3522,364,541,1298,55,200,496,547,1174,124
7040,8434,6368,789,3811,1304,464,2802,2095,653,818,2066,341,592,571,562,1708,358
7041,2733,1923,257,1092,356,218,861,723,172,167,810,170,256,223,161,710,100
7042,10700,6566,1049,3661,1420,436,2435,1966,1085,1080,4134,1112,1555,855,612,3478,656
7043,4255,3233,341,2029,673,190,1696,1166,155,216,1022,151,327,273,271,840,182
7044,5819,3829,472,1939,995,423,1668,1678,172,311,1990,281,469,557,683,1773,217
7045,3778,2970,275,1714,861,120,1335,1352,107,176,808,113,252,263,180,711,97
7046,1343,1214,55,774,337,48,681,446,58,29,129,0,33,53,43,124,5
7047,21247,14289,2937,7162,3236,954,5096,5169,1886,2138,6958,1338,2212,1889,1519,5890,1068
7050,11891,7713,1908,3941,1563,301,1950,1793,2239,1731,4178,835,1394,1302,647,3595,583
7052,16466,11740,1501,6028,3098,1113,4362,5184,976,1218,4726,837,1413,1311,1165,4066,660
7054,10865,7170,1284,3663,1862,361,2652,3426,523,569,3695,1057,1159,932,547,3098,597
7055,19497,14593,4535,6840,2577,641,5176,3444,3173,2800,4904,884,1562,1269,1189,3936,968
7057,4747,3054,606,1507,682,259,982,1379,245,448,1693,374,535,382,402,1414,279
7058,1913,1504,297,786,377,44,713,645,54,92,409,168,119,93,29,304,105
7059,4621,3917,333,2299,1090,195,1994,1626,164,133,704,95,280,174,155,556,148
7060,16217,11284,2362,5888,2528,506,3773,3622,2042,1847,4933,991,1859,1145,938,3798,1135
7062,4534,3454,607,1705,910,232,994,1097,646,717,1080,213,355,362,150,843,237
7063,3715,3048,505,1566,757,220,893,987,545,623,667,85,218,243,121,601,66
7064,1324,1031,158,397,399,77,301,462,118,150,293,41,84,91,77,238,55
7065,10028,6735,1017,3525,1665,528,2162,2688,841,1044,3293,634,1090,759,810,2810,483
7066,5648,4144,421,1898,1242,583,1544,2132,151,317,1504,251,370,422,461,1358,146
7067,6305,5195,552,2575,1640,428,2003,2363,288,541,1110,126,286,381,317,995,115
7068,2126,1498,190,581,549,178,473,811,57,157,628,53,205,234,136,543,85
7070,7052,4710,692,2300,1316,402,1795,2003,256,656,2342,538,783,542,479,2005,337
7071,7906,5254,872,2339,1506,537,1718,2317,390,829,2652,627,709,614,702,2263,389
7072,2388,1603,322,650,458,173,435,803,135,230,785,179,249,232,125,637,148
7073,3633,2135,429,1042,477,187,667,933,218,317,1498,409,489,303,297,1218,280
7074,1046,723,81,376,212,54,257,332,46,88,323,20,125,105,73,285,38
7075,3031,2184,264,1105,629,186,807,1070,118,189,847,105,298,230,214,788,59
7076,7228,5388,700,2861,1473,354,2361,2289,258,480,1840,348,559,511,422,1519,321
7077,1041,767,129,392,190,56,270,313,66,118,274,47,85,86,56,254,20
7078,4279,3692,250,2151,988,303,1959,1454,143,136,587,60,150,203,174,507,80
7079,5549,3822,431,2106,995,290,1607,1495,325,395,1727,426,479,381,441,1411,316
7080,7140,5862,719,3224,1471,448,2393,2527,372,570,1278,278,325,336,339,1086,192
7081,6120,4043,732,1730,1096,485,1534,2079,124,306,2077,351,534,589,603,1814,263
7082,1529,1294,151,702,373,68,542,604,58,90,235,66,69,58,42,190,45
7083,18114,13323,1699,6843,3312,1469,5010,5571,930,1812,4791,541,1096,1426,1728,4189,602
7087,28909,19313,4809,9260,4272,972,6000,5812,3879,3622,9596,2808,3043,2432,1313,7391,2205
7088,1277,842,152,412,178,100,196,231,189,226,435,36,89,237,73,370,65
7090,11749,9097,1071,5085,2280,661,4242,3813,465,577,2652,517,657,732,746,2270,382
7092,2436,1935,117,860,701,257,671,1059,93,112,501,15,99,143,244,436,65
7093,21228,13715,3350,6374,3169,822,4038,4489,2464,2724,7513,1699,2323,2109,1382,6178,1335
7094,6200,3915,595,1849,1159,312,1368,1796,307,444,2285,458,674,656,497,1971,314
7095,8053,5491,1238,2681,1178,394,1972,2248,533,738,2562,732,678,615,537,2024,538
7102,4677,2023,721,818,418,66,273,471,878,401,2654,370,810,914,560,2361,293
7103,10056,6756,2000,2952,1581,223,847,1220,2801,1888,3300,442,1093,1271,494,2879,421
7104,16512,11101,3288,5237,2170,406,3167,2689,3011,2234,5411,1535,1871,1272,733,4466,945
7105,15338,11449,3300,5444,2196,509,3734,4047,1589,2079,3889,1101,1206,990,592,2844,1045
7106,11277,8212,2146,3814,1965,287,2175,1902,2079,2056,3065,706,1089,804,466,2585,480
7107,12084,8536,2599,3947,1608,382,2278,1849,2518,1891,3548,448,1110,1207,783,3108,440
7108,8609,5886,1790,2576,1228,292,841,897,2400,1748,2723,314,816,1138,455,2413,310
7109,13690,9092,1939,4369,2093,691,3050,3539,992,1511,4598,1178,1485,1169,766,3815,783
7110,10881,7357,1001,3686,1969,701,2707,3219,568,863,3524,853,979,917,775,3039,485
7111,21989,14460,3909,6806,3313,432,3400,3505,4312,3243,7529,1889,3214,1652,774,6405,1124
7112,9527,6653,1771,2786,1755,341,1034,1457,2279,1883,2874,536,1089,1057,192,2456,418
7114,3248,1909,534,865,425,85,334,408,667,500,1339,165,442,596,136,1214,125
7201,8332,6085,1663,2892,1166,364,1940,1595,1240,1310,2247,361,826,764,296,1796,451
7202,13412,8980,2417,4184,1846,533,3174,2571,1570,1665,4432,867,1349,1419,797,3710,722
7203,7521,5272,1050,2587,1253,382,1688,1900,782,902,2249,355,685,664,545,1900,349
7204,5119,3476,682,1718,785,291,1240,1458,414,364,1643,363,647,357,276,1406,237
7205,7138,5567,873,2700,1635,359,1864,2189,565,949,1571,251,515,437,368,1287,284
7206,6918,5492,1678,2428,1202,184,1631,1244,1507,1110,1426,182,465,475,304,1121,305
7208,11865,7888,2010,3949,1493,436,2666,2435,1498,1289,3977,952,1516,959,550,3297,680
7302,14227,6698,2021,3173,1247,257,1592,2594,1377,1135,7529,3624,2197,1086,622,5562,1967
7304,14500,9826,2495,4963,1876,492,2688,2333,2637,2168,4674,1092,1538,1389,655,3911,763
7305,20171,14506,3666,6473,3573,794,3527,4124,3651,3204,5665,928,2115,1705,917,4863,802
7306,20389,12573,3173,6106,2672,622,4026,4036,2092,2419,7816,2370,2641,1834,971,6268,1548
7307,16129,11077,2916,5554,2003,604,3844,3144,2208,1881,5052,1687,1617,1042,706,4025,1027
7310,3201,1434,711,558,124,41,339,747,149,199,1767,1161,521,79,6,1265,502
7401,2105,1783,141,1071,472,99,927,702,75,79,322,32,129,94,67,279,43
7403,2824,2116,392,1021,572,131,788,1042,133,153,708,183,290,157,78,615,93
7405,5917,4715,612,2564,1311,228,2074,2117,207,317,1202,229,398,315,260,974,228
7407,7096,5129,855,2470,1293,511,1814,2204,367,744,1967,440,470,443,614,1641,326
7410,11824,8899,852,4630,2364,1053,3432,4148,481,838,2925,363,756,790,1016,2528,397
7416,2119,1517,284,831,325,77,617,569,176,155,602,96,214,162,130,485,117
7417,3294,2952,179,1565,1078,130,1344,1376,83,149,342,16,85,159,82,286,56
7418,840,770,70,528,166,6,360,321,43,46,70,0,40,16,14,56,14
7419,2685,1935,305,1010,494,126,716,856,154,209,750,154,294,211,91,640,110
7420,1581,1239,190,687,272,90,492,490,159,98,342,69,118,44,111,272,70
7421,2721,2098,312,1387,351,48,954,819,205,120,623,99,300,147,77,470,153
7422,2422,1927,311,1295,275,46,1005,675,133,114,495,87,158,187,63,405,90
7423,1429,1192,76,631,369,116,503,581,37,71,237,24,55,109,49,209,28
7424,9087,5894,1086,2518,1703,587,1865,2951,398,680,3193,709,1012,833,639,2672,521
7428,34,7,0,7,0,0,0,0,7,0,27,11,16,0,0,20,7
7430,9355,6315,946,3300,1728,341,2477,2989,382,467,3040,628,1166,949,297,2610,430
7432,2630,1911,242,1004,523,142,811,852,88,160,719,175,197,170,177,614,105
7435,759,591,63,276,202,50,180,337,27,47,168,40,63,44,21,114,54
7436,4263,3590,491,1950,978,171,1604,1608,139,239,673,89,218,274,92,538,135
7438,4222,3363,531,1945,807,80,1576,1379,235,173,859,145,372,227,115,746,113
7439,887,717,101,424,149,43,334,268,48,67,170,40,52,52,26,146,24
7440,1699,1361,114,704,469,74,522,688,62,89,338,33,70,89,146,304,34
7442,3938,2810,424,1447,756,183,1121,1191,207,291,1128,218,343,305,262,943,185
7444,3324,2510,395,1250,645,220,1113,1133,78,186,814,127,359,230,98,741,73
7446,5323,3968,484,2291,980,213,1809,1632,224,303,1355,203,464,454,234,1195,160
7450,8582,6825,599,4042,1804,380,3594,2479,323,429,1757,263,571,425,498,1589,168
7452,3966,3315,333,1910,755,317,1630,1407,102,176,651,20,146,215,270,585,66
7456,4091,3418,444,1998,900,76,1553,1425,180,260,673,119,245,221,88,497,176
7457,927,670,100,353,170,47,241,319,35,75,257,65,86,57,49,194,63
7458,3638,3207,150,1733,1128,196,1501,1455,55,196,431,17,97,236,81,369,62
7460,1254,1030,143,687,169,31,541,365,64,60,224,41,94,64,25,164,60
7461,6122,4951,649,2953,1150,199,2261,1894,411,385,1171,220,448,325,178,956,215
7462,2595,1778,464,935,323,56,799,614,202,163,817,274,371,149,23,607,210
7463,3423,2694,395,1350,725,224,1148,1168,111,267,729,76,215,219,219,642,87
7465,1869,1443,173,857,352,61,589,643,86,125,426,66,221,101,38,307,119
7470,18760,14381,1491,7660,4243,987,5739,6785,711,1146,4379,549,1340,1439,1051,3804,575
7480,5525,4393,522,2594,1116,161,1953,1951,226,263,1132,198,440,326,168,906,226
7481,5538,4656,352,2572,1319,413,2232,1997,157,270,882,59,224,310,289,825,57
7501,10299,7073,2142,3388,1228,315,1793,1376,2332,1572,3226,493,963,1161,609,2726,500
7502,4374,3407,662,1762,736,247,1153,1113,544,597,967,144,320,196,307,851,116
7503,6030,4372,1141,2226,730,275,1725,1270,609,768,1658,300,572,509,277,1349,309
7504,3697,2999,610,1487,811,91,815,936,672,576,698,137,240,236,85,539,159
7505,752,497,171,225,76,25,110,56,173,158,255,25,70,115,45,223,32
7506,7248,4937,867,2409,1195,466,1809,2085,400,643,2311,439,681,621,570,1916,395
7508,7255,5501,1085,2650,1343,423,2095,2309,500,597,1754,360,506,450,438,1436,318
7512,3528,2644,326,1138,879,301,812,1402,102,328,884,117,209,211,347,768,116
7513,3415,3010,845,1521,568,76,956,738,780,536,405,44,128,132,101,338,67
7514,6109,4362,1045,2169,953,195,1074,1121,1160,1007,1747,321,606,495,325,1505,242
7522,6340,5036,1452,2479,960,145,1486,1036,1542,972,1304,280,420,437,167,1037,267
7524,3744,3054,1002,1427,528,97,958,679,930,487,690,170,174,222,124,543,147
7601,18114,9625,2658,4261,2089,617,2716,3627,1444,1838,8489,2424,3237,1852,976,7196,1293
7603,2871,2175,323,1290,434,128,840,773,226,336,696,215,151,184,146,628,68
7604,4527,3154,400,1633,801,320,1227,1385,197,345,1373,245,404,386,338,1189,184
7605,3249,2414,269,1313,689,143,1031,925,186,272,835,135,199,276,225,722,113
7606,786,585,97,248,194,46,169,297,46,73,201,25,51,69,56,176,25
7607,3711,2651,417,1302,723,209,982,1095,164,410,1060,142,290,230,398,919,141
7608,8,3,0,3,0,0,0,0,3,0,5,0,2,0,3,3,2
7620,509,450,7,235,180,28,172,257,7,14,59,5,21,20,13,55,4
7621,8984,6756,1032,3494,1675,555,2830,2545,450,931,2228,299,755,572,602,1868,360
7624,2983,2548,141,1540,756,111,1215,991,171,171,435,45,136,109,145,407,28
7626,2663,2195,115,1211,651,218,956,960,88,191,468,33,106,143,186,419,49
7627,1603,1393,47,822,417,107,689,551,70,83,210,11,51,82,66,186,24
7628,6354,4794,670,2281,1437,406,1846,2076,336,536,1560,296,323,478,463,1413,147
7630,2390,2003,221,1057,603,122,783,1007,62,151,387,42,71,140,134,342,45
7631,9291,6505,1028,3130,1829,518,2249,2334,731,1191,2786,400,956,886,544,2294,492
7632,1812,1547,104,671,612,160,562,853,28,104,265,8,44,130,83,227,38
7640,1553,1352,86,790,391,85,689,556,39,68,201,9,35,76,81,189,12
7641,1133,968,60,530,297,81,447,414,36,71,165,0,28,57,80,146,19
7642,3487,2838,301,1476,808,253,1208,1313,118,199,649,39,232,171,207,556,93
7643,4355,2786,503,1399,694,190,1033,1137,204,412,1569,397,576,398,198,1359,210
7644,9518,6086,1383,2695,1440,568,2107,2326,646,1007,3432,926,1027,803,676,2872,560
7645,2518,2064,217,1078,684,85,903,948,78,135,454,75,147,175,57,433,21
7646,6355,4307,574,2213,1116,404,1688,1879,264,476,2048,502,631,465,450,1812,236
7647,1656,1298,171,586,436,105,492,618,51,137,358,35,89,139,95,303,55
7648,1848,1584,156,835,490,103,725,709,57,93,264,28,88,101,47,252,12
7649,2809,2333,261,1175,677,220,1009,1070,110,144,476,30,152,176,118,438,38
7650,6238,4467,894,2151,1119,303,1609,1806,325,727,1771,514,551,393,313,1424,347
7652,8076,6804,458,3354,2362,630,2881,3182,235,506,1272,83,225,457,507,1163,109
7656,3181,2413,241,1198,811,163,983,1157,94,179,768,154,318,185,111,673,95
7657,4024,2939,404,1422,842,271,1090,1316,185,348,1085,172,287,297,329,925,160
7660,5020,3209,566,1654,844,145,1179,1357,315,358,1811,438,638,456,279,1486,325
7661,4185,3128,384,1603,822,319,1294,1373,158,303,1057,159,225,291,382,946,111
7662,2055,1376,214,681,303,178,515,649,32,180,679,95,161,185,238,566,113
7663,5073,3588,468,1644,1029,447,1259,1705,166,458,1485,344,427,357,357,1264,221
7666,13416,10193,1185,5256,2905,847,3944,4314,824,1111,3223,397,956,942,928,2825,398
7670,4781,3881,290,2196,1035,360,1731,1514,349,287,900,98,184,291,327,802,98
7675,14592,11412,1149,5997,3479,787,5046,5183,438,745,3180,498,930,984,768,2774,406
7701,9633,5670,809,2810,1380,671,1871,2655,451,693,3963,774,974,1122,1093,3435,528
7702,1209,1020,99,637,207,77,512,345,54,109,189,12,43,61,73,158,31
7703,56,56,21,31,4,0,27,29,0,0,0,0,0,0,0,0,0
7704,1997,1651,213,994,343,101,838,600,123,90,346,21,103,155,67,308,38
7711,708,500,45,277,124,54,237,216,9,38,208,46,65,52,45,150,58
7712,16044,9947,2395,5034,1976,542,3096,3324,2303,1224,6097,1262,2237,1481,1117,5188,909
7716,3559,2351,225,1250,692,184,802,1087,147,315,1208,268,451,347,142,1001,207
7717,1066,531,68,201,199,63,188,272,5,66,535,78,177,144,136,471,64
7718,2125,1755,273,933,459,90,675,776,122,182,370,56,164,110,40,321,49
7719,8906,5473,837,2936,1383,317,2015,2367,493,598,3433,778,1236,902,517,2868,565
7720,2290,1044,211,446,283,104,261,478,106,199,1246,389,552,235,70,979,267
7721,911,667,122,370,148,27,269,211,92,95,244,42,109,81,12,192,52
7722,3534,3225,528,1702,861,134,1588,1378,155,104,309,59,88,104,58,263,46
7723,614,449,37,151,183,78,132,236,25,56,165,33,43,53,36,139,26
7724,9271,5927,1268,3033,1372,254,2471,2348,510,598,3344,862,1191,866,425,2781,563
7726,13180,10912,1030,6741,2394,747,5696,4187,383,646,2268,108,512,704,944,2039,229
7727,2085,1611,220,946,390,55,754,580,155,122,474,96,217,136,25,390,84
7728,17772,13258,2013,6972,3489,784,5485,5607,898,1268,4514,649,1297,1403,1165,3973,541
7730,6346,5073,651,2592,1561,269,2084,2182,299,508,1273,108,270,500,395,1133,140
7731,11892,10032,1544,6531,1661,296,5553,3069,720,690,1860,317,738,543,262,1396,464
7732,2482,1235,192,650,323,70,314,479,187,255,1247,301,450,378,118,1025,222
7733,4832,4262,231,2606,1223,202,2147,1674,192,249,570,86,183,229,72,492,78
7734,4932,3408,717,1878,707,106,1346,1070,513,479,1524,207,513,535,269,1234,290
7735,7529,5204,894,2886,1144,280,2101,1841,529,733,2325,346,787,654,538,1963,362
7737,1507,1204,129,716,318,41,462,489,89,164,303,54,147,94,8,251,52
7738,2122,1724,119,1011,480,114,806,768,75,75,398,25,65,163,145,367,31
7739,2238,1820,172,905,545,198,795,850,67,108,418,14,118,165,121,377,41
7740,12725,7421,1710,3572,1557,582,2179,2637,1431,1174,5304,1299,1955,1285,765,4346,958
7746,5417,4807,362,3079,1132,234,2584,1892,172,159,610,84,193,192,141,506,104
7747,10928,8025,1353,4312,1883,477,3332,3527,510,656,2903,628,976,836,463,2414,489
7748,9813,8033,901,4633,2159,340,3748,3342,362,581,1780,261,507,466,546,1507,273
7750,1632,971,98,439,333,101,350,440,60,121,661,57,256,240,108,572,89
7751,5272,4737,564,3047,1033,93,2676,1714,147,200,535,54,229,180,72,436,99
7753,12302,8354,1379,4073,2274,628,2704,3334,1085,1231,3948,503,1490,1249,706,3298,650
7755,2326,1873,192,1004,550,127,773,831,107,162,453,35,108,118,192,418,35
7756,2321,793,208,276,176,133,121,452,107,113,1528,320,678,321,209,1327,201
7757,2037,1561,143,823,490,105,625,733,77,126,476,8,143,194,131,438,38
7758,1545,1189,144,682,285,78,525,406,78,180,356,69,102,104,81,270,86
7760,3633,2560,311,1397,709,143,1172,1091,167,130,1073,260,342,245,226,866,207
7762,4226,2483,147,982,997,357,727,1324,139,293,1743,197,449,605,492,1563,180
7764,2450,1835,170,998,505,162,807,754,90,184,615,37,143,195,240,524,91
7801,7585,5646,1359,2775,1237,275,2124,2031,684,807,1939,334,620,578,407,1505,434
7803,1364,1031,171,534,251,75,390,441,43,157,333,61,102,112,58,262,71
7821,3143,2552,419,1489,558,86,1142,1135,143,132,591,141,232,156,62,461,130
7822,298,242,44,105,86,7,134,96,0,12,56,14,28,6,8,40,16
7823,2926,1996,282,1040,479,195,752,913,158,173,930,140,265,332,193,801,129
7825,3322,2601,253,1415,778,155,1019,1265,108,209,721,72,268,222,159,572,149
7826,2119,1564,181,918,390,75,622,729,140,73,555,56,159,204,136,479,76
7827,1450,1044,160,579,256,49,403,462,113,66,406,72,128,150,56,326,80
7828,4930,3372,802,1983,547,40,1482,1203,430,257,1558,589,517,277,175,1228,330
7830,2312,1922,201,1089,558,74,831,930,71,90,390,39,111,132,108,268,122
7832,1243,1035,136,602,247,50,443,454,73,65,208,36,64,54,54,147,61
7833,53,43,3,22,14,4,17,26,0,0,10,4,3,3,0,10,0
7834,6493,4712,654,2496,1275,287,1934,2248,170,360,1781,270,494,447,570,1511,270
7836,4449,3348,581,1947,773,47,1645,1326,192,185,1101,432,380,219,70,872,229
7838,1044,835,130,542,137,26,427,278,47,83,209,20,49,75,65,164,45
7840,10286,6907,1341,3653,1612,301,2784,3032,591,500,3379,768,1039,946,626,2808,571
7842,24,24,4,15,0,5,0,19,0,5,0,0,0,0,0,0,0
7843,4436,3354,601,1974,682,97,1442,1336,282,294,1082,293,336,358,95,820,262
7846,18,16,5,9,0,2,8,4,2,2,2,0,0,2,0,2,0
7847,544,417,86,228,80,23,191,127,59,40,127,17,66,36,8,97,30
7848,1349,1112,187,618,242,65,468,515,70,59,237,45,101,77,14,183,54
7849,2606,1870,279,1105,402,84,728,847,178,117,736,141,352,119,124,567,169
7850,2368,1909,317,1063,449,80,884,698,196,131,459,122,121,140,76,347,112
7851,111,83,12,34,25,12,27,43,3,10,28,4,10,2,12,22,6
7852,1108,707,113,335,209,50,208,350,21,128,401,60,106,121,114,373,28
7853,4291,3736,338,2469,819,110,1986,1461,153,136,555,41,213,124,177,471,84
7856,1476,960,156,477,285,42,279,497,61,123,516,152,187,125,52,443,73
7857,1412,802,163,389,198,52,287,321,84,110,610,190,219,131,70,513,97
7860,9439,6827,979,3888,1648,312,2895,2902,510,520,2612,391,898,759,564,2166,446
7863,1398,1049,184,566,222,77,425,490,81,53,349,54,90,119,86,299,50
7865,697,557,51,356,114,36,261,256,18,22,140,32,67,12,29,93,47
7866,8105,6207,953,3533,1445,276,2731,2606,434,436,1898,426,734,495,243,1503,395
7869,8574,6741,873,4128,1469,271,3378,2720,328,315,1833,520,661,439,213,1594,239
7871,6614,5369,644,3338,1225,162,2719,2151,272,227,1245,162,406,311,366,1084,161
7874,3318,2518,362,1532,553,71,1169,1017,134,198,800,194,361,213,32,594,206
7876,3563,3025,294,1882,720,129,1524,1192,102,207,538,87,208,152,91,455,83
7878,287,230,56,129,35,10,130,61,23,16,57,16,24,17,0,41,16
7882,5405,3862,637,2182,814,229,1685,1508,390,279,1543,394,449,484,216,1300,243
7885,3908,2757,521,1418,643,175,1080,1132,289,256,1151,211,419,312,209,954,197
7901,8570,6100,997,3084,1530,489,2796,2543,298,463,2470,541,778,620,531,2069,401
7920,9286,6477,676,3862,1612,327,3242,2672,326,237,2809,489,1088,687,545,2456,353
7921,4030,1956,428,976,488,64,660,975,207,114,2074,478,981,475,140,1799,275
7922,4128,3442,424,1856,929,233,1577,1509,125,231,686,59,168,219,240,627,59
7924,2708,2075,185,1146,621,123,862,1011,118,84,633,48,276,194,115,569,64
7927,1138,858,121,467,212,58,355,370,63,70,280,48,100,87,45,244,36
7928,6946,5073,657,2707,1318,391,2325,2218,233,297,1873,339,669,490,375,1650,223
7930,2615,2157,176,1244,639,98,1076,904,76,101,458,56,165,155,82,352,106
7931,999,773,54,439,225,55,346,353,37,37,226,29,69,64,64,190,36
7932,3209,2464,178,1184,851,251,926,1217,95,226,745,99,176,318,152,675,70
7933,1189,901,46,560,253,42,407,408,39,47,288,11,84,148,45,253,35
7934,592,466,34,248,136,48,190,226,20,30,126,20,43,29,34,110,16
7935,147,111,35,43,26,7,82,29,0,0,36,0,9,8,19,36,0
7936,3847,3224,335,1546,1094,249,1266,1574,101,283,623,80,155,234,154,518,105
7940,5528,3822,521,1932,1072,297,1460,1842,215,305,1706,349,594,357,406,1422,284
7945,3135,2565,173,1503,762,127,1270,1119,98,78,570,44,181,196,149,467,103
7946,1014,836,35,522,241,38,430,340,28,38,178,15,82,30,51,159,19
7950,6583,4780,610,2453,1449,268,1918,2254,166,442,1803,563,653,357,230,1434,369
7960,16241,10585,1681,5046,3100,758,3833,4870,790,1092,5656,1496,1999,1292,869,4716,940
7970,99,86,14,61,11,0,35,33,18,0,13,0,6,7,0,13,0
7974,4068,3173,379,1697,882,215,1471,1317,159,226,895,155,231,257,252,790,105
7976,273,236,26,130,64,16,116,112,0,8,37,0,8,0,29,29,8
7977,241,171,18,93,47,13,62,79,11,19,70,11,20,14,25,50,20
7979,145,137,5,84,48,0,34,85,8,10,8,0,8,0,0,8,0
7980,937,740,155,362,168,55,335,290,43,72,197,32,80,29,56,158,39
7981,3148,2359,310,1098,749,202,883,1127,115,234,789,127,201,230,231,658,131
8001,128,88,27,37,13,11,51,25,7,5,40,0,8,16,16,40,0
8002,8227,5541,744,2556,1656,585,1905,2547,395,694,2686,358,714,660,954,2386,300
8003,10699,8708,765,4558,2924,461,3594,4143,474,497,1991,192,538,822,439,1711,280
8004,5131,3971,643,2252,855,221,1646,1593,335,397,1160,188,407,326,239,975,185
8005,6069,4602,568,2205,1474,355,1776,2118,268,440,1467,155,354,630,328,1217,250
8006,371,227,13,74,102,38,53,145,13,16,144,13,27,40,64,131,13
8007,2265,1407,275,650,356,126,513,630,140,124,858,159,220,187,292,721,137
8008,3772,2317,176,700,1116,325,419,1574,88,236,1455,197,348,466,444,1292,163
8009,4224,3203,575,1569,857,202,1200,1372,280,351,1021,216,298,293,214,823,198
8010,4107,2788,470,1376,749,193,789,1210,435,354,1319,208,512,384,215,1083,236
8011,22,22,12,10,0,0,12,6,4,0,0,0,0,0,0,0,0
8012,14466,10264,1863,5306,2632,463,3882,4249,1142,991,4202,1321,1258,990,633,3435,767
8014,248,170,35,83,35,17,52,57,21,40,78,7,30,26,15,69,9
8015,7491,5602,1008,3043,1326,225,2014,2108,905,575,1889,283,778,600,228,1506,383
8016,11272,8075,1791,4135,1577,572,3074,3008,1097,896,3197,606,989,1004,598,2694,503
8019,325,228,28,137,35,28,98,90,20,20,97,16,39,14,28,75,22
8020,813,657,57,411,180,9,264,283,99,11,156,18,69,22,47,132,24
8021,18431,11630,2800,5867,2428,535,3648,4253,2230,1499,6801,1930,2464,1727,680,5474,1327
8022,2233,1698,102,685,619,292,524,1073,27,74,535,14,35,281,205,472,63
8023,122,69,5,58,0,6,23,10,13,23,53,5,0,36,12,48,5
8026,833,680,117,327,203,33,258,313,62,47,153,24,35,76,18,136,17
8027,1883,1439,241,630,418,150,486,677,121,155,444,22,157,125,140,416,28
8028,6632,4422,899,2312,897,314,1586,1547,723,566,2210,923,569,445,273,1512,698
8029,1954,1330,203,620,371,136,412,655,109,154,624,52,95,230,247,558,66
8030,5023,3373,657,1666,811,239,1169,1190,544,470,1650,221,449,503,477,1385,265
8031,4619,3241,471,1387,1045,338,951,1398,328,564,1378,234,399,460,285,1210,168
8032,132,119,30,58,11,20,54,47,7,11,13,0,0,7,6,6,7
8033,6702,4593,529,2277,1267,520,1868,2048,330,347,2109,483,573,503,550,1836,273
8034,7223,5093,611,2342,1558,582,1803,2466,266,558,2130,362,602,746,420,1803,327
8035,3039,2054,324,971,519,240,839,915,107,193,985,212,220,249,304,861,124
8036,78,57,0,41,16,0,14,22,21,0,21,13,0,8,0,15,6
8037,7798,5782,792,2890,1591,509,2088,2567,477,650,2016,300,585,555,576,1656,360
8038,115,90,16,41,27,6,33,54,3,0,25,0,6,11,8,22,3
8039,65,41,2,22,17,0,23,13,5,0,24,0,14,2,8,22,2
8041,290,225,4,128,84,9,105,96,7,17,65,7,30,19,9,56,9
8042,68,68,5,43,20,0,20,33,5,10,0,0,0,0,0,0,0
8043,10505,7204,1090,4185,1695,234,3415,2780,500,509,3301,1048,988,695,570,2824,477
8045,1023,717,70,289,298,60,126,263,131,197,306,17,83,121,85,293,13
8046,10747,8876,960,4329,3181,406,2497,3897,1110,1372,1871,143,598,910,220,1610,261
8048,314,176,0,91,67,18,15,139,10,12,138,7,31,28,72,138,0
8049,2043,1443,245,733,376,89,497,606,176,164,600,112,185,151,152,472,128
8050,7818,6028,953,2608,1867,600,2109,3098,311,510,1790,212,504,707,367,1530,260
8051,4247,2767,531,1428,638,170,1078,1176,275,238,1480,361,431,477,211,1274,206
8052,8434,4713,1226,2033,1074,380,1473,2015,562,663,3721,1150,1237,827,507,3045,676
8053,15128,10856,1789,6168,2476,423,4971,4189,917,779,4272,1248,1612,905,507,3538,734
8054,16581,11113,1676,5702,3027,708,4204,5239,857,813,5468,1371,1852,1590,655,4637,831
8055,9714,7818,723,4541,2223,331,3342,3725,422,329,1896,264,607,569,456,1654,242
8056,865,743,37,397,237,72,285,378,17,63,122,4,29,36,53,122,0
8057,7104,5406,535,2945,1473,453,2296,2338,401,371,1698,192,400,547,559,1481,217
8059,2180,1432,210,725,315,182,565,589,72,206,748,99,192,208,249,656,92
8060,13268,9538,1956,5427,1723,432,3974,3498,1297,769,3730,860,1305,993,572,3003,727
8061,224,144,18,66,55,5,24,47,52,21,80,6,34,13,27,62,18
8062,3504,2825,337,1845,560,83,1453,1002,212,158,679,140,226,191,122,560,119
8063,1159,904,172,453,218,61,376,360,81,87,255,28,75,90,62,211,44
8064,28,28,6,9,6,7,5,17,6,0,0,0,0,0,0,0,0
8065,3007,1861,378,906,415,162,588,780,236,257,1146,232,485,256,173,961,185
8066,3447,2141,478,957,550,156,552,740,475,374,1306,349,399,409,149,1072,234
8067,588,471,56,235,133,47,152,239,34,46,117,26,48,24,19,95,22
8068,2456,1653,351,697,532,73,427,693,263,270,803,255,266,225,57,656,147
8069,4867,3284,853,1382,808,241,884,1271,727,402,1583,228,538,478,339,1401,182
8070,5351,3747,549,1777,1125,296,1221,1772,370,384,1604,265,453,468,418,1397,207
8071,3685,2610,400,1340,699,171,969,1128,304,209,1075,215,326,262,272,946,129
8072,84,64,31,23,10,0,19,37,4,4,20,0,7,5,8,20,0
8073,95,86,8,25,53,0,24,53,0,9,9,0,0,9,0,9,0
8074,19,19,0,19,0,0,10,9,0,0,0,0,0,0,0,0,0
8075,9895,7152,1283,3612,1717,540,2768,2905,726,753,2743,771,934,628,410,2302,441
8077,6118,4917,420,2343,1706,448,1804,2437,244,432,1201,122,345,426,308,1061,140
8078,3317,2209,330,1109,571,199,733,856,255,365,1108,244,295,305,264,932,176
8079,4666,3206,662,1381,896,267,866,1316,620,404,1460,200,460,404,396,1255,205
8080,11758,9948,1375,6339,1934,300,5035,3598,787,528,1810,479,640,479,212,1454,356
8081,14073,11510,2606,6939,1681,284,5654,3484,1440,932,2563,583,1049,673,258,2128,435
8083,3748,2701,374,1253,870,204,841,1235,226,399,1047,208,368,314,157,953,94
8084,2743,1926,264,941,506,215,643,889,212,182,817,199,235,240,143,701,116
8085,3552,2853,568,1678,482,125,1388,1022,254,189,699,80,298,210,111,546,153
8086,2227,1468,225,828,356,59,533,645,155,135,759,172,241,233,113,644,115
8087,7854,5551,944,2555,1584,468,1836,2715,556,444,2303,311,536,845,611,1903,400
8088,9198,7021,720,3633,1885,783,2675,3591,314,441,2177,179,492,725,781,1910,267
8089,1283,977,148,485,276,68,331,458,89,99,306,34,108,98,66,251,55
8090,3018,2379,349,1156,710,164,905,1016,211,247,639,91,208,199,141,546,93
8091,1882,1370,200,764,326,80,542,536,120,172,512,84,152,200,76,412,100
8092,1183,797,115,393,245,44,351,363,26,57,386,32,105,140,109,321,65
8093,4059,2561,606,1266,481,208,910,973,371,307,1498,346,583,368,201,1195,303
8094,11707,8903,1641,4418,2279,565,3188,3689,976,1050,2804,389,980,899,536,2329,475
8095,44,35,10,17,0,8,12,8,15,0,9,0,9,0,0,9,0
8096,12350,8547,1450,4255,2222,620,2927,3444,1057,1119,3803,709,988,1152,954,3286,517
8097,1125,917,96,496,269,56,390,426,49,52,208,31,69,51,57,188,20
8098,2971,2193,287,1144,590,172,779,1032,163,219,778,104,224,200,250,682,96
8102,2594,1710,601,664,370,75,253,243,726,488,884,196,276,284,128,746,138
8103,4519,3156,823,1317,802,214,450,734,1214,758,1363,176,343,474,370,1191,172
8104,8236,5941,2011,2601,1132,197,960,864,2700,1417,2295,299,885,691,420,1904,391
8105,9224,7109,2525,3259,1146,179,1726,1315,2713,1355,2115,354,762,724,275,1652,463
8106,4179,2722,481,1340,615,286,1014,1143,273,292,1457,194,463,383,417,1287,170
8107,5576,3286,695,1666,671,254,1117,1109,531,529,2290,418,766,628,478,1942,348
8108,7894,4784,793,2328,1092,571,1700,2003,420,661,3110,607,833,854,816,2636,474
8109,8460,5849,919,2946,1443,541,2060,2475,651,663,2611,447,779,757,628,2352,259
8110,5132,4037,760,2210,817,250,1428,1195,759,655,1095,214,386,281,214,944,151
8201,12024,8603,1400,5090,1778,335,3240,3227,1371,765,3421,1009,1297,795,320,2442,979
8202,1077,699,41,210,333,115,132,532,14,21,378,31,91,134,122,357,21
8203,5473,3334,533,1411,1146,244,895,1602,407,430,2139,454,840,560,285,1683,456
8204,7782,5211,625,2242,1750,594,1573,2708,442,488,2571,195,668,976,732,2271,300
8210,4989,3796,596,1948,966,286,1491,1616,348,341,1193,201,366,423,203,983,210
8212,121,71,0,17,43,11,10,59,2,0,50,0,6,23,21,43,7
8215,4510,3228,511,1747,769,201,1112,1382,438,296,1282,133,344,382,423,1101,181
8217,67,32,0,20,12,0,11,21,0,0,35,11,6,0,18,29,6
8221,2668,1984,102,1120,592,170,792,968,86,138,684,61,176,261,186,600,84
8223,1592,1241,100,710,362,69,475,617,122,27,351,71,79,83,118,302,49
8224,203,159,11,95,37,16,71,58,16,14,44,9,18,10,7,37,7
8225,2835,2124,298,1044,579,203,862,872,123,267,711,62,254,251,144,610,101
8226,7479,4022,440,1582,1445,555,912,2343,376,391,3457,618,1001,1028,810,3008,449
8230,1924,1545,182,907,357,99,756,575,109,105,379,58,91,109,121,307,72
8232,6042,4151,1068,1956,983,144,1068,1114,1093,876,1891,253,721,542,375,1494,397
8234,10906,7940,1380,4670,1644,246,3223,2992,956,769,2966,434,1095,1011,426,2390,576
8241,356,280,17,193,56,14,118,117,9,36,76,3,41,17,15,64,12
8242,1232,755,127,341,216,71,200,347,123,85,477,68,138,179,92,410,67
8243,1335,767,40,279,351,97,160,484,43,80,568,62,104,238,164,518,50
8244,4924,2943,556,1467,681,239,1026,1112,436,369,1981,358,743,624,256,1631,350
8245,35,17,9,0,8,0,9,0,0,8,18,0,18,0,0,10,8
8247,633,361,14,115,164,68,61,250,17,33,272,25,56,97,94,249,23
8248,106,60,0,9,51,0,0,51,0,9,46,0,21,14,11,46,0
8251,4099,2727,516,1195,737,279,787,1204,446,290,1372,128,378,484,382,1151,221
8252,375,227,18,49,132,28,22,130,22,53,148,0,4,69,75,139,9
8260,6908,4061,658,1675,1340,388,965,2041,559,496,2847,430,674,1033,710,2480,367
8270,2675,2065,405,1096,423,141,792,798,274,201,610,68,255,172,115,483,127
8302,13574,9931,2084,4323,2713,811,2841,3722,1890,1478,3643,399,1135,1211,898,3192,451
8310,790,484,72,142,167,103,110,303,7,64,306,23,49,105,129,270,36
8311,636,496,108,252,98,38,199,176,69,52,140,4,43,66,27,119,21
8312,2432,1870,392,996,395,87,746,826,169,129,562,125,186,159,92,478,84
8313,67,67,0,53,14,0,32,25,10,0,0,0,0,0,0,0,0
8314,130,99,17,36,40,6,34,54,3,8,31,11,10,10,0,14,17
8316,109,82,17,28,19,18,31,47,4,0,27,0,0,12,15,23,4
8317,372,289,35,186,50,18,129,98,35,27,83,16,33,20,14,57,26
8318,4205,3333,459,1883,748,243,1310,1471,289,263,872,56,347,280,189,718,154
8319,421,350,43,211,84,12,152,144,28,26,71,5,32,18,16,54,17
8321,101,62,8,23,27,4,10,42,6,4,39,2,11,14,12,33,6
8322,3134,2557,331,1486,601,139,1070,998,252,237,577,98,207,161,111,473,104
8323,335,259,34,129,79,17,74,138,17,30,76,7,16,33,20,71,5
8324,162,142,36,61,36,9,48,50,33,11,20,0,5,15,0,9,11
8326,452,304,76,114,80,34,85,96,77,46,148,19,31,42,56,125,23
8327,350,247,48,115,75,9,73,107,36,31,103,14,36,30,23,96,7
8328,514,390,64,226,79,21,217,121,21,31,124,12,52,50,10,108,16
8329,57,24,0,24,0,0,0,24,0,0,33,10,6,17,0,23,10
8330,7679,5455,1219,2803,1214,219,2161,1986,697,611,2224,401,1012,538,273,1723,501
8332,12587,8877,2030,4181,2089,577,2747,3385,1791,954,3710,650,1235,1084,741,3068,642
8340,281,208,24,124,60,0,103,55,29,21,73,7,22,44,0,73,0
8341,821,513,96,269,132,16,149,196,94,74,308,31,86,93,98,268,40
8343,1550,1243,77,741,356,69,495,540,108,100,307,43,129,102,33,243,64
8344,2048,1586,173,868,415,130,504,718,142,222,462,47,98,166,151,404,58
8345,342,240,43,86,87,24,64,106,32,38,102,9,33,34,26,81,21
8346,200,153,6,119,18,10,85,32,18,18,47,0,0,34,13,23,24
8348,152,125,4,54,60,7,25,80,0,20,27,8,14,0,5,15,12
8349,905,701,101,336,197,67,167,316,124,94,204,17,55,69,63,173,31
8350,308,239,28,105,96,10,74,108,8,49,69,8,22,29,10,49,20
8352,268,200,50,96,41,13,55,60,67,18,68,16,31,4,17,56,12
8353,167,145,32,63,37,13,49,67,25,4,22,0,0,11,11,19,3
8360,14215,10017,2473,4621,2221,702,3131,3502,1835,1549,4198,537,1441,1225,995,3501,697
8361,5671,4243,667,2008,1254,314,1399,1837,516,491,1428,189,444,389,406,1186,242
8401,15886,8821,2546,3671,2010,594,1783,2323,2672,2043,7065,1077,2236,2330,1422,5904,1161
8402,3979,2322,232,765,927,398,512,1490,122,198,1657,268,423,449,517,1441,216
8403,588,338,11,106,163,58,73,233,13,19,250,20,75,67,88,216,34
8406,5493,3319,482,1470,1071,296,926,1474,358,561,2174,360,677,607,530,1834,340
8501,1771,1447,169,843,373,62,631,670,64,82,324,98,99,74,53,227,97
8502,5910,5331,664,3542,1017,108,3106,1836,242,147,579,135,201,151,92,499,80
8505,6050,4151,723,2143,1058,227,1453,1871,316,511,1899,499,673,464,263,1504,395
8510,698,609,75,353,160,21,280,266,45,18,89,0,37,41,11,80,9
8511,449,298,71,147,59,21,146,116,16,20,151,28,60,49,14,134,17
8512,3745,2608,580,1515,457,56,1246,843,268,251,1137,262,459,237,179,955,182
8514,1068,879,88,561,187,43,388,422,13,56,189,48,56,70,15,160,29
8515,110,89,11,44,29,5,47,33,0,9,21,8,3,6,4,13,8
8518,1946,1291,263,613,340,75,460,488,169,174,655,162,230,154,109,552,103
8520,9241,6560,1345,3505,1504,206,2602,2795,538,625,2681,672,1035,506,468,2135,546
8525,1899,1426,87,846,395,98,580,651,111,84,473,76,185,147,65,375,98
8527,14063,11213,2018,6438,2361,396,5361,4113,848,891,2850,420,1131,812,487,2253,597
8528,58,41,23,18,0,0,18,11,12,0,17,0,8,9,0,17,0
8530,2912,1733,160,932,506,135,604,872,86,171,1179,213,435,353,178,935,244
8533,2274,1814,298,1051,415,50,801,700,172,141,460,60,230,117,53,376,84
8534,4129,3322,423,1875,884,140,1551,1376,248,147,807,119,293,248,147,715,92
8535,536,520,44,374,101,1,336,149,28,7,16,0,16,0,0,16,0
8536,7718,4423,1404,2569,412,38,2273,1569,408,173,3295,1810,1121,262,102,2655,640
8540,14735,10147,1388,5207,2775,777,4086,4855,631,575,4588,1191,1602,1110,685,3736,852
8542,1440,670,205,301,100,64,255,205,100,110,770,306,202,165,97,574,196
8550,5519,4896,373,3383,1088,52,2954,1597,214,131,623,187,235,113,88,550,73
8551,1762,1527,162,902,381,82,693,690,67,77,235,44,66,62,63,180,55
8553,288,199,15,104,62,18,53,138,4,4,89,27,25,21,16,72,17
8554,1427,989,168,532,191,98,342,433,112,102,438,71,179,99,89,394,44
8555,324,255,15,166,60,14,113,99,29,14,69,11,21,23,14,49,20
8558,1745,1443,105,869,424,45,703,609,85,46,302,16,150,89,47,236,66
8559,1941,1509,110,869,438,92,590,763,54,102,432,64,173,130,65,313,119
8560,1316,1022,94,567,264,97,374,562,24,62,294,30,104,136,24,227,67
8561,114,84,0,46,29,9,31,38,15,0,30,10,0,10,10,30,0
8562,1754,1245,216,755,236,38,494,453,196,102,509,139,139,143,88,418,91
8608,431,156,57,99,0,0,35,15,92,14,275,37,101,98,39,246,29
8609,5006,3312,902,1610,617,183,824,651,985,852,1694,329,440,631,294,1396,298
8610,11864,7870,1458,3666,1895,851,2681,3363,810,1016,3994,521,1317,1159,997,3341,653
8611,8644,5467,1807,2261,974,425,1552,1404,1320,1191,3177,570,964,887,756,2677,500
8618,13632,8793,2194,3981,1984,634,2004,2302,2592,1895,4839,778,1660,1551,850,4091,748
8619,9281,6068,993,2982,1540,553,2156,2782,341,789,3213,586,787,992,848,2748,465
8620,4520,3514,494,1814,984,222,1462,1681,156,215,1006,174,364,241,227,803,203
8625,0,0,0,0,0,0,0,0,0,0,0,0,0,0,0,0,0
8628,3574,2225,364,940,670,251,643,1187,149,246,1349,265,528,338,218,1081,268
8629,4053,2772,662,1337,524,249,719,1057,567,429,1281,311,403,288,279,1054,227
8638,8258,5595,983,2599,1423,590,1443,2225,933,994,2663,363,877,831,592,2143,520
8640,823,711,361,339,7,4,465,181,62,3,112,25,87,0,0,96,16
8641,1633,1559,949,610,0,0,1162,251,140,6,74,67,4,3,0,60,14
8648,10343,6874,1078,3632,1599,565,2749,2896,588,641,3469,934,962,904,669,2812,657
8690,6356,5167,547,2967,1399,254,2080,2492,277,318,1189,194,359,415,221,965,224
8691,4336,3074,541,1884,562,87,1499,1210,197,168,1262,232,496,336,198,1076,186
8701,19952,13601,3729,5152,3365,1355,5424,5466,1351,1360,6351,448,980,2322,2601,5659,692
8720,250,220,9,147,56,8,101,88,8,23,30,0,20,10,0,30,0
8721,6168,4672,677,2458,1222,315,1703,2147,356,466,1496,231,349,589,327,1241,255
8722,3402,2797,497,1545,630,125,1157,1037,290,313,605,54,281,187,83,459,146
8723,12518,8758,1278,4354,2389,737,3083,4110,794,771,3760,641,966,1215,938,3142,618
8724,16450,11670,1682,6003,2912,1073,4381,5051,1062,1176,4780,625,1362,1484,1309,4072,708
8730,1949,1425,90,742,477,116,539,675,63,148,524,39,145,195,145,453,71
8731,6933,5255,876,2484,1400,495,1918,2566,377,394,1678,140,408,614,516,1404,274
8732,649,457,43,240,137,37,159,228,32,38,192,36,65,51,40,153,39
8733,7851,4736,378,1137,1728,1493,861,3276,189,410,3115,109,184,1119,1703,2878,237
8734,2419,2024,177,1268,490,89,889,767,172,196,395,56,133,68,138,311,84
8735,2150,1276,73,353,593,257,157,900,70,149,874,92,211,300,271,795,79
8736,5178,3630,363,1790,1137,340,1464,1632,186,348,1548,292,514,466,276,1285,263
8738,676,416,4,170,195,47,80,294,16,26,260,28,48,127,57,250,10
8740,831,543,128,259,118,38,174,188,103,78,288,38,124,82,44,234,54
8741,936,696,72,367,203,54,264,354,36,42,240,26,77,62,75,191,49
8742,10568,6977,861,3680,1923,513,2620,3140,521,696,3591,627,1205,1030,729,2977,614
8750,1657,1073,54,483,394,142,352,595,25,101,584,60,160,211,153,513,71
8751,2412,1188,321,431,334,102,286,509,221,172,1224,286,471,240,227,1052,172
8752,1480,776,60,273,350,93,125,505,79,67,704,119,165,234,186,591,113
8753,23076,17167,2276,8906,4924,1061,6344,7444,1516,1863,5909,1061,1775,1676,1397,4905,1004
8755,8703,6475,715,2707,2327,726,2031,3341,494,609,2228,272,423,941,592,1944,284
8757,17254,10240,568,1852,4069,3751,1283,7628,360,969,7014,112,360,2157,4385,6635,379
8758,2000,1406,307,675,283,141,583,520,163,140,594,99,223,146,126,498,96
8759,10672,4686,91,510,2013,2072,335,3871,29,451,5986,9,174,2063,3740,5791,195
8801,2582,1976,197,1178,546,55,884,927,73,92,606,156,221,203,26,512,94
8802,1312,1092,101,698,273,20,536,447,59,50,220,13,77,78,52,171,49
8804,728,550,75,334,118,23,252,240,36,22,178,37,72,40,29,127,51
8805,4331,3037,650,1433,723,231,1087,1153,267,530,1294,345,377,338,234,980,314
8807,13208,10037,1563,5598,2398,478,4532,4239,626,640,3171,602,1114,818,637,2655,516
8809,2070,1234,164,678,323,69,457,591,119,67,836,213,300,258,65,696,140
8810,2373,2013,329,1438,219,27,1116,625,216,56,360,116,91,102,51,323,37
8812,4369,3262,456,1752,791,263,1338,1428,186,310,1107,201,465,272,169,884,223
8816,15992,12815,1435,7393,3330,657,5787,5281,819,928,3177,581,997,951,648,2753,424
8817,16287,11832,2888,5865,2514,565,4734,4917,811,1370,4455,1462,1535,825,633,3425,1030
8820,12777,10490,1253,5901,2837,499,4743,4432,488,827,2287,340,841,682,424,1970,317
8821,115,64,9,27,28,0,21,43,0,0,51,0,27,16,8,51,0
8822,10268,7620,955,4719,1655,291,3710,2895,510,505,2648,547,1011,615,475,2147,501
8823,3134,1951,525,1091,279,56,826,602,268,255,1183,441,555,174,13,934,249
8824,3739,3232,343,2088,706,95,1807,1163,120,142,507,86,119,191,111,410,97
8825,1678,1211,192,751,219,49,600,483,77,51,467,84,151,129,103,376,91
8826,2164,1526,210,908,357,51,644,700,91,91,638,143,258,187,50,509,129
8827,1425,1155,131,739,246,39,564,469,74,48,270,56,96,76,42,201,69
8828,743,495,107,310,66,12,203,205,46,41,248,64,116,50,18,189,59
8829,1434,1060,210,606,200,44,500,398,92,70,374,90,203,53,28,295,79
8830,5869,4460,798,2258,1014,390,1608,1976,281,595,1409,266,385,418,340,1196,213
8831,14840,9964,921,3340,3452,2251,2536,6433,379,616,4876,226,531,1619,2500,4495,381
8832,1104,785,350,344,64,27,283,258,168,76,319,138,112,23,46,286,33
8833,2908,2376,163,1527,601,85,1113,1066,137,60,532,49,206,178,99,449,83
8835,4102,2806,398,1285,781,342,1027,1148,162,469,1296,260,338,360,338,1057,239
8836,1348,1156,77,700,310,69,523,539,45,49,192,14,56,83,39,178,14
8837,6039,3674,858,1699,817,300,1191,1723,294,466,2365,688,688,502,487,1993,372
8840,5965,4366,581,2160,1201,424,1672,1899,309,486,1599,331,580,386,302,1307,292
8846,5057,3760,606,1916,980,258,1400,1514,340,506,1297,185,346,430,336,1093,204
8848,3099,2505,296,1363,655,191,993,1213,149,150,594,68,180,196,150,517,77
8850,3091,2364,204,1206,783,171,955,1015,129,265,727,110,197,180,240,599,128
8852,5321,3571,965,1999,494,113,1607,1281,423,260,1750,652,737,302,59,1317,433
8853,3972,3392,345,2281,715,51,1783,1338,123,148,580,117,245,111,107,505,75
8854,16508,12456,2362,6535,3012,547,4862,5524,905,1165,4052,1178,1513,841,520,3227,825
8857,12953,9637,1711,5319,2216,391,4140,3844,711,942,3316,870,1123,974,349,2754,562
8858,80,63,0,45,18,0,14,37,0,12,17,0,9,8,0,17,0
8859,7310,5491,1075,2876,1300,240,2235,2154,428,674,1819,383,644,411,381,1568,251
8861,15421,11463,2941,5657,2165,700,3991,3393,2258,1821,3958,586,1363,1130,879,3270,688
8863,4414,3119,625,1421,789,284,1179,1344,224,372,1295,314,397,312,272,1071,224
8865,11273,7750,1369,3756,1915,710,2616,3283,1026,825,3523,568,971,1025,959,3046,477
8867,1505,1245,92,757,376,20,567,590,49,39,260,23,94,63,80,196,64
8869,2586,1711,304,807,392,208,658,704,141,208,875,203,272,221,179,748,127
8872,6877,5073,1087,2651,1026,309,2062,2118,467,426,1804,500,520,389,395,1466,338
8873,15343,10442,1948,5502,2397,595,3808,4576,996,1062,4901,1472,1829,1075,525,3899,1002
8876,15914,10918,2294,6057,2113,454,4809,4272,942,895,4996,1215,1977,1123,681,4091,905
8879,8217,5763,978,2899,1469,417,2065,2296,540,862,2454,560,821,661,412,2050,404
8880,1632,1108,263,558,235,52,437,394,88,189,524,134,194,112,84,410,114
8882,5628,3982,889,1884,909,300,1596,1620,281,485,1646,277,492,439,438,1308,338
8884,3114,2193,377,1055,617,144,774,1052,146,221,921,147,146,334,294,819,102
8886,1585,1384,280,890,175,39,752,504,65,63,201,33,52,78,38,170,31
8887,545,253,68,125,25,35,52,168,24,9,292,61,114,74,43,272,20
8889,3485,2782,317,1586,774,105,1252,1242,97,191,703,94,290,235,84,589,114
8901,13063,7359,2590,3133,1256,380,2115,1818,2011,1415,5704,3080,1183,923,518,3188,2516
8902,13901,9592,1937,5113,2092,450,3762,3983,972,875,4309,1075,1606,1021,607,3419,890
8904,5905,3424,829,1631,652,312,1443,1317,275,389,2481,963,703,403,412,1856,625
10001,8772,2711,612,1096,771,232,523,1152,334,702,6061,2007,2141,1147,766,4907,1154
10002,31647,18859,2801,9160,5206,1692,4790,7282,2763,4024,12788,3056,3587,3465,2680,10710,2078
10003,29743,7504,1997,3452,1541,514,2025,4120,408,951,22239,9620,8127,3139,1353,17243,4996
10004,574,221,94,87,28,12,86,75,13,47,353,173,165,15,0,211,142
10005,612,119,85,34,0,0,8,70,5,36,493,367,99,27,0,360,133
10006,793,230,102,112,16,0,64,120,18,28,563,348,177,38,0,340,223
10007,1283,563,145,365,44,9,236,259,41,27,720,280,375,65,0,508,212
10009,29084,11823,2283,5708,2870,962,2547,4145,2339,2792,17261,6041,6038,3136,2046,13273,3988
10010,15379,4819,953,2233,1116,517,1216,2505,374,724,10560,4073,3215,2092,1180,8553,2007
10011,28708,6704,1358,3304,1625,417,1666,3638,465,935,22004,7428,9044,3835,1697,17701,4303
10012,13705,4501,893,2116,1188,304,1175,2297,302,727,9204,4349,2893,1391,571,6943,2261
10013,10095,5447,734,2762,1479,472,1683,2604,423,737,4648,1269,1826,997,556,3696,952
10014,20542,4763,1305,2237,990,231,1253,2513,360,637,15779,5999,6049,2856,875,12255,3524
10016,30871,7973,2353,3454,1741,425,1803,4844,507,819,22898,9941,7525,3896,1536,18256,4642
10017,11101,2742,795,1159,636,152,623,1656,162,301,8359,3456,2688,1627,588,7290,1069
10018,2205,626,225,259,129,13,143,255,55,173,1579,649,663,240,27,1029,550
10019,22309,5984,1809,2352,1489,334,1017,3346,623,998,16325,6149,5771,2983,1422,13248,3077
10020,0,0,0,0,0,0,0,0,0,0,0,0,0,0,0,0,0
10021,61898,20928,4692,8448,6081,1707,5939,12501,1076,1412,40970,15476,12773,8468,4253,35355,5615
10022,19615,6274,1078,2327,2211,658,1289,4338,276,371,13341,3907,4177,3588,1669,11661,1680
10023,37215,11604,2620,5004,3139,841,2970,6436,742,1456,25611,8838,8893,5045,2835,21985,3626
10024,33688,12623,2330,6252,3286,755,4368,5936,993,1326,21065,7265,7779,4012,2009,17512,3553
10025,46634,19247,3489,9391,5166,1201,5621,6943,2758,3925,27387,8706,9795,6136,2750,21474,5913
10026,12233,6812,1709,3496,1308,299,1127,1048,2724,1913,5421,1373,1858,1366,824,4539,882
10027,21789,10798,2947,4624,2581,646,1876,2445,3409,3068,10991,3038,3673,2855,1425,8955,2036
10028,26171,9188,1594,4259,2641,694,3107,4948,486,647,16983,7433,5058,3189,1303,14248,2735
10029,27623,17413,4255,7946,4204,1008,3195,3320,5420,5478,10210,2009,2840,3729,1632,8823,1387
10030,10982,5853,1735,2827,1078,213,781,966,2615,1491,5129,1040,1755,1450,884,4596,533
10031,20973,12996,3096,6384,2826,690,2967,2394,3819,3816,7977,2092,2707,2091,1087,6427,1550
10032,20636,13451,2917,6665,3260,609,3183,2598,3869,3801,7185,1365,2309,2264,1247,5790,1395
10033,19366,12954,2771,6357,3000,826,3348,3260,3190,3156,6412,1674,1985,1504,1249,4956,1456
10034,15288,9856,2506,5067,1800,483,2471,2280,2906,2199,5432,1606,1789,1359,678,4404,1028
10035,11237,6586,1667,3269,1451,199,1244,955,2427,1960,4651,689,1669,1521,772,4159,492
10036,10844,2480,637,1127,578,138,476,1303,236,465,8364,2661,3723,1593,387,6484,1880
10037,8545,3836,774,1614,1098,350,464,758,1248,1366,4709,800,1473,1434,1002,4353,356
10038,6602,3010,458,1310,787,455,562,1329,302,817,3592,1088,788,799,917,2868,724
10039,8870,5297,1316,2281,1311,389,605,939,2223,1530,3573,541,1023,1302,707,3184,389
10040,16225,10759,2782,5354,2015,608,2715,2327,3348,2369,5466,1298,1874,1339,955,4463,1003
10041,0,0,0,0,0,0,0,0,0,0,0,0,0,0,0,0,0
10044,3214,1840,195,1127,436,82,631,619,387,203,1374,258,530,398,188,1157,217
10048,0,0,0,0,0,0,0,0,0,0,0,0,0,0,0,0,0
10069,961,422,157,195,58,12,105,261,33,23,539,298,205,36,0,463,76
10103,0,0,0,0,0,0,0,0,0,0,0,0,0,0,0,0,0
10111,0,0,0,0,0,0,0,0,0,0,0,0,0,0,0,0,0
10112,0,0,0,0,0,0,0,0,0,0,0,0,0,0,0,0,0
10115,0,0,0,0,0,0,0,0,0,0,0,0,0,0,0,0,0
10119,0,0,0,0,0,0,0,0,0,0,0,0,0,0,0,0,0
10128,32769,12049,2679,5816,2930,624,4001,5626,1047,1375,20720,8742,6608,3775,1595,16311,4409
10152,0,0,0,0,0,0,0,0,0,0,0,0,0,0,0,0,0
10153,0,0,0,0,0,0,0,0,0,0,0,0,0,0,0,0,0
10154,0,0,0,0,0,0,0,0,0,0,0,0,0,0,0,0,0
10162,966,480,98,243,124,15,176,233,45,26,486,122,164,140,60,486,0
10165,6,6,6,0,0,0,0,0,0,6,0,0,0,0,0,0,0
10167,0,0,0,0,0,0,0,0,0,0,0,0,0,0,0,0,0
10169,0,0,0,0,0,0,0,0,0,0,0,0,0,0,0,0,0
10170,0,0,0,0,0,0,0,0,0,0,0,0,0,0,0,0,0
10171,0,0,0,0,0,0,0,0,0,0,0,0,0,0,0,0,0
10172,0,0,0,0,0,0,0,0,0,0,0,0,0,0,0,0,0
10173,0,0,0,0,0,0,0,0,0,0,0,0,0,0,0,0,0
10177,0,0,0,0,0,0,0,0,0,0,0,0,0,0,0,0,0
10271,0,0,0,0,0,0,0,0,0,0,0,0,0,0,0,0,0
10278,0,0,0,0,0,0,0,0,0,0,0,0,0,0,0,0,0
10279,0,0,0,0,0,0,0,0,0,0,0,0,0,0,0,0,0
10280,3757,1613,493,856,246,18,501,834,174,104,2144,759,1045,277,63,1795,349
10282,764,317,95,213,9,0,71,157,80,9,447,284,141,22,0,323,124
10301,14359,8557,1949,4378,1748,482,2784,2885,1645,1243,5802,1465,2053,1446,838,4685,1117
10302,5549,3868,1049,1734,817,268,1269,1274,728,597,1681,194,557,542,388,1467,214
10303,7394,5807,1412,3107,1037,251,2099,1413,1452,843,1587,323,573,453,238,1389,198
10304,13312,9560,2068,4847,2110,535,3023,3097,2149,1291,3752,664,1463,983,642,3232,520
10305,14162,9702,1857,4845,2305,695,3644,3645,1011,1402,4460,834,1503,1245,878,3846,614
10306,20700,14986,2260,7438,4237,1051,5578,6373,1085,1950,5714,835,1759,1771,1349,5077,637
10307,4063,3112,542,1844,610,116,1608,1087,185,232,951,304,316,165,166,828,123
10308,9528,7473,1071,3665,2378,359,2979,3346,323,825,2055,324,619,770,342,1872,183
10309,8799,7013,1184,4050,1509,270,3246,2724,555,488,1786,384,621,514,267,1566,220
10310,8143,5713,1046,3125,1213,329,2011,1819,984,899,2430,440,789,613,588,2146,284
10312,20024,16183,2377,9099,4195,512,6992,6791,953,1447,3841,722,1188,1191,740,3444,397
10314,30383,22693,3186,11831,6415,1261,9133,9374,1579,2607,7690,1660,2300,2408,1322,6795,895
10451,14925,9702,2442,4656,2128,476,1641,1647,3918,2496,5223,620,1547,2163,893,4694,529
10452,22884,16976,5733,8460,2318,465,4095,1974,7178,3729,5908,1074,2544,1863,427,4852,1056
10453,24125,18113,5559,9590,2584,380,4133,2281,7818,3881,6012,1031,2618,1893,470,5078,934
10454,11436,7725,2099,3799,1610,217,1682,1126,2978,1939,3711,395,1114,1652,550,3311,400
10455,11992,8679,2498,4224,1726,231,1954,1402,3167,2156,3313,435,1210,1109,559,2818,495
10456,25149,18062,5411,8650,3382,619,3756,2572,7445,4289,7087,1043,2659,2390,995,6231,856
10457,22262,16182,5344,8043,2376,419,3406,2344,7044,3388,6080,920,2247,2031,882,5220,860
10458,25289,17576,6265,8520,2246,545,4501,2999,6969,3107,7713,1660,2929,1938,1186,6547,1166
10459,12497,9000,2540,4554,1729,177,1944,1421,3599,2036,3497,391,1105,1440,561,3039,458
10460,18059,12610,3743,6303,2233,331,2840,2058,5157,2555,5449,1115,1633,1898,803,4627,822
10461,20189,12189,2616,5328,2975,1270,3614,4987,1547,2041,8000,2018,2273,2012,1697,6987,1013
10462,28280,18313,4616,9070,3552,1075,5160,4804,4843,3506,9967,2037,3446,2759,1725,8523,1444
10463,27471,16143,3430,7538,3486,1689,4362,5712,3547,2522,11328,2256,3364,3070,2638,9921,1407
10464,2085,1144,193,513,337,101,394,535,109,106,941,136,399,269,137,775,166
10465,15981,11268,1755,5351,3307,855,3359,4547,1503,1859,4713,755,1176,1626,1156,4259,454
10466,23622,16951,3530,8352,4299,770,4244,4106,4552,4049,6671,1267,2414,2000,990,5843,828
10467,34760,22657,7028,10743,3732,1154,5717,4890,7692,4358,12103,2230,4716,3250,1907,10347,1756
10468,25724,18311,5652,9456,2692,511,4893,3133,6602,3683,7413,1708,2708,2042,955,6191,1222
10469,21462,15743,2720,7542,4285,1196,4164,4942,3315,3322,5719,1034,1587,1727,1371,5037,682
10470,6529,3987,877,1726,1056,328,1243,1356,662,726,2542,598,699,757,488,2184,358
10471,9769,5323,795,2448,1559,521,1701,2467,487,668,4446,978,1421,1172,875,3936,510
10472,21824,15819,4704,7420,3116,579,3624,3193,5610,3392,6005,962,2105,2039,899,5136,869
10473,19422,14380,3085,6804,3662,829,3161,3399,4298,3522,5042,580,1614,2136,712,4617,425
10474,3400,2479,782,1264,375,58,606,275,1072,526,921,170,281,363,107,730,191
10475,16979,9855,1323,4726,2944,862,2216,3395,1955,2289,7124,731,2221,2558,1614,6657,467
10501,235,208,31,116,43,18,117,56,0,35,27,0,17,5,5,16,11
10502,1630,1392,74,805,390,123,708,548,74,62,238,5,68,91,74,201,37
10503,59,40,0,8,26,6,8,32,0,0,19,0,5,7,7,19,0
10504,2315,2029,110,1179,596,144,983,836,80,130,286,5,78,136,67,229,57
10506,1852,1579,124,920,498,37,849,643,45,42,273,23,119,112,19,204,69
10507,2076,1486,260,799,336,91,673,651,62,100,590,132,169,157,132,481,109
10509,6614,5008,639,3027,1112,230,2317,1849,375,467,1606,277,657,447,225,1312,294
10510,3227,2629,269,1529,652,179,1398,1006,85,140,598,32,173,205,188,516,82
10511,809,603,121,290,143,49,215,242,68,78,206,31,66,64,45,180,26
10512,8472,6364,901,3637,1507,319,2682,2688,495,499,2108,449,811,553,295,1692,416
10514,3820,3408,247,2198,837,126,1848,1261,249,50,412,54,147,147,64,353,59
10516,2153,1438,203,746,407,82,557,659,88,134,715,93,224,207,191,602,113
10518,549,486,25,357,97,7,281,143,25,37,63,0,28,28,7,63,0
10519,47,33,24,4,5,0,7,17,4,5,14,8,6,0,0,14,0
10520,4959,3264,311,1979,803,171,1569,1284,197,214,1695,247,412,604,432,1537,158
10522,3814,2578,322,1389,653,214,1096,950,276,256,1236,228,479,277,252,1042,194
10523,2518,1871,425,845,518,83,710,678,198,285,647,172,196,126,153,514,133
10524,1462,1144,71,698,323,52,490,500,50,104,318,14,154,118,32,244,74
10526,565,455,72,272,104,7,235,178,42,0,110,18,19,39,34,76,34
10527,340,312,32,180,94,6,149,127,16,20,28,7,0,21,0,28,0
10528,4680,3398,461,1684,884,369,1420,1592,189,197,1282,274,428,313,267,1121,161
10530,5692,3558,476,1716,1015,351,1197,1939,167,255,2134,322,802,653,357,1918,216
10532,1714,1376,150,713,422,91,584,636,45,111,338,58,94,73,113,293,45
10533,2788,2067,196,1163,541,167,1056,812,48,151,721,180,198,205,138,644,77
10535,150,85,13,67,0,5,53,32,0,0,65,13,36,10,6,51,14
10536,3441,2831,239,1742,716,134,1468,1008,137,218,610,107,198,199,106,497,113
10537,753,556,73,284,176,23,202,205,70,79,197,52,73,49,23,147,50
10538,6375,4708,700,2355,1342,311,2279,1921,261,247,1667,344,519,397,407,1490,177
10541,8626,7209,893,4154,1892,270,3387,2944,385,493,1417,253,564,380,220,1154,263
10543,7301,5132,844,2450,1410,428,2087,2187,351,507,2169,421,676,650,422,1900,269
10546,435,349,36,223,90,0,193,119,29,8,86,23,47,16,0,72,14
10547,2839,2177,408,1320,363,86,979,832,247,119,662,123,326,141,72,567,95
10548,1411,1049,122,594,246,87,427,427,91,104,362,29,117,131,85,314,48
10549,5810,4018,615,2186,1000,217,1827,1532,303,356,1792,308,637,550,297,1533,259
10550,13844,9202,2170,4612,1928,492,2428,2420,2444,1910,4642,869,1573,1373,827,4049,593
10552,8625,5107,860,2541,1165,541,1597,2076,531,903,3518,772,1144,981,621,3078,440
10553,3233,2510,374,1281,691,164,643,679,634,554,723,68,242,332,81,581,142
10560,1686,1338,138,774,353,73,622,557,80,79,348,41,99,158,50,279,69
10562,10672,7231,1460,3731,1599,441,2683,2824,846,878,3441,692,1224,1055,470,2842,599
10566,8695,5402,1521,2637,876,368,1791,1636,1077,898,3293,501,1325,925,542,2727,566
10567,5659,4770,579,2869,1123,199,2347,1846,250,327,889,142,271,391,85,702,187
10570,4221,3236,375,1842,797,222,1580,1267,167,222,985,189,300,325,171,827,158
10573,12683,8948,1878,4175,2137,758,3512,3367,774,1295,3735,706,972,1227,830,3127,608
10576,1648,1380,84,756,462,78,570,700,60,50,268,20,84,119,45,212,56
10577,710,663,34,375,188,66,347,280,15,21,47,0,13,13,21,41,6
10578,238,194,6,139,22,27,90,97,0,7,44,8,9,14,13,44,0
10579,2752,2193,359,1263,487,84,1013,856,134,190,559,58,261,179,61,443,116
10580,5865,4488,419,2517,1221,331,2252,1699,212,325,1377,270,325,369,413,1194,183
10583,13721,10873,898,5946,3084,945,5415,4427,467,564,2848,379,767,994,708,2570,278
10588,678,567,71,330,130,36,248,213,48,58,111,12,27,55,17,86,25
10589,3372,2228,144,873,830,381,631,1381,36,180,1144,12,164,600,368,1055,89
10590,2537,2057,184,1241,578,54,1042,856,101,58,480,76,189,163,52,403,77
10591,8323,5414,1173,2596,1263,382,2012,2155,571,676,2909,744,1073,612,480,2354,555
10594,1666,1371,79,759,440,93,540,638,42,151,295,31,117,117,30,252,43
10595,2032,1538,278,773,413,74,676,723,69,70,494,185,125,123,61,333,161
10597,110,83,15,59,9,0,44,35,4,0,27,0,7,20,0,27,0
10598,10271,8219,761,4704,2166,588,3924,3502,351,442,2052,154,414,744,740,1875,177
10601,4060,1877,492,842,412,131,459,708,354,356,2183,570,790,522,301,1885,298
10603,6831,4130,686,1899,1156,389,1335,1768,448,579,2701,536,1004,642,519,2338,363
10604,3892,2675,489,1293,684,209,1030,1123,242,280,1217,229,365,359,264,1019,198
10605,6895,4738,566,2310,1462,400,1866,2203,297,372,2157,275,698,731,453,1870,287
10606,5351,3622,683,1859,861,219,1305,1467,378,472,1729,510,517,435,267,1443,286
10607,2530,2002,260,903,669,170,653,990,95,264,528,53,184,188,103,415,113
10701,22447,15330,4035,7373,2994,928,4510,4260,4093,2467,7117,1263,2560,2188,1106,6049,1068
10703,7740,5144,989,2445,1250,460,1681,1839,889,735,2596,350,692,817,737,2324,272
10704,11955,7693,1367,3204,2229,893,2267,3548,654,1224,4262,933,1138,1105,1086,3689,573
10705,13369,9344,2631,4241,1917,555,2967,2596,2351,1430,4025,920,1254,1243,608,3412,613
10706,3624,2522,208,1367,766,181,1085,1186,120,131,1102,185,436,251,230,952,150
10707,3734,2554,510,1190,647,207,933,1137,197,287,1180,290,399,292,199,1039,141
10708,9749,5763,863,2714,1670,516,2024,2892,261,586,3986,593,1258,1278,857,3593,393
10709,3626,2536,217,1263,781,275,926,1178,145,287,1090,143,272,356,319,1005,85
10710,10084,6928,814,3148,2066,900,2171,3294,515,948,3156,350,783,1103,920,2887,269
10801,12740,8399,1774,4025,1928,672,3145,2548,1233,1473,4341,765,1205,1349,1022,3637,704
10803,4221,3246,323,1793,887,243,1541,1264,217,224,975,202,313,206,254,824,151
10804,4861,4033,280,2088,1279,386,1835,1854,167,177,828,33,126,347,322,754,74
10805,7365,4176,877,1979,1016,304,1356,1622,517,681,3189,775,1058,831,525,2758,431
10901,8077,5698,792,3084,1487,335,2364,2466,440,428,2379,400,639,850,490,2042,337
10913,1472,1277,114,688,442,33,546,584,38,109,195,16,47,65,67,161,34
10916,1276,1029,82,619,291,37,507,426,46,50,247,40,99,76,32,191,56
10917,582,482,88,259,96,39,206,222,27,27,100,26,37,5,32,89,11
10918,3741,2910,430,1712,650,118,1298,1219,196,197,831,188,327,227,89,652,179
10919,179,138,19,90,29,0,58,45,14,21,41,12,12,0,17,23,18
10920,3002,2505,360,1427,632,86,1053,1075,187,190,497,92,116,238,51,477,20
10921,1389,1067,109,625,269,64,435,459,78,95,322,40,128,86,68,280,42
10923,2891,2260,392,1216,570,82,943,865,239,213,631,143,272,165,51,492,139
10924,4005,2865,411,1516,747,191,1216,1165,235,249,1140,178,267,422,273,994,146
10925,1930,1235,148,729,300,58,487,523,147,78,695,131,321,155,88,529,166
10926,1226,892,182,527,166,17,396,280,111,105,334,87,150,49,48,266,68
10927,2799,2172,588,994,485,105,767,643,481,281,627,139,133,186,169,508,119
10928,2239,1388,212,717,384,75,467,566,173,182,851,181,290,230,150,730,121
10930,2383,2033,332,1193,455,53,1089,690,150,104,350,53,159,101,37,317,33
10931,215,177,19,83,58,17,36,69,47,25,38,0,11,11,16,32,6
10940,15444,10506,2319,5501,2049,637,3743,3713,1812,1238,4938,840,1605,1551,942,4105,833
10941,4720,3514,641,1847,890,136,1350,1381,470,313,1206,358,440,290,118,945,261
10950,10675,8995,2224,4715,1762,294,5019,2943,551,482,1680,197,724,496,263,1462,218
10952,7928,6840,1520,3177,1757,386,3868,2299,298,375,1088,156,320,331,281,940,148
10954,8083,6071,827,3255,1653,336,2229,2598,639,605,2012,270,670,650,422,1767,245
10956,9902,8625,702,4701,2918,304,3821,4074,222,508,1277,131,345,533,268,1081,196
10958,925,746,118,392,200,36,326,273,83,64,179,17,77,39,46,158,21
10960,6015,3452,586,1707,866,293,1190,1508,353,401,2563,612,956,676,319,2032,531
10962,1728,1406,57,644,540,165,513,746,22,125,322,38,65,145,74,309,13
10963,901,709,111,397,170,31,295,310,59,45,192,22,55,70,45,155,37
10964,460,357,36,143,160,18,122,183,0,52,103,9,20,46,28,86,17
10965,5300,3951,472,1760,1301,418,1539,1758,128,526,1349,241,335,483,290,1169,180
10968,1112,590,69,331,166,24,197,265,65,63,522,139,220,128,35,412,110
10969,358,243,32,121,74,16,112,110,13,8,115,8,23,60,24,101,14
10970,3647,2571,353,1438,695,85,848,1132,336,255,1076,301,361,322,92,906,170
10973,637,495,71,254,119,51,150,251,63,31,142,24,67,21,30,109,33
10974,1059,843,118,449,251,25,360,335,54,94,216,53,69,52,42,164,52
10975,133,43,16,27,0,0,16,17,5,5,90,29,42,19,0,69,21
10976,578,254,43,134,58,19,109,103,27,15,324,14,20,55,235,316,8
10977,13656,11141,2432,5824,2525,360,4873,3569,1412,1287,2515,435,845,811,424,2092,423
10980,4299,3422,399,1798,1029,196,1412,1492,227,291,877,139,250,290,198,760,117
10983,2040,1671,191,821,548,111,685,718,83,185,369,32,58,111,168,351,18
10984,768,633,79,383,166,5,270,298,31,34,135,51,40,25,19,96,39
10985,17,17,0,17,0,0,11,0,6,0,0,0,0,0,0,0,0
10986,599,444,70,244,124,6,149,198,39,58,155,41,21,48,45,99,56
10987,1246,942,91,493,292,66,326,478,65,73,304,49,115,85,55,229,75
10989,3346,2449,269,1380,657,143,955,1181,115,198,897,147,365,272,113,733,164
10990,6564,4980,568,2951,1161,300,2384,2041,318,237,1584,195,576,467,346,1370,214
10992,3039,2409,291,1510,562,46,1234,785,215,175,630,59,204,185,182,557,73
10993,1589,1107,210,523,306,68,515,357,100,135,482,56,70,155,201,438,44
10994,2179,1825,198,942,629,56,759,910,51,105,354,61,83,117,93,259,95
10996,984,929,380,523,26,0,655,197,56,21,55,36,16,3,0,52,3
10998,1177,942,129,568,205,40,480,334,84,44,235,28,101,72,34,185,50
11001,8910,6863,635,3675,1916,637,2747,2841,327,948,2047,256,507,583,701,1847,200
11003,12280,9867,1205,5423,2491,748,3682,3714,1085,1386,2413,328,758,659,668,2041,372
11004,5703,3798,428,1899,1094,377,1416,1731,222,429,1905,357,606,497,445,1675,230
11005,1582,569,0,56,216,297,24,506,0,39,1013,0,80,399,534,988,25
11010,8679,6723,878,3132,1956,757,2566,3047,281,829,1956,251,362,538,805,1774,182
11020,1354,1178,52,542,446,138,507,595,19,57,176,0,24,62,90,160,16
11021,8565,5208,674,2523,1419,592,1953,2503,318,434,3357,637,882,955,883,3005,352
11023,2982,2407,218,1039,868,282,920,1203,129,155,575,23,60,246,246,518,57
11024,2173,1841,147,852,651,191,783,790,92,176,332,37,61,97,137,296,36
11030,5827,4789,317,2307,1654,511,1971,2315,147,356,1038,124,200,378,336,910,128
11040,13337,10799,980,5147,3288,1384,4268,4950,418,1163,2538,161,470,800,1107,2289,249
11042,0,0,0,0,0,0,0,0,0,0,0,0,0,0,0,0,0
11050,10423,7799,945,4059,2229,566,3138,3509,549,603,2624,444,816,794,570,2180,444
11096,2562,1893,293,969,482,149,662,548,308,375,669,45,163,216,245,553,116
11101,9781,5625,1439,2874,1048,264,1374,1435,1553,1263,4156,1201,1530,1059,366,3270,886
11102,13769,8080,2002,3896,1698,484,2764,2753,987,1576,5689,2301,1838,948,602,4213,1476
11103,17509,10105,2455,4909,2271,470,3247,3720,939,2199,7404,3036,2099,1275,994,5302,2102
11104,12379,6908,1607,3291,1567,443,2314,2495,549,1550,5471,1750,1628,1152,941,4293,1178
11105,16982,10330,1948,4802,2726,854,3289,4477,845,1719,6652,2699,1505,1435,1013,4974,1678
11106,17723,9931,2364,4914,1941,712,3196,3544,1365,1826,7792,2400,2360,1682,1350,6050,1742
11201,21551,9089,2324,4220,2052,493,2603,3713,1081,1692,12462,4869,4055,2584,954,9904,2558
11203,27849,20705,3536,10378,6014,777,4665,5237,5312,5491,7144,1368,2495,2469,812,6150,994
11204,25902,18939,3792,8618,4917,1612,7480,7614,1375,2470,6963,1142,1586,1995,2240,6104,859
11205,13180,7256,2038,3615,1328,275,1327,1562,2422,1945,5924,1982,2057,1432,453,4641,1283
11206,22501,15734,4082,7525,3442,685,3570,2958,5188,4018,6767,1063,1989,2603,1112,5615,1152
11207,27631,20665,5689,9800,4465,711,4384,3835,7943,4503,6966,1228,2819,2253,666,6070,896
11208,25905,20728,5505,10416,4072,735,5978,4226,6296,4228,5177,833,2193,1686,465,4425,752
11209,31571,17028,3435,8046,4152,1395,5870,7044,1295,2819,14543,3585,4563,3443,2952,12729,1814
11210,19859,14844,2678,7993,3551,622,5326,3925,2979,2614,5015,1023,1894,1366,732,4309,706
11211,27879,17749,5693,7982,3002,1072,7114,4626,3135,2874,10130,3833,2560,2321,1416,7479,2651
11212,28512,20724,5431,10245,4471,577,3664,3424,8420,5216,7788,1100,2777,2772,1139,6898,890
11213,22652,15390,3969,7307,3294,820,3556,2767,4656,4411,7262,1230,2425,2499,1108,6310,952
11214,31493,21864,3865,10252,5665,2082,7370,9199,1813,3482,9629,1561,2491,2880,2697,8588,1041
11215,27469,13709,3066,7240,2652,751,4909,5016,1680,2104,13760,6290,4537,1913,1020,9476,4284
11216,22024,12815,3286,6233,2603,693,2437,2310,4368,3700,9209,1838,3542,2695,1134,7959,1250
11217,15726,7107,1644,3716,1436,311,1950,2526,1169,1462,8619,3995,3007,1177,440,6062,2557
11218,25584,17134,3708,8894,3410,1122,6802,5365,2275,2692,8450,1785,2800,2197,1668,6844,1606
11219,26610,19630,5282,8842,3581,1925,9225,6479,1787,2139,6980,1066,1698,1939,2277,6117,863
11220,28564,21250,5288,10680,4417,865,7949,6044,3437,3820,7314,1764,2168,2217,1165,6029,1285
11221,25322,17588,5196,8160,3516,716,3651,2997,6643,4297,7734,1342,2973,2340,1079,6823,911
11222,15915,8880,1851,4438,2125,466,2956,3142,882,1900,7035,2088,2347,1625,975,4941,2094
11223,28178,20261,3853,9420,5271,1717,7359,7794,2015,3093,7917,1220,1721,2678,2298,7202,715
11224,20226,12758,2013,5946,3680,1119,2783,4797,2895,2283,7468,548,1665,2835,2420,7032,436
11225,23452,16086,3428,8326,3618,714,3375,3672,4769,4270,7366,1447,2872,2263,784,6464,902
11226,35767,25967,6161,14195,4998,613,5981,4633,8458,6895,9800,1964,4286,2790,760,8249,1551
11228,15808,10781,1921,4676,3143,1041,3565,5046,670,1500,5027,780,1298,1427,1522,4518,509
11229,30333,21193,3317,10243,5649,1984,7182,9037,2014,2960,9140,1114,2230,2964,2832,8266,874
11230,31485,21502,4120,9863,5258,2261,8691,8086,1766,2959,9983,1462,2587,2935,2999,8919,1064
11231,14904,7884,2368,3467,1629,420,1926,2798,1730,1430,7020,2677,2437,1237,669,5291,1729
11232,8371,5954,1841,2813,967,333,2257,1488,1192,1017,2417,619,845,681,272,1845,572
11233,22463,14857,4249,7056,2862,690,2536,2196,6218,3907,7606,1260,2685,2608,1053,6628,978
11234,31174,23464,3095,12275,6369,1725,7969,8689,2780,4026,7710,1251,2289,2366,1804,6911,799
11235,32182,19813,3018,8841,5594,2360,5998,9308,1547,2960,12369,1725,3211,3863,3570,11074,1295
11236,31693,24333,4951,13128,5183,1071,7468,6145,5897,4823,7360,1585,2629,2008,1138,6393,967
11237,14007,11162,4021,5226,1668,247,3403,1940,3757,2062,2845,683,884,914,364,2124,721
11238,20889,10254,2303,5267,2073,611,2194,2831,2667,2562,10635,3865,3709,2214,847,8144,2491
11239,6375,3773,536,1824,1075,338,713,1325,954,781,2602,175,505,1135,787,2463,139
11354,19811,13472,2025,7017,3457,973,4508,5486,1198,2280,6339,968,1820,1783,1768,5347,992
11355,28717,20821,3873,10919,4774,1255,7402,7902,1976,3541,7896,1593,2425,2082,1796,6441,1455
11356,7074,5252,965,2763,1223,301,1926,2090,545,691,1822,383,517,485,437,1548,274
11357,15364,10905,1456,4673,3501,1275,3534,5290,566,1515,4459,674,1044,1342,1399,3933,526
11358,13875,9998,1557,4982,2655,804,3611,4371,718,1298,3877,988,1037,890,962,3311,566
11360,8874,5374,453,2274,1972,675,1370,3201,288,515,3500,466,1080,997,957,3209,291
11361,11172,7485,1091,3703,2087,604,2686,3196,502,1101,3687,1041,1177,842,627,3136,551
11362,7040,4959,625,2198,1516,620,1719,2403,287,550,2081,260,612,697,512,1912,169
11363,2653,1911,204,959,623,125,673,918,124,196,742,135,283,184,140,659,83
11364,13526,9616,1117,4958,2460,1081,3581,4412,518,1105,3910,554,1364,966,1026,3602,308
11365,16037,11310,2161,5468,2515,1166,4066,4537,1195,1512,4727,784,1372,1215,1356,4174,553
11366,4497,3510,361,1900,925,324,1383,1455,190,482,987,147,180,325,335,853,134
11367,14592,10076,2228,4520,2325,1003,3578,4175,948,1375,4516,872,1420,1303,921,3924,592
11368,27585,21446,5693,11066,3891,796,7707,5629,4014,4096,6139,1284,2327,1635,893,4818,1321
11369,11069,8299,1771,3977,1982,569,2877,2146,1550,1726,2770,395,845,977,553,2293,477
11370,9745,7285,1464,3493,1869,459,2875,2583,519,1308,2460,515,789,654,502,1934,526
11371,0,0,0,0,0,0,0,0,0,0,0,0,0,0,0,0,0
11372,24893,16290,3992,7864,3423,1011,5500,5238,1999,3553,8603,1515,3045,2671,1372,6682,1921
11373,33173,24328,5462,12481,5385,1000,8778,7768,2683,5099,8845,2405,2782,2302,1356,6601,2244
11374,19315,11181,1756,5420,2818,1187,3585,5141,792,1663,8134,1971,2375,2026,1762,7082,1052
11375,33284,18079,3473,8047,4661,1898,5819,8847,1099,2314,15205,3331,4772,3787,3315,13383,1822
11377,31545,20632,4770,10321,4540,1001,7069,6978,2419,4166,10913,2984,3423,2883,1623,8301,2612
11378,13235,9073,1811,4239,2308,715,3008,3592,882,1591,4162,934,1079,946,1203,3547,615
11379,11827,7798,1146,3660,2290,702,2406,3601,701,1090,4029,677,1071,1293,988,3616,413
11385,34810,25052,6370,12111,5203,1368,9126,8057,3993,3876,9758,1925,2931,2727,2175,8421,1337
11411,6607,5479,516,2461,2244,258,1354,2083,753,1289,1128,182,351,412,183,915,213
11412,11524,8717,1312,3820,2703,882,2103,2103,1629,2882,2807,283,841,1097,586,2376,431
11413,12715,10300,1310,5037,3348,605,2561,3363,1745,2631,2415,441,797,854,323,1968,447
11414,11370,7872,987,3151,2839,895,2175,3899,479,1319,3498,520,1031,1048,899,3140,358
11415,8565,4717,1072,2279,1012,354,1667,1853,453,744,3848,1175,1432,788,453,3097,751
11416,7319,5780,1570,2954,953,303,2194,1779,976,831,1539,340,481,419,299,1275,264
11417,9238,7134,1387,3881,1415,451,2716,2571,822,1025,2104,471,619,543,471,1781,323
11418,11346,8579,1795,4684,1783,317,3317,2417,1321,1524,2767,772,957,612,426,2208,559
11419,13397,11461,2123,6592,2396,350,4722,3497,1470,1772,1936,556,626,514,240,1461,475
11420,13304,10935,1801,5876,2697,561,3970,3573,1642,1750,2369,459,798,678,434,1968,401
11421,12124,9199,1950,4865,1827,557,3767,2835,1148,1449,2925,584,915,689,737,2581,344
11422,9357,7380,1023,4259,1866,232,2686,2105,1298,1291,1977,326,700,624,327,1688,289
11423,9544,7369,1120,3815,2018,416,2499,2378,1084,1408,2175,368,659,707,441,1861,314
11426,6304,4692,634,2445,1134,479,1885,1963,263,581,1612,272,395,482,463,1465,147
11427,7887,6030,893,3082,1591,464,2186,2279,720,845,1857,304,533,531,489,1690,167
11428,5959,5034,829,2829,1163,213,2196,1604,501,733,925,177,381,218,149,748,177
11429,7759,6488,938,2986,2316,248,1857,2100,1007,1524,1271,129,481,461,200,1022,249
11430,20,20,7,13,0,0,7,13,0,0,0,0,0,0,0,0,0
11432,18111,12614,2395,6767,2828,624,4534,3989,1626,2465,5497,1157,1972,1588,780,4637,860
11433,9132,6632,1271,3280,1650,431,1569,1496,1757,1810,2500,187,637,1035,641,2235,265
11434,19950,14060,2260,6948,3825,1027,3466,3433,3264,3897,5890,621,1964,2139,1166,5227,663
11435,17788,12590,3014,6204,2771,601,4192,3801,2001,2596,5198,1120,2105,1382,591,4238,960
11436,5465,4262,660,2015,1207,380,958,1158,1026,1120,1203,132,406,442,223,979,224
11501,7496,4988,909,2335,1328,416,1858,2273,223,634,2508,476,718,651,663,2206,302
11507,2588,2184,177,1051,655,301,880,981,107,216,404,25,63,149,167,368,36
11509,1061,819,58,375,307,79,252,454,52,61,242,24,69,92,57,224,18
11510,10857,8709,1069,4704,2401,535,3546,3651,642,870,2148,246,616,676,610,1835,313
11514,1862,1395,199,736,309,151,572,630,81,112,467,121,93,146,107,434,33
11516,2602,1903,271,892,557,183,711,838,137,217,699,94,155,258,192,621,78
11518,4244,2962,361,1635,721,245,1146,1292,186,338,1282,138,453,397,294,1113,169
11520,13597,10125,1775,5455,2343,552,3570,3273,1589,1693,3472,440,1228,1195,609,2846,626
11530,9072,7189,511,3648,2316,714,2872,3404,298,615,1883,141,403,631,708,1726,157
11542,9827,7031,1112,3228,1950,741,2308,3105,676,942,2796,419,743,901,733,2313,483
11545,4067,3376,246,1807,1044,279,1426,1541,187,222,691,80,233,193,185,571,120
11547,264,194,23,98,51,22,65,100,0,29,70,22,34,0,14,47,23
11548,463,358,61,155,116,26,141,164,16,37,105,17,33,25,30,103,2
11550,16003,12028,3225,5673,2672,458,3692,3027,2567,2742,3975,690,1297,1412,576,3283,692
11552,7444,6077,717,3018,1736,606,2502,2489,424,662,1367,185,349,419,414,1141,226
11553,6181,4967,712,2682,1285,288,1973,1529,560,905,1214,139,270,401,404,969,245
11554,12161,9770,1251,5069,2445,1005,4134,4173,467,996,2391,215,431,770,975,2146,245
11557,2785,2240,127,1145,720,248,861,1115,117,147,545,63,152,167,163,482,63
11558,3010,2277,309,1078,767,123,755,1051,168,303,733,136,244,197,156,619,114
11559,2693,2098,289,974,617,218,985,856,99,158,595,53,144,177,221,562,33
11560,2491,1879,243,933,547,156,734,815,128,202,612,78,202,182,150,517,95
11561,16639,9353,1482,4769,2372,730,2733,4310,1027,1283,7286,1813,2631,1673,1169,5938,1348
11563,8586,6162,835,3052,1692,583,2344,2735,294,789,2424,359,694,762,609,2117,307
11565,3212,2641,205,1412,786,238,1042,1247,77,275,571,42,120,198,211,475,96
11566,11807,10152,1047,5759,2684,662,4550,4279,432,891,1655,84,378,670,523,1442,213
11568,1003,869,44,432,312,81,432,378,29,30,134,17,35,58,24,102,32
11569,657,436,48,145,189,54,100,239,23,74,221,39,63,60,59,154,67
11570,10103,7229,884,3851,1878,616,3151,2993,372,713,2874,349,717,926,882,2586,288
11572,10741,8729,850,4396,2775,708,3598,3900,378,853,2012,231,525,625,631,1780,232
11575,4154,3478,628,1623,1080,147,974,911,692,901,676,79,260,257,80,519,157
11576,4201,3533,185,1825,1266,257,1532,1762,106,133,668,51,190,289,138,588,80
11577,4324,3396,261,1899,925,311,1450,1416,223,307,928,105,291,305,227,831,97
11579,2036,1374,114,705,400,155,570,583,72,149,662,151,231,162,118,538,124
11580,12603,9833,1245,5106,2440,1042,3789,4122,732,1190,2770,240,651,956,923,2488,282
11581,7070,5693,478,2977,1647,591,2266,2534,272,621,1377,133,254,528,462,1213,164
11590,12445,9968,1449,4920,2800,799,3773,4083,836,1276,2477,348,702,768,659,1995,482
11596,3692,2941,271,1515,880,275,1185,1399,105,252,751,108,166,205,272,646,105
11598,4287,3646,457,1756,1131,302,1659,1634,182,171,641,64,141,257,179,596,45
11691,18078,12277,2923,6242,2542,570,3462,3107,3557,2151,5801,871,1679,1853,1398,5313,488
11692,5097,3753,863,2014,762,114,792,758,1330,873,1344,207,497,471,169,1218,126
11693,4167,2797,498,1592,629,78,745,776,785,491,1370,248,356,495,271,1226,144
11694,7847,4648,711,2183,1313,441,1538,2018,510,582,3199,582,1099,856,662,2960,239
11697,1871,1206,108,551,418,129,428,519,43,216,665,26,160,236,243,635,30
11701,8764,5944,982,2972,1546,444,1875,2097,838,1134,2820,369,990,754,707,2328,492
11702,5400,4007,565,2233,958,251,1634,1700,273,400,1393,312,470,371,240,1106,287
11703,5669,4333,541,2180,1289,323,1614,1892,186,641,1336,204,463,399,270,1088,248
11704,13150,10120,1684,5200,2633,603,3954,3888,955,1323,3030,570,940,906,614,2484,546
11705,2773,2128,330,1201,538,59,968,899,158,103,645,150,297,143,55,481,164
11706,18591,14230,2220,7495,3767,748,5250,5227,1743,2010,4361,658,1667,1299,737,3437,924
11709,2499,1878,266,924,588,100,750,859,91,178,621,54,237,225,105,497,124
11710,11590,9568,1175,5022,2653,718,4122,3943,462,1041,2022,202,565,700,555,1784,238
11713,2756,2168,334,1216,480,138,841,739,319,269,588,69,196,210,113,450,138
11714,7894,6199,789,2762,2012,636,2244,2979,241,735,1695,240,355,606,494,1461,234
11715,1570,1188,167,662,301,58,487,505,85,111,382,44,113,135,90,311,71
11716,3519,2750,481,1435,691,143,1104,1221,184,241,769,161,185,234,189,646,123
11717,12045,10539,1974,5644,2458,463,4324,3247,1400,1568,1506,203,529,504,270,1154,352
11718,1065,839,96,464,227,52,396,364,8,71,226,41,85,78,22,162,64
11719,1020,770,52,438,255,25,254,390,46,80,250,24,129,79,18,156,94
11720,8407,7224,1054,4184,1757,229,3338,2701,521,664,1183,257,384,344,198,895,288
11721,2299,1794,188,983,564,59,736,831,101,126,505,83,199,167,56,385,120
11722,9523,7486,1301,4141,1795,249,2765,2379,1231,1111,2037,358,741,641,297,1578,459
11724,974,859,52,525,223,59,408,353,51,47,115,0,35,54,26,107,8
11725,9443,8233,879,4316,2604,434,3620,3668,376,569,1210,106,288,582,234,1033,177
11726,5552,4226,697,2173,1100,256,1636,1636,325,629,1326,203,438,407,278,1061,265
11727,9374,6768,1435,3496,1554,283,2569,2906,576,717,2606,628,813,830,335,2089,517
11729,9475,7385,1126,3454,2375,430,2844,3269,497,775,2090,321,492,787,490,1708,382
11730,5216,4285,553,2427,1090,215,1971,1599,298,417,931,118,283,300,230,777,154
11731,10346,8689,1031,4504,2635,519,3635,3948,424,682,1657,258,499,613,287,1350,307
11732,1570,1083,143,514,345,81,360,568,67,88,487,34,202,152,99,453,34
11733,5807,4752,426,2878,1282,166,2215,2022,257,258,1055,237,317,357,144,738,317
11735,10896,8352,1284,4099,2274,695,3389,3515,488,960,2544,388,895,697,564,2116,428
11738,5137,4437,644,2697,972,124,2030,1710,276,421,700,224,227,164,85,523,177
11740,3442,2470,301,1357,675,137,1051,1030,199,190,972,78,191,286,417,847,125
11741,9070,7475,1270,4085,1934,186,3228,3215,507,525,1595,282,708,474,131,1255,340
11742,4068,3182,681,1799,604,98,1476,1271,218,217,886,201,297,282,106,702,184
11743,14774,11280,1190,5939,3360,791,4448,5094,593,1145,3494,636,1201,976,681,2783,711
11746,20244,16501,2182,8547,4973,799,6908,6861,1193,1539,3743,724,1412,982,625,2874,869
11747,5296,4308,439,2287,1308,274,1878,1952,179,299,988,199,274,342,173,824,164
11751,5221,3998,724,2075,996,203,1654,1567,389,388,1223,184,407,421,211,988,235
11752,3002,2540,394,1325,731,90,1144,997,150,249,462,84,210,124,44,370,92
11753,4018,3391,219,1813,1100,259,1469,1648,89,185,627,83,156,238,150,533,94
11754,6294,4907,695,2558,1391,263,2172,2061,238,436,1387,171,374,425,417,1185,202
11755,3822,3188,576,1662,856,94,1353,1345,165,325,634,180,188,126,140,486,148
11756,14084,11678,1382,6398,3168,730,4905,4656,707,1410,2406,287,728,803,588,1934,472
11757,15202,11905,1881,6362,2992,670,4975,4486,909,1535,3297,584,1078,1025,610,2591,706
11758,18122,15059,1826,7494,4541,1198,6198,6695,593,1573,3063,323,747,1174,819,2548,515
11762,7980,6871,716,3448,2117,590,2823,3177,228,643,1109,63,227,432,387,997,112
11763,7491,6251,890,3792,1316,253,2786,2400,474,591,1240,149,443,407,241,935,305
11764,3583,3015,399,1844,638,134,1524,1082,241,168,568,99,277,116,76,454,114
11765,239,187,11,98,55,23,79,96,4,8,52,3,20,12,17,42,10
11766,2837,2502,281,1594,525,102,1219,1060,115,108,335,35,71,133,96,290,45
11767,4488,3802,591,2138,963,110,1705,1585,180,332,686,140,177,266,103,580,106
11768,7794,6084,517,3237,1917,413,2420,2988,278,398,1710,208,650,574,278,1382,328
11769,3646,2629,337,1297,832,163,971,1303,118,237,1017,130,300,373,214,878,139
11770,88,47,4,29,14,0,16,21,10,0,41,2,24,13,2,37,4
11771,3457,2540,292,1314,740,194,1065,1047,99,329,917,195,276,247,199,787,130
11772,15167,10397,1992,5281,2431,693,3744,4325,1134,1194,4770,801,1454,1308,1207,3846,924
11776,7406,5814,1050,2936,1614,214,2563,2453,300,498,1592,290,565,496,241,1306,286
11777,3366,2266,258,1091,839,78,786,1170,141,169,1100,241,441,263,155,833,267
11778,3990,2989,569,1681,591,148,1467,1009,278,235,1001,230,431,154,186,777,224
11779,13052,10145,1776,5457,2460,452,4324,4127,657,1037,2907,524,951,867,565,2371,536
11780,5111,3961,420,2075,1195,271,1657,1885,164,255,1150,80,285,362,423,1021,129
11782,5283,4137,528,2324,1043,242,1805,1690,248,394,1146,208,349,348,241,933,213
11783,7354,5999,704,3118,1594,583,2550,2556,260,633,1355,122,401,494,338,1121,234
11784,8332,6691,1319,3651,1483,238,3043,2296,664,688,1641,350,496,490,305,1305,336
11786,1875,1659,147,950,486,76,708,785,121,45,216,25,77,61,53,167,49
11787,11693,9521,1139,4664,3202,516,3916,4367,400,838,2172,320,638,733,481,1829,343
11788,5779,4571,569,2288,1560,154,1768,2120,240,443,1208,330,397,368,113,955,253
11789,2655,1988,405,1114,328,141,868,606,248,266,667,190,285,70,122,496,171
11790,5253,3999,492,2067,1184,256,1720,1931,174,174,1254,385,273,309,287,1034,220
11791,8125,7002,611,3791,2084,516,3047,3242,332,381,1123,76,248,468,331,1007,116
11792,2404,1961,305,1112,461,83,866,875,128,92,443,46,208,103,86,331,112
11793,11074,9106,1008,4823,2567,708,3979,4023,332,772,1968,154,622,648,544,1736,232
11795,8384,7187,814,4035,2008,330,3227,2910,403,647,1197,161,352,461,223,934,263
11796,1336,1006,142,561,258,45,411,374,93,128,330,40,99,105,86,296,34
11797,2845,2317,240,1281,696,100,1012,1099,107,99,528,90,148,180,110,484,44
11798,3862,3228,658,1660,797,113,1097,797,724,610,634,60,267,217,90,457,177
11801,13187,10433,1243,4998,3026,1166,3888,4557,492,1496,2754,409,774,824,747,2300,454
11803,9260,7947,687,4203,2401,656,3401,3693,281,572,1313,47,276,562,428,1201,112
11804,1706,1448,107,756,462,123,625,680,32,111,258,4,41,100,113,247,11
11901,8536,5611,973,2488,1483,667,1558,2504,844,705,2925,308,806,1030,781,2418,507
11930,556,313,39,110,128,36,93,167,18,35,243,16,92,95,40,202,41
11932,629,410,9,162,171,68,86,260,22,42,219,5,68,99,47,191,28
11933,2385,1544,183,736,474,151,477,765,199,103,841,46,264,278,253,759,82
11934,2167,1708,185,970,450,103,652,747,152,157,459,75,165,92,127,352,107
11935,1318,967,92,452,322,101,307,542,74,44,351,28,110,107,106,302,49
11937,5337,3375,450,1771,871,283,1139,1502,412,322,1962,175,635,765,387,1519,443
11939,327,235,22,88,92,33,63,144,17,11,92,2,20,37,33,84,8
11940,1457,1185,191,627,306,61,544,512,76,53,272,24,118,68,62,219,53
11941,884,623,99,370,122,32,277,265,49,32,261,51,111,67,32,222,39
11942,1567,1063,115,621,238,89,457,478,50,78,504,96,184,127,97,404,100
11944,1513,900,146,382,275,97,261,398,145,96,613,81,129,210,193,508,105
11946,5123,3322,516,1540,982,284,1001,1652,344,325,1801,300,494,534,473,1436,365
11947,87,74,18,39,17,0,53,16,3,2,13,0,4,9,0,9,4
11948,351,247,17,137,75,18,83,133,15,16,104,6,30,36,32,87,17
11949,4295,3081,527,1657,692,205,1442,1356,154,129,1214,186,465,329,234,1021,193
11950,4234,3743,826,2216,574,127,1551,1207,621,364,491,98,190,116,87,404,87
11951,4068,3090,672,1768,524,126,1311,1042,443,294,978,144,424,238,172,726,252
11952,1823,1391,154,674,446,117,467,655,144,125,432,22,134,81,195,381,51
11953,4619,3202,711,1561,782,148,1114,1280,394,414,1417,207,654,361,195,1052,365
11954,1594,1001,172,472,270,87,331,444,99,127,593,121,201,196,75,451,142
11955,1278,769,172,275,231,91,165,524,44,36,509,101,149,174,85,377,132
11956,161,86,1,45,27,13,15,61,5,5,75,5,26,13,31,63,12
11957,318,202,7,71,79,45,34,136,15,17,116,2,25,52,37,101,15
11958,221,134,5,80,49,0,65,50,5,14,87,13,21,25,28,82,5
11959,435,296,19,115,122,40,61,176,31,28,139,5,47,50,37,122,17
11960,329,237,18,99,94,26,82,125,14,16,92,7,26,43,16,72,20
11961,5193,3191,439,1516,660,576,1163,1490,287,251,2002,85,197,484,1236,1850,152
11962,179,109,0,49,41,19,25,63,8,13,70,9,27,23,11,60,10
11963,2973,1762,171,813,553,225,606,821,150,185,1211,137,424,372,278,1015,196
11964,549,329,23,136,121,49,78,181,25,45,220,40,52,58,70,184,36
11965,448,330,26,128,112,64,94,198,10,28,118,5,16,51,46,99,19
11967,7273,6073,1104,3677,1085,207,2538,2071,853,611,1200,242,456,356,146,894,306
11968,4720,2934,458,1271,926,279,869,1352,372,341,1786,259,559,594,374,1418,368
11970,125,77,17,38,6,16,27,42,8,0,48,0,34,7,7,34,14
11971,2383,1694,198,685,592,219,522,1000,92,80,689,49,131,206,303,605,84
11972,277,192,26,109,44,13,80,82,9,21,85,36,17,20,12,49,36
11975,178,103,22,40,36,5,27,57,4,15,75,5,21,37,12,60,15
11976,771,492,16,253,204,19,155,276,0,61,279,10,123,103,43,178,101
11977,823,577,68,316,156,37,240,259,43,35,246,33,67,97,49,219,27
11978,1461,953,137,450,297,69,328,431,123,71,508,99,116,172,121,440,68
11980,1393,955,154,549,209,43,374,423,69,89,438,97,149,131,61,330,108
12008,187,164,44,83,26,11,96,53,15,0,23,0,9,0,14,23,0
12009,2974,2114,314,1185,491,124,846,960,197,111,860,195,227,237,201,702,158
12010,11904,7529,1317,3291,1895,1026,2154,3381,1127,867,4375,782,1208,1128,1257,3780,595
12015,1150,788,141,362,245,40,239,401,83,65,362,34,93,150,85,313,49
12017,119,80,13,39,24,4,27,45,6,2,39,0,14,19,6,24,15
12018,2857,2180,397,1184,450,149,925,903,220,132,677,161,248,156,112,507,170
12019,5007,3879,456,2131,1118,174,1576,1853,280,170,1128,312,326,316,174,866,262
12020,10613,7617,1939,3891,1453,334,3267,3057,883,410,2996,806,1053,738,399,2311,685
12022,303,220,38,101,51,30,76,93,26,25,83,4,25,28,26,74,9
12023,832,598,96,314,162,26,238,232,65,63,234,26,88,60,60,210,24
12025,2198,1582,264,785,412,121,613,681,140,148,616,65,224,182,145,541,75
12027,1367,1105,145,598,304,58,488,512,71,34,262,40,44,85,93,235,27
12028,366,298,64,127,97,10,118,120,32,28,68,4,31,33,0,56,12
12029,463,309,40,144,102,23,92,164,28,25,154,12,77,46,19,124,30
12031,55,41,13,18,8,2,9,19,9,4,14,7,7,0,0,10,4
12032,368,236,14,122,75,25,55,133,36,12,132,14,47,51,20,99,33
12033,3055,2234,282,1182,646,124,895,952,229,158,821,123,278,227,193,691,130
12035,502,332,47,195,65,25,122,144,45,21,170,68,43,16,43,117,53
12036,90,65,14,23,20,8,15,36,10,4,25,0,11,12,2,18,7
12037,1668,1079,177,525,287,90,361,504,120,94,589,76,184,203,126,503,86
12041,13,7,0,0,7,0,0,7,0,0,6,6,0,0,0,6,0
12042,277,218,29,124,44,21,97,92,15,14,59,10,14,35,0,54,5
12043,2889,1757,314,837,488,118,641,752,269,95,1132,240,240,365,287,905,227
12045,275,218,40,126,34,18,82,78,37,21,57,5,26,14,12,52,5
12046,316,243,35,112,87,9,79,144,5,15,73,0,52,21,0,56,17
12047,7955,4550,1100,2065,986,399,1367,1826,832,525,3405,631,1059,925,790,2886,519
12051,1681,1017,182,514,271,50,372,353,153,139,664,113,185,207,159,549,115
12052,379,282,54,153,60,15,99,141,26,16,97,0,58,29,10,72,25
12053,1640,1319,181,746,351,41,571,629,53,66,321,58,109,116,38,283,38
12054,6515,4500,542,2442,1129,387,1922,1955,328,295,2015,332,553,571,559,1712,303
12056,874,656,95,364,153,44,234,337,47,38,218,47,91,51,29,172,46
12057,631,509,79,251,127,52,193,264,29,23,122,26,27,33,36,97,25
12058,565,417,65,218,122,12,146,193,57,21,148,21,62,56,9,117,31
12059,669,484,50,271,152,11,163,226,74,21,185,31,77,38,39,138,47
12060,567,374,21,218,109,26,119,205,18,32,193,27,59,46,61,162,31
12061,3005,2139,313,1201,475,150,840,904,196,199,866,262,267,140,197,700,166
12062,625,483,58,279,135,11,182,232,44,25,142,17,68,43,14,98,44
12063,59,47,0,30,17,0,29,18,0,0,12,0,0,0,12,12,0
12064,187,127,27,53,34,13,33,82,10,2,60,8,10,13,29,39,21
12065,15777,10575,1973,5722,2533,347,4434,4615,957,569,5202,1583,1974,1130,515,4118,1084
12066,713,528,87,270,136,35,237,179,64,48,185,21,81,58,25,133,52
12067,697,517,56,298,149,14,216,228,33,40,180,55,62,18,45,116,64
12068,1506,1089,208,530,263,88,408,456,128,97,417,31,131,146,109,363,54
12070,515,412,63,226,83,40,139,164,48,61,103,20,37,24,22,78,25
12071,111,80,17,28,29,6,20,44,11,5,31,6,5,16,4,26,5
12072,903,653,128,326,146,53,242,278,74,59,250,32,77,83,58,206,44
12074,1210,913,153,482,230,48,342,440,82,49,297,57,107,87,46,230,67
12075,1094,846,121,442,228,55,277,452,68,49,248,26,80,81,61,216,32
12076,515,376,37,166,144,29,107,196,32,41,139,7,52,47,33,131,8
12077,1987,1555,244,883,349,79,775,617,94,69,432,59,126,188,59,387,45
12078,9811,6264,1245,2760,1710,549,1758,2940,1071,495,3547,577,1054,954,962,2892,655
12083,1220,818,123,417,232,46,310,386,74,48,402,39,99,136,128,324,78
12084,2163,1052,247,520,207,78,247,525,144,136,1111,411,310,217,173,916,195
12086,623,437,41,229,145,22,159,206,35,37,186,19,48,66,53,173,13
12087,213,176,23,100,53,0,66,85,19,6,37,0,0,28,9,30,7
12090,2522,1719,242,844,475,158,589,788,210,132,803,170,222,208,203,733,70
12092,400,299,11,126,150,12,35,187,59,18,101,13,33,29,26,78,23
12093,575,400,39,192,135,34,116,213,41,30,175,15,63,72,25,149,26
12094,776,578,121,320,113,24,263,222,67,26,198,41,80,49,28,141,57
12095,4889,3198,608,1465,797,328,1046,1457,475,220,1691,339,450,502,400,1472,219
12106,948,629,72,329,184,44,216,317,56,40,319,55,95,109,60,250,69
12108,178,124,12,50,51,11,31,83,5,5,54,18,5,22,9,47,7
12110,7322,5233,705,2759,1325,444,2037,2438,392,366,2089,568,676,513,332,1690,399
12115,89,72,13,46,10,3,30,27,3,12,17,10,2,5,0,17,0
12116,738,504,91,221,152,40,148,276,40,40,234,51,70,58,55,187,47
12117,1281,916,134,427,264,91,265,442,141,68,365,46,120,115,84,305,60
12118,4919,3108,685,1451,704,268,1168,1393,334,213,1811,371,612,459,369,1522,289
12120,228,163,20,87,41,15,55,81,17,10,65,5,18,28,14,50,15
12121,677,571,105,232,210,24,202,280,28,61,106,12,22,40,32,106,0
12122,1792,1184,213,563,308,100,391,526,151,116,608,91,188,191,138,519,89
12123,2056,1495,246,767,376,106,525,681,159,130,561,81,188,163,129,456,105
12125,621,388,73,179,112,24,129,163,65,31,233,33,82,86,32,176,57
12130,365,245,34,145,58,8,75,131,28,11,120,26,37,21,36,92,28
12131,102,70,15,23,26,6,24,34,4,8,32,0,13,14,5,27,5
12134,1101,773,119,363,237,54,206,402,104,61,328,38,82,114,94,267,61
12136,412,253,37,110,76,30,94,129,10,20,159,16,55,73,15,136,23
12137,508,391,64,221,90,16,141,209,27,14,117,19,42,37,19,96,21
12138,1412,1034,160,564,256,54,360,486,121,67,378,44,139,134,61,297,81
12139,131,95,10,53,21,11,38,33,11,13,36,0,3,30,3,36,0
12140,541,372,40,180,131,21,128,200,34,10,169,39,41,35,54,130,39
12143,2152,1460,276,752,346,86,606,565,201,88,692,135,203,163,191,591,101
12144,7606,4843,966,2457,1103,317,1603,2082,620,538,2763,538,957,784,484,2284,479
12147,210,132,16,54,51,11,47,75,2,8,78,13,22,22,21,59,19
12148,1103,854,132,345,290,87,309,452,53,40,249,11,81,50,107,218,31
12149,776,520,115,207,140,58,180,237,67,36,256,34,105,83,34,212,44
12150,360,274,47,138,72,17,81,138,28,27,86,12,41,27,6,74,12
12151,284,178,13,130,25,10,79,52,29,18,106,11,43,34,18,89,17
12153,341,262,22,191,47,2,117,140,3,2,79,21,33,25,0,58,21
12154,969,740,128,397,140,75,361,282,49,48,229,38,81,59,51,175,54
12155,703,486,68,253,140,25,165,227,54,40,217,38,55,80,44,159,58
12156,321,245,35,127,52,31,89,140,8,8,76,10,44,0,22,57,19
12157,1476,1092,165,572,261,94,438,480,91,83,384,54,93,143,94,323,61
12158,2125,1554,323,760,393,78,568,623,220,143,571,97,234,144,96,446,125
12159,3124,2088,270,1177,430,211,1021,805,167,95,1036,212,274,276,274,909,127
12160,425,312,45,172,74,21,102,158,20,32,113,20,46,29,18,93,20
12164,217,128,7,56,48,17,43,71,6,8,89,11,36,18,24,81,8
12165,97,70,8,25,35,2,19,49,2,0,27,4,6,10,7,27,0
12166,552,428,57,229,124,18,130,223,45,30,124,20,54,27,23,83,41
12167,984,645,76,309,201,59,205,308,87,45,339,50,92,132,65,269,70
12168,837,597,115,299,154,29,204,270,83,40,240,37,95,82,26,188,52
12169,72,48,12,32,4,0,22,13,8,5,24,9,6,0,9,19,5
12170,1871,1493,253,837,332,71,531,663,177,122,378,71,147,93,67,316,62
12173,910,691,125,362,156,48,258,299,82,52,219,60,73,42,44,181,38
12175,307,219,30,113,66,10,62,111,23,23,88,12,28,33,15,69,19
12176,61,39,6,13,20,0,19,10,0,10,22,0,15,0,7,22,0
12180,20863,12100,2825,5511,2836,928,3582,4688,2403,1427,8763,2942,2485,1849,1487,6932,1831
12182,5838,3630,758,1601,922,349,977,1554,718,381,2208,408,683,717,400,1918,290
12183,1072,575,142,236,144,53,139,237,112,87,497,118,173,118,88,413,84
12184,2726,1976,265,1112,514,85,783,894,181,118,750,139,240,207,164,602,148
12185,753,595,119,322,125,29,186,252,117,40,158,16,64,26,52,125,33
12186,2511,1984,192,1146,556,90,758,923,207,96,527,72,207,178,70,450,77
12187,267,203,50,94,44,15,62,101,40,0,64,12,14,19,19,51,13
12188,4252,2880,527,1490,658,205,1001,1321,351,207,1372,287,495,312,278,1051,321
12189,7640,3979,934,1887,796,362,1149,1367,896,567,3661,940,1065,991,665,3068,593
12190,328,200,21,99,65,15,51,108,27,14,128,14,26,45,43,107,21
12192,839,601,50,347,189,15,169,319,54,59,238,34,108,58,38,177,61
12193,843,608,111,292,163,42,215,307,45,41,235,31,85,90,29,203,32
12194,89,67,12,27,22,6,18,42,7,0,22,0,12,3,7,10,12
12196,1078,747,92,408,237,10,261,343,107,36,331,20,120,158,33,272,59
12197,986,658,98,289,217,54,233,285,68,72,328,34,84,134,76,284,44
12198,2757,1939,277,1034,507,121,760,886,157,136,818,206,218,192,202,675,143
12202,4634,2190,814,989,259,128,311,443,1108,328,2444,879,934,443,188,2019,425
12203,12275,5816,1106,2668,1462,580,1727,2644,721,724,6459,2461,1914,1133,951,4724,1735
12204,3164,1634,416,695,352,171,547,644,238,205,1530,401,476,440,213,1301,229
12205,10976,7212,1157,3302,1996,757,2234,3357,799,822,3764,521,1207,1221,815,3226,538
12206,6947,3497,1065,1710,491,231,670,901,1290,636,3450,841,1237,809,563,2823,627
12207,1198,326,149,99,62,16,21,70,195,40,872,113,387,209,163,850,22
12208,9574,4208,909,1957,901,441,1242,1719,574,673,5366,2016,1498,1019,833,3922,1444
12209,4116,2438,611,1017,577,233,611,819,582,426,1678,490,586,320,282,1301,377
12210,4841,1736,671,727,287,51,203,435,808,290,3105,1378,1119,386,222,2400,705
12211,3944,3029,323,1416,1013,277,1034,1591,187,217,915,60,258,373,224,757,158
12302,10684,7469,995,3718,2064,692,2635,3782,629,423,3215,409,847,1090,869,2834,381
12303,11321,7604,1266,3774,1872,692,2509,3239,1176,680,3717,667,1128,1004,918,3091,626
12304,8354,5295,1332,2411,1067,485,1550,1873,1161,711,3059,481,1121,766,691,2596,463
12305,2542,548,117,263,126,42,100,278,106,64,1994,641,713,417,223,1690,304
12306,10234,6801,1159,3139,1823,680,2210,3038,731,822,3433,607,1073,942,811,2894,539
12307,2619,1483,578,615,269,21,292,282,680,229,1136,178,479,320,159,943,193
12308,5785,3256,909,1360,703,284,953,1113,816,374,2529,778,774,499,478,1975,554
12309,11375,8144,993,4387,2109,655,3270,3766,550,558,3231,354,964,1028,885,2882,349
12401,14981,8850,1580,4083,2450,737,2554,3595,1546,1155,6131,1082,2162,1740,1147,5159,972
12404,1458,1107,204,603,201,99,474,401,116,116,351,59,150,115,27,272,79
12405,204,126,53,66,7,0,73,26,27,0,78,0,33,26,19,69,9
12406,445,245,42,103,91,9,62,102,32,49,200,24,35,98,43,173,27
12407,182,124,16,63,39,6,36,67,12,9,58,6,10,25,17,48,10
12409,284,152,19,76,57,0,44,100,8,0,132,6,47,55,24,104,28
12410,407,263,26,98,118,21,65,146,37,15,144,17,43,61,23,127,17
12411,149,114,26,50,28,10,24,68,15,7,35,6,0,14,15,27,8
12412,379,276,50,149,72,5,109,111,48,8,103,6,61,36,0,88,15
12413,1134,680,123,300,195,62,190,303,132,55,454,58,146,162,88,377,77
12414,4638,3122,494,1481,925,222,912,1393,497,320,1516,261,521,416,318,1266,250
12416,29,19,0,14,5,0,0,11,8,0,10,5,0,5,0,10,0
12418,213,155,15,50,74,16,42,97,4,12,58,0,25,16,17,51,7
12419,119,74,15,50,9,0,8,49,10,7,45,14,15,16,0,38,7
12420,160,115,6,55,47,7,44,57,9,5,45,10,15,20,0,30,15
12421,369,214,10,82,89,33,59,119,19,17,155,19,37,83,16,121,34
12422,123,105,24,43,34,4,32,40,22,11,18,5,8,5,0,9,9
12423,455,293,54,111,114,14,88,150,28,27,162,20,52,42,48,139,23
12424,135,96,10,42,29,15,26,62,3,5,39,0,15,17,7,32,7
12427,184,102,37,34,26,5,22,64,8,8,82,16,33,21,12,62,20
12428,2535,1719,342,833,415,129,501,632,356,230,816,106,224,305,181,650,166
12429,7,7,0,7,0,0,0,7,0,0,0,0,0,0,0,0,0
12430,462,326,58,121,118,29,77,194,43,12,136,22,12,58,44,100,36
12431,518,403,67,226,68,42,156,194,39,14,115,10,31,49,25,91,24
12433,167,110,16,43,46,5,26,70,0,14,57,11,19,15,12,36,21
12434,280,185,12,111,52,10,47,103,28,7,95,23,19,26,27,89,6
12435,110,77,30,19,28,0,32,32,13,0,33,7,7,0,19,26,7
12439,50,25,6,11,3,5,9,8,4,4,25,5,16,4,0,19,6
12440,806,402,32,196,158,16,138,187,41,36,404,68,118,123,95,328,76
12442,246,120,15,54,45,6,47,56,11,6,126,20,44,44,18,111,15
12443,1555,1130,118,629,282,101,394,554,110,72,425,19,160,161,85,351,74
12444,183,130,28,50,45,7,43,69,10,8,53,2,25,11,15,46,7
12446,1963,1305,214,707,290,94,514,476,163,152,658,118,236,229,75,541,117
12448,108,62,0,44,18,0,21,36,5,0,46,9,21,9,7,40,6
12449,1197,833,137,474,190,32,316,316,107,94,364,22,151,125,66,314,50
12450,199,125,17,55,40,13,28,60,15,22,74,10,24,33,7,71,3
12451,617,414,91,172,108,43,132,201,56,25,203,27,90,38,48,151,52
12454,249,169,24,70,68,7,57,86,17,9,80,15,23,32,10,60,20
12455,855,546,74,233,161,78,153,297,57,39,309,38,124,88,59,268,41
12456,252,185,28,89,45,23,58,91,21,15,67,5,25,29,8,45,22
12457,493,285,37,175,63,10,111,111,45,18,208,17,117,67,7,171,37
12458,941,629,150,278,156,45,219,274,67,69,312,40,77,132,63,260,52
12459,81,56,0,27,14,15,8,48,0,0,25,0,17,8,0,25,0
12460,143,102,14,59,22,7,29,35,20,18,41,3,21,13,4,34,7
12461,788,514,63,285,150,16,167,284,30,33,274,41,133,44,56,207,67
12463,552,344,67,191,72,14,158,147,27,12,208,43,61,85,19,169,39
12464,496,295,17,212,37,29,117,109,39,30,201,28,40,92,41,145,56
12466,1180,808,168,439,175,26,295,345,106,62,372,44,133,94,101,331,41
12468,549,372,65,156,120,31,119,176,41,36,177,18,66,45,48,146,31
12469,348,222,23,96,97,6,59,122,28,13,126,4,49,49,24,110,16
12470,312,236,28,101,78,29,16,132,47,41,76,9,24,34,9,58,18
12471,76,32,8,0,18,6,5,27,0,0,44,0,10,0,34,44,0
12472,766,382,106,185,75,16,117,151,63,51,384,110,112,103,59,300,84
12473,289,154,11,84,48,11,44,71,31,8,135,11,39,66,19,99,36
12474,403,291,28,138,97,28,112,147,21,11,112,25,16,47,24,98,14
12477,7572,5165,819,2619,1403,324,1832,2238,699,396,2407,381,853,732,441,1932,475
12480,357,221,28,106,53,34,73,107,13,28,136,5,39,46,46,102,34
12481,509,330,25,190,97,18,125,149,41,15,179,7,66,81,25,143,36
12482,186,109,20,54,28,7,47,49,6,7,77,0,8,34,35,71,6
12484,1069,750,67,430,208,45,280,378,55,37,319,50,115,102,52,235,84
12485,491,306,43,121,121,21,76,149,46,35,185,45,46,57,37,154,31
12486,591,435,59,208,141,27,167,221,47,0,156,46,61,15,34,91,65
12487,1436,893,201,501,135,56,345,370,98,80,543,180,189,111,63,379,164
12489,98,69,0,41,22,6,12,34,17,6,29,11,0,13,5,5,24
12491,674,445,46,195,178,26,159,227,32,27,229,18,66,98,47,202,27
12492,140,73,6,39,24,4,23,39,6,5,67,2,25,19,21,55,12
12493,200,101,10,72,11,8,48,31,0,22,99,37,36,0,26,90,9
12494,270,207,33,99,54,21,47,125,35,0,63,0,12,35,16,57,6
12495,74,46,6,25,11,4,8,34,0,4,28,0,13,15,0,16,12
12496,463,283,19,129,117,18,83,145,29,26,180,15,38,78,49,162,18
12498,2400,1377,102,611,553,111,383,695,175,124,1023,98,381,401,143,809,214
12501,976,667,119,280,213,55,248,303,34,82,309,58,106,103,42,214,95
12502,490,347,38,148,131,30,100,198,29,20,143,16,49,54,24,107,36
12503,301,214,13,105,71,25,67,112,13,22,87,18,20,28,21,58,29
12507,22,11,0,11,0,0,11,0,0,0,11,11,0,0,0,11,0
12508,6536,4243,1003,2132,772,336,1430,1587,736,490,2293,401,931,590,371,1938,355
12513,410,233,46,85,73,29,98,107,18,10,177,26,25,73,53,128,49
12514,1052,771,101,464,145,61,351,377,31,12,281,36,117,90,38,229,52
12515,386,296,46,149,74,27,140,86,31,39,90,8,47,28,7,57,33
12516,690,480,60,209,161,50,153,253,33,41,210,31,44,78,57,155,55
12517,120,62,19,35,8,0,24,17,9,12,58,6,23,11,18,58,0
12518,2458,1711,230,924,401,156,697,757,157,100,747,123,167,286,171,655,92
12520,1129,805,81,459,206,59,332,346,74,53,324,89,97,61,77,281,43
12521,637,414,29,220,137,28,143,199,46,26,223,14,64,100,45,184,39
12522,2198,1524,293,776,322,133,593,531,226,174,674,89,213,225,147,575,99
12523,806,552,87,247,177,41,196,251,47,58,254,29,91,99,35,186,68
12524,5206,3353,528,1619,990,216,1252,1674,228,199,1853,305,592,535,421,1625,228
12525,1074,771,138,398,198,37,306,312,91,62,303,91,116,70,26,208,95
12526,1435,969,137,470,268,94,333,451,118,67,466,67,140,163,96,385,81
12528,4772,3191,598,1639,774,180,1225,1302,393,271,1581,418,598,345,220,1265,316
12529,1002,681,61,320,216,84,196,357,67,61,321,34,104,117,66,267,54
12531,976,715,103,456,116,40,358,244,42,71,261,12,143,80,26,226,35
12533,7168,5949,804,3540,1398,207,2940,2286,300,423,1219,229,496,346,148,965,254
12534,7475,4732,842,2227,1214,449,1319,2089,799,525,2743,390,784,883,686,2337,406
12538,4846,3308,424,1755,868,261,1301,1403,327,277,1538,338,434,445,321,1261,277
12540,2286,1849,162,1164,432,91,879,732,92,146,437,67,141,187,42,356,81
12542,2154,1578,222,927,363,66,636,642,179,121,576,125,117,154,180,467,109
12543,1063,790,187,463,93,47,380,233,110,67,273,65,79,79,50,209,64
12545,1857,1206,169,596,349,92,431,616,71,88,651,126,215,200,110,551,100
12546,1172,783,102,381,248,52,254,373,85,71,389,69,130,112,78,326,63
12547,835,542,47,350,106,39,215,235,39,53,293,22,125,72,74,228,65
12548,566,456,51,278,89,38,185,169,69,33,110,20,51,17,22,85,25
12549,2959,2309,395,1262,530,122,1030,861,218,200,650,131,247,174,98,504,146
12550,17617,12637,2813,6291,2910,623,4287,4368,2585,1397,4980,860,1730,1450,940,4011,969
12553,8416,6088,972,3161,1498,457,2415,2395,617,661,2328,456,875,560,437,1949,379
12561,6110,3551,487,1956,903,205,1315,1458,477,301,2559,1099,547,576,337,1750,809
12563,2183,1712,259,950,445,58,831,710,89,82,471,63,195,157,56,366,105
12564,2513,1794,237,950,488,119,730,810,147,107,719,127,219,235,138,589,130
12565,711,459,97,221,119,22,170,170,80,39,252,49,71,77,55,191,61
12566,3525,2675,365,1569,612,129,1240,1043,198,194,850,190,256,226,178,683,167
12567,1163,816,68,439,233,76,308,350,74,84,347,99,99,109,40,267,80
12569,3389,2426,355,1314,640,117,936,1015,230,245,963,163,340,316,144,790,173
12570,1939,1645,277,946,360,62,811,717,81,36,294,9,153,91,41,231,63
12571,3231,2336,247,1353,599,137,1017,923,225,171,895,219,225,314,137,703,192
12572,3789,2324,254,1222,673,175,831,1056,224,213,1465,201,519,390,355,1247,218
12575,701,564,91,341,107,25,307,207,28,22,137,36,38,37,26,103,34
12577,534,466,61,298,99,8,249,176,28,13,68,13,12,21,22,45,23
12578,804,654,64,423,142,25,262,314,52,26,150,51,40,26,33,116,34
12580,1473,1140,157,648,289,46,444,520,103,73,333,25,116,126,66,271,62
12581,888,606,87,255,222,42,211,296,52,47,282,69,89,102,22,219,63
12582,1404,1273,148,817,265,43,737,455,27,54,131,20,61,42,8,112,19
12583,953,600,87,344,124,45,209,256,92,43,353,113,115,105,20,248,105
12585,276,190,16,100,67,7,105,58,10,17,86,29,27,7,23,66,20
12586,4042,2999,498,1655,722,124,1124,1157,452,266,1043,191,354,279,219,866,177
12589,4135,3108,582,1746,701,79,1448,1139,306,215,1027,235,328,275,189,805,222
12590,12407,9120,1519,4740,2459,402,3610,4087,769,654,3287,795,1139,835,518,2695,592
12592,411,268,34,150,66,18,81,99,40,48,143,20,34,52,37,131,12
12594,1225,880,182,497,162,39,495,226,63,96,345,37,130,149,29,287,58
12601,15286,9022,2385,4190,1952,495,2752,2992,2134,1144,6264,1605,1950,1629,1080,4896,1368
12603,14990,10823,1444,5672,2892,815,4316,4643,971,893,4167,818,1317,1238,794,3493,674
12701,4492,2817,561,1278,751,227,661,1198,669,289,1675,248,591,561,275,1398,277
12719,368,270,29,147,73,21,74,139,29,28,98,12,32,30,24,92,6
12720,80,50,0,29,21,0,9,21,20,0,30,0,12,18,0,22,8
12721,1963,1448,253,805,355,35,656,533,138,121,515,87,223,138,67,412,103
12723,774,610,79,263,223,45,169,326,69,46,164,34,49,50,31,126,38
12724,134,93,4,37,45,7,17,61,11,4,41,3,10,14,14,32,9
12725,105,61,5,36,18,2,24,30,5,2,44,0,20,20,4,40,4
12726,490,313,38,150,104,21,109,153,30,21,177,26,71,58,22,150,27
12727,6,4,0,2,2,0,0,4,0,0,2,0,0,0,2,2,0
12729,497,353,89,173,58,33,147,142,35,29,144,15,60,46,23,142,2
12732,379,265,15,128,88,34,80,137,33,15,114,12,30,46,26,114,0
12733,242,162,46,63,27,26,59,70,12,21,80,16,24,25,15,69,11
12734,267,138,19,56,54,9,39,71,28,0,129,27,59,30,13,119,10
12736,69,36,7,21,6,2,15,10,5,6,33,11,10,10,2,28,5
12737,589,420,68,198,106,48,179,173,38,30,169,4,44,74,47,150,19
12738,120,72,5,45,22,0,28,29,15,0,48,0,23,21,4,39,9
12739,247,142,15,63,47,17,47,74,21,0,105,10,40,53,2,84,21
12740,836,621,87,268,230,36,236,350,20,15,215,38,57,82,38,180,35
12741,110,77,10,38,19,10,28,39,8,2,33,3,9,12,9,30,3
12742,58,35,21,0,8,6,9,20,6,0,23,0,10,13,0,23,0
12743,129,86,17,24,38,7,26,44,16,0,43,5,8,8,22,39,4
12746,486,349,75,186,78,10,195,74,63,17,137,13,36,59,29,88,49
12747,536,357,103,148,76,30,126,128,92,11,179,13,50,73,43,144,35
12748,721,481,94,227,126,34,193,212,53,23,240,41,59,63,77,193,47
12749,122,47,16,22,0,9,19,6,9,13,75,18,30,14,13,49,26
12751,173,100,14,47,21,18,20,49,22,9,73,6,31,28,8,73,0
12752,59,45,7,17,15,6,15,24,4,2,14,2,0,6,6,14,0
12754,2853,1784,418,801,448,117,597,626,399,162,1069,101,277,360,331,915,154
12758,1680,1134,183,552,338,61,273,579,160,122,546,41,144,242,119,485,61
12759,611,460,93,240,64,63,134,161,130,35,151,54,32,30,35,122,29
12760,314,194,25,83,67,19,68,97,12,17,120,13,33,44,30,100,20
12762,133,89,19,49,21,0,6,48,26,9,44,10,16,6,12,34,10
12763,306,215,20,133,62,0,54,112,20,29,91,22,32,22,15,65,26
12764,696,458,62,198,149,49,141,214,47,56,238,12,48,97,81,211,27
12765,295,224,48,87,63,26,79,81,25,39,71,19,42,0,10,52,19
12766,176,118,16,58,26,18,32,62,19,5,58,13,19,18,8,44,14
12768,275,211,4,118,75,14,82,90,13,26,64,0,40,6,18,53,11
12770,110,63,5,40,17,1,15,33,10,5,47,3,12,23,9,42,5
12771,5171,3435,771,1666,747,251,1143,1353,648,291,1736,268,561,508,399,1396,340
12775,683,442,83,169,139,51,129,242,27,44,241,46,69,97,29,191,50
12776,971,644,72,287,219,66,249,292,36,67,327,39,93,117,78,271,56
12777,298,225,37,106,76,6,97,107,7,14,73,8,36,21,8,65,8
12778,318,185,0,99,62,24,63,81,30,11,133,11,67,43,12,133,0
12779,607,369,83,215,47,24,179,79,83,28,238,34,74,88,42,198,40
12780,819,599,107,281,179,32,188,285,77,49,220,47,63,72,38,160,60
12783,727,507,36,229,187,55,135,253,51,68,220,5,70,94,51,179,41
12784,13,13,0,7,6,0,0,6,7,0,0,0,0,0,0,0,0
12785,79,59,5,30,17,7,18,29,5,7,20,0,20,0,0,0,20
12786,272,152,10,65,60,17,27,91,6,28,120,0,50,22,48,88,32
12787,115,67,16,26,20,5,21,21,21,4,48,0,21,27,0,41,7
12788,770,475,86,243,129,17,170,176,95,34,295,41,87,116,51,227,68
12789,693,431,61,236,112,22,149,163,77,42,262,27,94,112,29,227,35
12790,2219,1536,268,718,458,92,568,741,123,104,683,83,216,252,132,590,93
12791,204,119,11,72,31,5,46,60,13,0,85,15,33,18,19,66,19
12792,119,78,4,46,28,0,34,39,0,5,41,8,20,5,8,29,12
12801,6360,3444,923,1609,687,225,1093,1147,814,390,2916,774,990,681,471,2388,528
12803,3046,1988,351,960,518,159,707,880,238,163,1058,192,258,328,280,870,188
12804,9304,6898,1079,3598,1749,472,2701,2972,689,536,2406,393,674,829,510,2014,392
12808,140,90,7,26,47,10,9,75,6,0,50,2,16,27,5,44,6
12809,1303,990,194,509,232,55,368,406,127,89,313,55,109,81,68,238,75
12810,253,203,20,109,60,14,58,110,23,12,50,1,22,24,3,40,10
12812,67,37,8,21,6,2,15,22,0,0,30,2,12,9,7,27,3
12814,687,445,25,212,169,39,110,238,59,38,242,44,77,76,45,206,36
12815,399,287,25,128,101,33,84,148,42,13,112,3,49,35,25,94,18
12816,1841,1243,249,571,346,77,420,556,167,100,598,94,212,175,117,514,84
12817,959,617,68,259,253,37,130,381,76,30,342,52,118,97,75,266,76
12819,147,107,21,55,24,7,31,48,20,8,40,0,11,16,13,35,5
12821,172,144,28,76,40,0,54,74,13,3,28,0,12,12,4,24,4
12822,2252,1641,331,702,477,131,473,802,237,129,611,76,173,182,180,519,92
12823,65,53,0,33,15,5,7,38,8,0,12,0,0,6,6,6,6
12824,330,246,23,108,101,14,65,140,18,23,84,12,24,38,10,68,16
12827,1428,1105,182,570,284,69,446,462,102,95,323,37,106,105,75,257,66
12828,3145,2273,479,1075,567,152,866,971,308,128,872,157,281,273,161,715,157
12831,4721,3709,697,2045,834,133,1785,1445,319,160,1012,222,462,296,32,732,280
12832,2728,1847,395,830,534,88,633,871,229,114,881,129,248,328,176,697,184
12833,1671,1243,214,657,306,66,475,524,151,93,428,53,147,159,69,285,143
12834,2618,1895,330,929,480,156,699,840,207,149,723,91,198,265,169,570,153
12835,1133,826,130,371,263,62,257,412,98,59,307,31,95,102,79,261,46
12836,303,209,23,79,90,17,54,134,9,12,94,9,19,31,35,90,4
12837,320,252,20,143,70,19,95,134,14,9,68,12,37,8,11,52,16
12838,221,164,39,76,27,22,61,83,15,5,57,21,14,10,12,42,15
12839,4782,3234,763,1421,849,201,980,1376,513,365,1548,243,534,474,297,1305,243
12841,42,24,0,2,19,3,0,22,0,2,18,2,8,4,4,16,2
12842,589,392,52,165,133,42,114,226,29,23,197,14,56,61,66,177,20
12843,257,199,40,91,54,14,75,84,27,13,58,17,5,30,6,45,13
12844,129,88,0,40,35,13,33,49,0,6,41,6,8,6,21,39,2
12845,2023,1254,125,647,359,123,386,690,84,94,769,186,222,219,142,546,223
12846,1238,867,154,409,261,43,295,412,103,57,371,50,119,128,74,288,83
12847,320,205,18,82,95,10,55,126,10,14,115,24,25,34,32,91,24
12849,180,116,37,66,13,0,50,43,23,0,64,0,11,41,12,48,16
12850,845,574,89,319,140,26,233,252,62,27,271,68,102,60,41,172,99
12851,149,103,18,31,47,7,17,63,11,12,46,5,13,17,11,37,9
12852,221,139,10,51,60,18,34,88,7,10,82,2,18,42,20,75,7
12853,852,570,96,256,174,44,194,278,52,46,282,49,73,95,65,229,53
12855,111,72,9,42,16,5,25,38,7,2,39,10,12,9,8,32,7
12856,93,60,0,41,15,4,26,34,0,0,33,0,13,16,4,28,5
12857,181,137,25,66,31,15,56,58,14,9,44,4,20,8,12,34,10
12858,25,19,3,9,7,0,3,14,2,0,6,0,3,0,3,6,0
12859,663,548,128,315,88,17,261,190,72,25,115,7,51,31,26,92,23
12860,242,191,34,78,62,17,67,94,16,14,51,6,14,17,14,41,10
12861,250,192,23,98,61,10,71,95,7,19,58,12,13,18,15,45,13
12863,208,153,23,79,45,6,37,104,5,7,55,15,13,6,21,34,21
12865,1226,872,132,447,238,55,293,397,116,66,354,61,88,126,79,300,54
12866,13992,8369,1667,4193,1964,545,2882,3782,1104,601,5623,1741,1694,1222,966,4453,1170
12870,696,445,65,196,143,41,156,233,26,30,251,50,52,77,72,205,46
12871,1573,1050,184,484,294,88,326,484,133,107,523,97,170,134,122,411,112
12873,342,234,19,123,69,23,61,110,37,26,108,9,37,37,25,77,31
12874,79,54,6,7,33,8,9,37,2,6,25,0,2,16,7,22,3
12878,271,173,33,70,57,13,66,76,13,18,98,13,34,33,18,80,18
12883,2017,1360,247,586,399,128,428,595,205,132,657,108,211,203,135,575,82
12885,1847,1295,273,627,325,70,446,535,221,93,552,102,196,145,109,477,75
12886,37,18,0,18,0,0,3,6,4,5,19,6,6,4,3,19,0
12887,1846,1278,279,591,320,88,433,610,155,80,568,97,163,195,113,487,81
12901,12772,7277,1479,3532,1893,373,2442,3112,1162,561,5495,1917,1430,1246,902,4153,1342
12903,21,11,0,0,11,0,0,11,0,0,10,0,10,0,0,10,0
12910,597,433,103,200,103,27,177,191,40,25,164,32,50,57,25,124,40
12911,21,21,6,0,15,0,15,0,6,0,0,0,0,0,0,0,0
12912,840,618,95,295,196,32,211,280,67,60,222,18,73,77,54,193,29
12913,505,329,49,213,49,18,142,133,35,19,176,19,52,60,45,139,37
12914,471,342,82,126,117,17,96,157,52,37,129,17,33,54,25,116,13
12916,736,503,82,246,147,28,198,210,58,37,233,25,73,69,66,204,29
12917,468,352,66,167,95,24,124,166,38,24,116,28,35,36,17,88,28
12918,1025,749,83,401,213,52,304,376,41,28,276,40,126,63,47,212,64
12919,1197,803,149,375,228,51,253,374,118,58,394,64,139,105,86,318,76
12920,917,618,118,301,153,46,198,284,87,49,299,45,105,93,56,240,59
12921,892,647,105,310,202,30,254,287,44,62,245,56,77,70,42,188,57
12922,34,23,3,4,11,5,0,16,5,2,11,2,3,6,0,9,2
12923,251,183,29,84,57,13,52,93,17,21,68,16,20,19,13,52,16
12926,750,556,91,296,135,34,184,259,64,49,194,34,71,59,30,154,40
12927,105,75,1,29,29,16,18,51,0,6,30,3,5,13,9,25,5
12928,793,576,104,275,154,43,201,260,76,39,217,42,70,64,41,167,50
12930,221,169,26,82,55,6,41,72,30,26,52,6,21,13,12,47,5
12932,538,339,34,191,92,22,135,152,35,17,199,5,75,70,49,166,33
12934,439,302,62,151,76,13,124,129,19,30,137,21,34,43,39,104,33
12935,891,662,141,335,146,40,225,292,106,39,229,48,80,58,43,197,32
12936,206,142,21,46,55,20,29,81,12,20,64,5,26,13,20,52,12
12937,589,435,67,208,132,28,137,205,55,38,154,21,36,67,30,137,17
12941,556,403,93,177,105,28,153,192,34,24,153,28,45,58,22,123,30
12942,269,182,38,87,43,14,78,84,14,6,87,12,27,29,19,71,16
12943,172,96,0,51,25,20,30,55,7,4,76,17,18,27,14,67,9
12944,1722,1230,212,631,320,67,400,564,167,99,492,69,144,190,89,381,111
12945,288,184,40,94,50,0,77,97,0,10,104,18,28,23,35,70,34
12946,2676,1574,254,762,457,101,550,731,182,111,1102,312,351,213,226,934,168
12950,277,197,31,102,56,8,60,79,33,25,80,23,27,21,9,59,21
12952,267,178,21,79,63,15,36,101,21,20,89,9,9,20,51,85,4
12953,4631,3051,587,1441,799,224,1056,1289,401,305,1580,263,416,468,433,1364,216
12955,172,109,16,41,41,11,38,53,10,8,63,4,19,33,7,59,4
12956,728,466,70,240,115,41,153,216,49,48,262,46,46,75,95,211,51
12957,729,513,120,236,126,31,153,216,84,60,216,37,97,45,37,153,63
12958,633,497,146,232,76,43,175,204,91,27,136,7,48,59,22,123,13
12959,569,420,70,226,106,18,137,191,50,42,149,19,27,70,33,112,37
12960,424,328,78,123,108,19,111,144,55,18,96,3,37,40,16,82,14
12961,55,45,14,21,10,0,15,17,10,3,10,0,1,2,7,10,0
12962,2207,1668,289,955,310,114,692,668,207,101,539,128,195,157,59,383,156
12964,60,46,11,16,19,0,12,29,5,0,14,3,4,4,3,11,3
12965,169,127,21,68,32,6,44,53,14,16,42,9,10,11,12,36,6
12966,1022,785,179,377,169,60,298,342,101,44,237,30,78,90,39,193,44
12967,407,304,58,140,92,14,107,137,31,29,103,25,23,44,11,70,33
12969,217,155,26,70,51,8,45,70,21,19,62,5,28,18,11,46,16
12970,243,157,22,87,45,3,75,74,2,6,86,6,52,22,6,65,21
12972,2074,1571,299,820,386,66,551,715,239,66,503,29,191,190,93,376,127
12974,650,398,78,151,113,56,110,170,52,66,252,32,66,93,61,217,35
12979,1050,651,141,301,170,39,230,292,88,41,399,94,114,122,69,346,53
12980,542,351,57,172,91,31,104,142,65,40,191,34,56,50,51,139,52
12981,1072,758,136,399,185,38,327,318,78,35,314,55,106,115,38,230,84
12983,3249,1788,271,999,368,150,656,729,271,132,1461,424,459,335,243,1211,250
12985,428,290,50,191,47,2,135,86,51,18,138,43,55,31,9,89,49
12986,2569,1620,364,707,428,121,509,627,304,180,949,186,272,274,217,790,159
12987,121,74,8,40,20,6,27,38,7,2,47,6,6,27,8,35,12
12989,331,231,22,142,52,15,97,97,26,11,100,16,23,43,18,83,17
12992,1676,1261,277,674,274,36,446,592,205,18,415,50,142,137,86,306,109
12993,718,478,51,209,170,48,169,221,41,47,240,31,71,94,44,209,31
12996,925,626,86,259,215,66,155,344,86,41,299,39,62,92,106,231,68
13021,16354,10367,1961,4992,2388,1026,3342,4391,1602,1032,5987,1095,1703,1597,1592,5113,874
13026,619,439,64,213,127,35,181,206,29,23,180,25,59,43,53,152,28
13027,11537,8120,1167,4572,1991,390,3299,3482,828,511,3417,685,1041,1132,559,2913,504
13028,470,352,35,219,91,7,148,138,38,28,118,21,56,41,0,86,32
13029,2107,1637,302,991,278,66,710,588,267,72,470,116,145,140,69,403,67
13030,1587,1112,145,597,349,21,327,550,152,83,475,120,187,108,60,345,130
13031,6069,4312,546,2036,1231,499,1573,2136,306,297,1757,333,484,499,441,1544,213
13032,4870,3429,571,1720,929,209,1217,1533,392,287,1441,213,456,417,355,1163,278
13033,1564,1210,216,680,264,50,475,533,127,75,354,55,109,127,63,294,60
13034,744,542,69,259,165,49,190,270,55,27,202,12,69,70,51,177,25
13035,2925,2054,150,1160,596,148,808,965,175,106,871,196,224,239,212,704,167
13036,3394,2323,508,1147,558,110,828,1027,324,144,1071,219,334,303,215,830,241
13037,3249,2399,478,1243,537,141,941,987,325,146,850,163,254,265,168,688,162
13039,5286,3968,713,2278,822,155,1770,1616,406,176,1318,229,499,383,207,999,319
13040,1048,772,136,398,211,27,282,361,81,48,276,38,90,106,42,205,71
13041,3350,2702,577,1529,527,69,1157,1065,264,216,648,180,258,146,64,476,172
13042,850,620,141,263,162,54,231,314,37,38,230,31,58,106,35,184,46
13044,1046,800,172,399,203,26,349,334,65,52,246,24,154,26,42,173,73
13045,11048,6356,1407,2955,1514,480,2023,2725,1019,589,4692,1636,1285,957,814,3410,1282
13052,626,422,72,204,109,37,124,201,66,31,204,26,65,69,44,172,32
13053,1702,1104,211,611,243,39,444,490,96,74,598,186,209,111,92,451,147
13054,785,575,87,266,195,27,216,238,65,56,210,32,34,68,76,156,54
13057,6258,3956,578,1836,1179,363,1192,1853,532,379,2302,375,766,649,512,1989,313
13060,1100,763,127,372,218,46,276,315,84,88,337,66,114,96,61,273,64
13061,341,234,29,134,57,14,103,105,10,16,107,16,49,28,14,74,33
13062,56,49,21,15,7,6,11,16,16,6,7,7,0,0,0,7,0
13063,706,559,72,345,100,42,288,224,30,17,147,25,56,45,21,114,33
13066,4982,3450,360,1708,1060,322,1375,1594,294,187,1532,241,458,477,356,1335,197
13068,1863,1270,208,713,294,55,472,535,170,93,593,200,198,140,55,430,163
13069,10154,6946,1488,3426,1531,501,2536,2743,1210,457,3208,620,1090,835,663,2548,660
13071,384,279,50,144,64,21,94,122,46,17,105,29,29,27,20,78,27
13072,294,245,34,131,60,20,87,125,23,10,49,7,14,15,13,45,4
13073,2201,1608,275,902,367,64,571,739,221,77,593,105,186,178,124,487,106
13074,1616,1178,269,609,261,39,435,475,173,95,438,88,164,85,101,319,119
13076,762,606,123,333,140,10,262,261,48,35,156,22,88,32,14,112,44
13077,2599,1896,268,1057,424,147,657,826,266,147,703,142,205,213,143,552,151
13078,3042,2141,220,1162,669,90,918,996,158,69,901,51,307,213,330,774,127
13080,1366,969,157,544,222,46,360,394,128,87,397,36,111,144,106,346,51
13081,452,331,44,163,102,22,114,164,35,18,121,5,57,22,37,102,19
13082,1985,1422,204,728,415,75,512,643,172,95,563,81,201,227,54,431,132
13083,700,467,97,228,123,19,188,188,61,30,233,56,70,59,48,178,55
13084,1561,1190,153,636,330,71,433,556,138,63,371,94,88,101,88,282,89
13088,9619,5854,1192,2543,1660,459,1780,2823,708,543,3765,1096,1091,885,693,3062,703
13090,11581,8342,1704,4758,1626,254,3580,3165,1129,468,3239,1051,1253,676,259,2482,757
13092,908,709,124,370,183,32,246,321,104,38,199,61,56,56,26,130,69
13101,835,653,124,283,206,40,203,304,86,60,182,43,52,34,53,139,43
13104,5496,4171,491,2444,978,258,1941,1685,319,226,1325,212,346,438,329,1222,103
13108,2245,1705,205,884,495,121,661,742,178,124,540,99,194,136,111,475,65
13110,911,663,56,365,222,20,227,341,45,50,248,26,136,65,21,199,49
13111,600,485,125,253,87,20,236,172,57,20,115,17,18,38,42,96,19
13112,695,550,102,308,98,42,251,235,40,24,145,9,56,57,23,115,30
13114,2383,1697,348,953,333,63,729,630,259,79,686,155,199,211,121,529,157
13116,1260,998,164,560,228,46,440,372,77,109,262,24,67,107,64,232,30
13118,1975,1420,260,726,375,59,536,630,187,67,555,98,162,151,144,425,130
13120,885,732,191,385,115,41,375,153,134,70,153,8,53,55,37,127,26
13122,460,349,30,211,91,17,160,144,20,25,111,21,36,42,12,73,38
13124,57,51,8,31,8,4,21,20,4,6,6,0,4,2,0,2,4
13126,13280,8356,1570,4384,1882,520,2924,3443,1385,604,4924,1475,1360,1127,962,3745,1179
13131,1430,1112,239,570,270,33,440,452,131,89,318,49,114,109,46,251,67
13132,1564,1204,222,636,298,48,493,485,128,98,360,70,171,95,24,274,86
13135,2195,1551,376,750,343,82,547,684,206,114,644,76,229,184,155,569,75
13136,209,168,36,65,61,6,54,65,33,16,41,6,18,8,9,35,6
13140,1775,1320,262,635,325,98,421,589,205,105,455,76,131,157,91,346,109
13141,307,222,32,110,67,13,69,107,25,21,85,11,35,30,9,69,16
13142,2587,1822,366,916,413,127,673,784,232,133,765,102,219,278,166,631,134
13143,1123,772,181,402,176,13,270,329,140,33,351,76,130,97,48,287,64
13144,517,392,100,181,104,7,150,179,51,12,125,14,53,39,19,92,33
13145,708,467,92,210,140,25,119,247,70,31,241,30,74,83,54,191,50
13146,866,661,143,334,160,24,223,269,98,71,205,28,55,59,63,161,44
13147,446,329,45,185,66,33,107,152,36,34,117,16,39,38,24,90,27
13148,4365,2872,524,1348,801,199,936,1335,364,237,1493,360,471,342,320,1166,327
13152,3319,2456,209,1325,733,189,1011,1102,175,168,863,91,225,285,262,752,111
13155,242,171,38,71,54,8,60,77,18,16,71,14,18,26,13,51,20
13156,921,643,105,258,234,46,193,329,57,64,278,35,106,89,48,220,58
13158,725,565,111,290,128,36,214,233,66,52,160,32,60,38,30,122,38
13159,2011,1473,206,826,381,60,559,640,176,98,538,114,206,130,88,425,113
13160,713,521,100,244,144,33,192,225,62,42,192,21,53,65,53,154,38
13164,632,457,63,196,150,48,161,221,36,39,175,30,74,32,39,133,42
13165,4169,2891,522,1442,741,186,920,1283,436,252,1278,211,326,409,332,1030,248
13166,2228,1699,306,913,377,103,664,713,231,91,529,114,132,178,105,414,115
13167,1183,921,179,475,229,38,343,431,109,38,262,82,126,45,9,188,74
13202,2408,867,392,359,90,26,107,87,496,177,1541,514,609,316,102,1347,194
13203,7381,3185,891,1305,694,295,713,1030,959,483,4196,1324,1428,856,588,3499,697
13204,8526,4698,1709,1914,761,314,924,1096,1927,751,3828,1026,1311,869,622,3137,691
13205,7930,4705,1137,2193,1048,327,1104,1306,1478,817,3225,430,889,976,930,2873,352
13206,7827,4037,1011,1715,925,386,1115,1578,765,579,3790,904,1427,781,678,3169,621
13207,5595,3848,997,1945,660,246,1236,1130,927,555,1747,386,671,437,253,1375,372
13208,9112,5033,1308,2141,1099,485,1322,1630,1337,744,4079,889,1351,911,928,3383,696
13209,5651,3770,713,1714,924,419,1253,1563,532,422,1881,367,576,528,410,1564,317
13210,9607,3480,1240,1605,426,209,942,1079,1063,396,6127,3934,1079,781,333,3723,2404
13211,2633,1697,287,828,388,194,504,694,288,211,936,189,238,308,201,768,168
13212,8704,5824,1089,2615,1538,582,1842,2629,848,505,2880,545,731,839,765,2379,501
13214,3069,2033,345,908,565,215,616,1004,261,152,1036,181,279,330,246,886,150
13215,5231,3716,455,2023,961,277,1661,1564,230,261,1515,254,445,383,433,1291,224
13219,6291,4482,491,2137,1235,619,1513,2153,359,457,1809,166,448,551,644,1652,157
13224,3774,2415,375,1151,660,229,719,1023,458,215,1359,323,403,389,244,1135,224
13290,0,0,0,0,0,0,0,0,0,0,0,0,0,0,0,0,0
13301,72,43,3,17,16,7,10,21,5,7,29,8,15,6,0,29,0
13302,544,415,84,199,105,27,126,198,53,38,129,20,38,53,18,103,26
13303,442,345,55,180,81,29,128,160,28,29,97,4,45,27,21,88,9
13304,677,462,43,287,102,30,185,197,52,28,215,28,91,69,27,167,48
13308,1976,1373,258,736,326,53,551,601,140,81,603,100,240,192,71,467,136
13309,2235,1564,320,746,383,115,557,657,224,126,671,88,244,175,164,548,123
13310,197,130,11,68,43,8,17,62,34,17,67,10,11,46,0,67,0
13312,283,184,23,77,69,15,40,120,9,15,99,11,34,26,28,82,17
13313,208,151,43,62,40,6,33,61,46,11,57,10,17,23,7,48,9
13314,335,261,55,123,57,26,103,103,29,26,74,7,26,16,25,58,16
13315,539,410,66,188,130,26,160,192,33,25,129,22,39,45,23,96,33
13316,2452,1762,329,863,477,93,671,743,208,140,690,96,262,169,163,583,107
13317,1514,1019,163,488,284,84,333,456,170,60,495,93,135,118,149,406,89
13318,504,424,68,262,76,18,178,157,61,28,80,9,30,37,4,57,23
13319,365,262,48,185,29,0,112,71,60,19,103,25,31,39,8,97,6
13320,826,608,67,332,163,46,207,279,68,54,218,24,101,54,39,181,37
13322,429,292,48,168,56,20,122,96,46,28,137,19,61,39,18,105,32
13323,4112,2729,314,1296,860,259,985,1346,205,193,1383,272,443,378,290,1148,235
13324,775,574,124,275,151,24,196,253,85,40,201,33,75,60,33,148,53
13325,349,254,39,130,65,20,82,118,35,19,95,13,22,41,19,76,19
13326,2321,1502,192,641,475,194,399,791,172,140,819,181,202,249,187,709,110
13327,776,588,114,293,151,30,261,229,41,57,188,23,48,55,62,164,24
13328,488,356,58,184,105,9,143,137,48,28,132,21,50,41,20,115,17
13329,1597,1099,190,553,273,83,389,457,152,101,498,73,122,145,158,424,74
13331,117,81,6,38,27,10,18,54,5,4,36,0,4,23,9,36,0
13332,911,651,100,315,217,19,218,314,84,35,260,49,86,72,53,190,70
13333,65,42,3,22,11,6,16,21,5,0,23,6,0,9,8,12,11
13334,556,430,77,261,68,24,179,157,77,17,126,24,22,43,37,101,25
13335,541,405,88,187,102,28,158,195,39,13,136,14,29,56,37,114,22
13337,325,215,9,151,49,6,105,73,31,6,110,25,43,28,14,77,33
13338,686,451,53,213,157,28,150,251,30,20,235,26,78,89,42,201,34
13339,2609,1840,371,819,484,166,603,816,251,170,769,84,208,274,203,654,115
13340,3079,2185,384,1003,611,187,688,939,322,236,894,146,201,284,263,729,165
13341,28,21,0,21,0,0,8,7,0,6,7,0,0,0,7,7,0
13342,79,58,12,30,6,10,29,17,7,5,21,3,7,4,7,21,0
13343,682,478,83,234,131,30,176,220,52,30,204,31,66,77,30,151,53
13346,1608,996,100,516,260,120,347,455,114,80,612,186,126,155,145,466,146
13348,520,343,49,195,77,22,151,133,31,28,177,22,45,84,26,148,29
13350,4100,2418,484,1019,673,242,713,1111,400,194,1682,330,305,488,559,1342,340
13353,59,48,6,5,32,5,3,42,0,3,11,0,5,3,3,8,3
13354,1128,896,96,512,225,63,369,356,84,87,232,21,71,88,52,188,44
13355,247,183,35,101,47,0,106,49,9,19,64,8,30,26,0,40,24
13357,4583,3127,577,1550,769,231,988,1341,529,269,1456,217,392,416,431,1272,184
13360,191,127,25,54,45,3,26,75,14,12,64,8,23,21,12,59,5
13361,264,200,33,94,65,8,77,85,21,17,64,5,16,27,16,47,17
13363,925,646,116,330,149,51,253,297,57,39,279,45,48,81,105,243,36
13365,3730,2303,438,1050,550,265,648,1049,386,220,1427,177,372,419,459,1211,216
13367,3164,2246,406,1109,546,185,884,988,232,142,918,149,200,252,317,791,127
13368,438,295,39,152,81,23,109,122,30,34,143,23,36,51,33,124,19
13402,670,460,93,212,104,51,171,202,42,45,210,81,48,57,24,159,51
13403,1575,1204,130,607,348,119,454,553,68,129,371,58,160,116,37,307,64
13406,243,174,28,92,40,14,59,86,24,5,69,4,30,21,14,65,4
13407,2286,1569,313,707,417,132,478,744,231,116,717,118,192,231,176,595,122
13408,1002,679,121,311,208,39,236,319,96,28,323,95,99,87,42,239,84
13409,787,612,105,306,168,33,220,251,81,60,175,34,66,42,33,134,41
13411,1226,857,180,386,247,44,313,379,111,54,369,31,86,136,116,322,47
13413,6310,4135,446,2032,1201,456,1536,2021,310,268,2175,250,545,682,698,1900,275
13416,833,582,99,289,154,40,217,239,71,55,251,38,74,62,77,209,42
13417,1569,870,188,348,242,92,198,395,157,120,699,136,151,172,240,614,85
13418,112,77,19,41,8,9,47,19,6,5,35,4,6,12,13,30,5
13420,728,461,40,202,181,38,128,267,39,27,267,53,81,73,60,218,49
13421,5357,3360,613,1776,777,194,1148,1439,591,182,1997,428,562,549,458,1665,332
13424,896,638,98,326,160,54,229,281,60,68,258,45,46,63,104,233,25
13425,774,553,94,287,124,48,182,250,74,47,221,29,38,70,84,201,20
13428,646,461,78,193,153,37,164,218,32,47,185,12,40,70,63,159,26
13431,658,500,59,266,146,29,181,239,45,35,158,23,64,34,37,126,32
13433,678,499,126,209,127,37,157,206,93,43,179,27,55,63,34,154,25
13436,71,38,6,11,14,7,8,21,4,5,33,3,13,10,7,28,5
13437,184,134,27,63,37,7,35,71,19,9,50,3,9,27,11,40,10
13438,1690,1212,203,620,305,84,446,554,118,94,478,61,135,216,66,360,118
13439,1529,1063,125,455,366,117,296,575,124,68,466,64,136,131,135,399,67
13440,17266,11219,2069,5150,3067,933,3279,5088,1828,1024,6047,1071,1826,1655,1495,5190,857
13450,86,59,18,19,17,5,22,17,9,11,27,0,7,8,12,27,0
13452,1724,1196,225,549,329,93,398,530,155,113,528,81,131,150,166,460,68
13454,231,182,34,81,59,8,68,84,20,10,49,1,15,21,12,38,11
13456,1568,1180,133,654,320,73,476,469,125,110,388,54,85,128,121,357,31
13459,747,538,79,280,153,26,169,248,72,49,209,33,43,71,62,171,38
13460,1735,1163,224,579,292,68,404,507,176,76,572,87,173,186,126,485,87
13461,1274,899,100,497,201,101,352,407,89,51,375,45,60,111,159,339,36
13464,438,332,65,167,82,18,131,130,41,30,106,30,34,34,8,68,38
13468,188,124,8,74,27,15,48,51,11,14,64,5,22,23,14,53,11
13469,322,241,44,97,92,8,72,114,49,6,81,8,30,22,21,66,15
13470,256,186,26,94,57,9,50,90,24,22,70,2,31,19,18,58,12
13471,1178,918,181,457,241,39,371,387,104,56,260,80,84,73,23,209,51
13473,281,214,30,120,50,14,85,85,28,16,67,9,17,19,22,55,12
13475,2,2,0,2,0,0,2,0,0,0,0,0,0,0,0,0,0
13476,1245,874,122,454,180,118,295,380,144,55,371,103,114,79,75,289,82
13477,524,392,64,181,132,15,142,169,52,29,132,28,49,37,18,97,35
13478,1208,939,177,461,259,42,359,417,93,70,269,43,96,63,67,225,44
13480,1227,883,176,434,240,33,351,363,110,59,344,52,96,116,80,289,55
13483,71,54,13,33,8,0,32,18,4,0,17,0,9,5,3,12,5
13485,350,270,64,127,64,15,115,110,25,20,80,20,26,23,11,62,18
13486,308,234,39,100,65,30,78,120,14,22,74,16,18,27,13,63,11
13489,290,215,50,111,40,14,102,76,26,11,75,23,26,21,5,55,20
13490,587,440,40,245,143,12,181,209,12,38,147,30,45,48,24,119,28
13491,1465,1083,194,515,314,60,378,510,115,80,382,56,66,131,129,322,60
13492,4649,3205,447,1506,921,331,1189,1456,264,296,1444,173,396,424,451,1263,181
13493,760,560,125,283,120,32,202,237,85,36,200,35,85,49,31,142,58
13495,1049,600,115,199,153,133,153,253,86,108,449,94,124,105,126,394,55
13501,14775,8518,2114,3428,1959,1017,2418,2998,1840,1262,6257,1023,1814,1665,1755,5539,718
13502,13649,8243,1987,3402,2128,726,2307,3451,1524,961,5406,1087,1663,1510,1146,4620,786
13601,14577,9233,2474,4203,1889,667,3324,3607,1627,675,5344,1224,1702,1407,1011,4497,847
13602,15,0,0,0,0,0,0,0,0,0,15,15,0,0,0,0,15
13603,2261,2192,1585,607,0,0,1550,500,142,0,69,41,28,0,0,64,5
13605,1881,1287,261,638,294,94,466,599,144,78,594,88,165,183,158,504,90
13606,924,697,124,402,128,43,320,280,55,42,227,51,58,67,51,169,58
13607,854,552,73,276,155,48,196,235,60,61,302,32,103,92,75,263,39
13608,548,403,84,198,105,16,152,168,66,17,145,22,35,53,35,118,27
13612,1017,757,159,411,148,39,284,332,98,43,260,48,94,88,30,205,55
13613,1007,694,145,318,186,45,197,358,106,33,313,42,110,74,87,252,61
13614,119,83,17,34,30,2,18,49,12,4,36,7,11,12,6,33,3
13615,442,300,40,171,68,21,84,143,42,31,142,19,32,57,34,128,14
13616,756,655,323,218,109,5,377,230,30,18,101,32,19,45,5,93,8
13617,3374,2146,328,1158,553,107,808,951,272,115,1228,298,329,347,254,953,275
13618,738,494,63,225,158,48,129,259,61,45,244,25,67,88,64,213,31
13619,4228,3020,752,1396,669,203,1194,1294,327,205,1208,186,382,414,226,1007,201
13620,869,677,135,342,169,31,280,312,60,25,192,41,66,64,21,144,48
13621,298,186,30,102,52,2,74,72,23,17,112,12,34,61,5,100,12
13622,793,586,91,281,184,30,217,282,39,48,207,19,63,76,49,171,36
13624,1865,1334,237,612,389,96,446,662,165,61,531,46,141,190,154,445,86
13625,749,497,72,232,169,24,165,246,63,23,252,26,92,90,44,216,36
13626,772,584,179,280,117,8,228,260,72,24,188,31,74,55,28,156,32
13630,523,367,68,185,98,16,131,148,50,38,156,25,49,63,19,116,40
13633,94,72,12,35,23,2,37,26,3,6,22,3,7,5,7,20,2
13634,1402,1004,202,529,233,40,396,448,119,41,398,58,128,120,92,312,86
13635,390,291,57,135,87,12,100,132,45,14,99,11,25,33,30,77,22
13637,1344,1044,495,365,141,43,454,348,182,60,300,93,116,59,32,208,92
13638,156,114,38,42,3,31,33,44,23,14,42,17,25,0,0,38,4
13639,73,62,7,39,16,0,21,33,6,2,11,2,6,0,3,6,5
13640,127,92,0,17,56,19,10,50,0,32,35,0,22,13,0,31,4
13642,3571,2510,597,1162,642,109,918,1067,389,136,1061,179,315,294,273,896,165
13646,897,639,90,265,218,66,183,329,78,49,258,47,90,71,50,209,49
13648,944,701,145,339,171,46,263,334,52,52,243,34,67,93,49,197,46
13650,554,380,54,167,126,33,119,213,21,27,174,19,54,53,48,137,37
13652,715,528,126,271,105,26,209,209,67,43,187,20,65,65,37,160,27
13654,836,632,149,321,138,24,278,249,77,28,204,25,52,81,46,171,33
13655,850,631,135,332,129,35,205,127,188,111,219,45,69,78,27,196,23
13656,973,745,206,313,186,40,304,331,75,35,228,26,81,95,26,179,49
13658,877,632,131,312,154,35,214,316,75,27,245,50,78,86,31,190,55
13659,205,149,21,93,26,9,62,50,27,10,56,4,29,17,6,45,11
13660,665,507,90,244,148,25,177,227,71,32,158,23,53,54,28,120,38
13661,722,567,104,266,143,54,246,225,65,31,155,33,44,49,29,125,30
13662,6920,4550,830,2101,1244,375,1367,2105,748,330,2370,436,775,622,537,1988,382
13664,134,82,26,30,21,5,25,26,22,9,52,3,16,14,19,48,4
13665,282,214,42,95,61,16,81,89,19,25,68,6,25,35,2,40,28
13667,1426,965,199,464,261,41,264,449,191,61,461,44,148,162,107,367,94
13668,1243,895,202,409,227,57,316,376,140,63,348,89,123,91,45,240,108
13669,6156,4051,865,1934,1044,208,1256,1667,757,371,2105,330,664,698,413,1746,359
13670,252,168,16,81,64,7,42,100,14,12,84,2,30,41,11,62,22
13672,159,117,13,45,56,3,17,62,22,16,42,2,13,18,9,29,13
13673,820,635,240,285,93,17,278,231,86,40,185,38,47,49,51,160,25
13675,39,33,0,23,10,0,8,10,8,7,6,0,6,0,0,6,0
13676,5500,3205,717,1481,799,208,1171,1383,430,221,2295,983,483,455,374,1665,630
13679,665,466,88,226,108,44,183,223,43,17,199,41,52,74,32,155,44
13680,430,341,89,159,75,18,164,121,33,23,89,13,37,18,21,65,24
13681,279,214,45,95,47,27,73,101,18,22,65,21,12,20,12,48,17
13682,296,233,42,145,35,11,107,97,22,7,63,7,26,17,13,48,15
13684,383,280,76,129,60,15,107,123,37,13,103,16,26,26,35,82,21
13685,966,611,114,306,163,28,175,300,83,53,355,150,74,80,51,294,61
13687,131,94,11,48,33,2,20,57,13,4,37,4,10,17,6,28,9
13690,483,308,63,141,93,11,89,158,37,24,175,19,43,66,47,154,21
13691,982,716,150,399,147,20,275,287,105,49,266,69,105,62,30,194,72
13693,218,165,11,71,67,16,41,103,11,10,53,8,13,18,14,44,9
13694,587,385,51,190,117,27,100,223,34,28,202,25,52,65,60,165,37
13697,841,560,141,262,132,25,200,277,75,8,281,54,91,81,55,240,41
13730,1139,789,120,369,239,61,248,361,121,59,350,74,99,101,76,286,64
13731,563,374,35,145,168,26,94,224,30,26,189,18,59,64,48,164,25
13732,2997,2405,397,1242,639,127,1046,1060,224,75,592,106,221,199,66,489,103
13733,1907,1329,222,645,357,105,473,640,151,65,578,98,197,186,97,481,97
13734,878,657,85,371,198,3,302,242,81,32,221,37,67,48,69,185,36
13736,918,643,113,357,153,20,213,287,69,74,275,52,108,49,66,218,57
13739,369,252,45,110,67,30,76,127,31,18,117,14,34,53,16,96,21
13740,225,140,18,64,47,11,59,71,2,8,85,10,30,26,19,60,25
13743,1399,1035,188,548,262,37,388,430,155,62,364,58,115,125,66,296,68
13744,467,325,37,168,103,17,93,161,58,13,142,22,53,58,9,113,29
13746,867,604,95,276,191,42,244,283,34,43,263,19,123,79,42,238,25
13748,1551,1169,177,588,333,71,407,582,139,41,382,43,150,136,53,323,59
13750,537,388,62,157,145,24,118,193,35,42,149,27,34,63,25,117,32
13752,311,208,17,90,78,23,53,124,20,11,103,21,26,31,25,91,12
13753,1809,1173,167,532,384,90,402,581,82,108,636,114,206,205,111,500,136
13754,1413,945,189,407,288,61,305,418,152,70,468,47,99,161,161,402,66
13755,486,319,50,129,122,18,106,161,26,26,167,16,44,64,43,154,13
13756,208,160,24,70,51,15,42,96,18,4,48,0,12,23,13,48,0
13757,431,303,55,136,93,19,112,142,20,29,128,24,35,49,20,105,23
13760,18746,11950,2111,5635,3168,1036,3865,5448,1527,1110,6796,1495,1988,1744,1569,5770,1026
13774,92,76,17,42,13,4,25,24,27,0,16,0,8,4,4,16,0
13775,696,446,66,191,152,37,164,226,29,27,250,47,58,76,69,199,51
13776,327,228,14,121,71,22,70,128,25,5,99,6,29,31,33,87,12
13777,367,292,63,161,51,17,114,127,36,15,75,9,27,27,12,63,12
13778,2477,1690,290,855,432,113,555,689,306,140,787,108,290,230,159,643,144
13780,376,256,37,118,61,40,70,130,40,16,120,16,60,20,24,95,25
13782,322,227,27,99,81,20,60,129,23,15,95,7,32,38,18,88,7
13783,1047,654,97,279,215,63,224,338,58,34,393,49,111,155,78,343,50
13786,174,128,15,59,43,11,43,70,8,7,46,14,3,24,5,40,6
13787,1313,979,172,559,206,42,350,418,133,78,334,39,110,129,56,277,57
13788,350,268,32,128,92,16,75,144,26,23,82,11,22,27,22,60,22
13790,8592,4895,896,2217,1272,510,1443,2153,764,535,3697,1017,963,748,969,3131,566
13795,1486,1090,153,505,314,118,318,560,139,73,396,81,129,118,68,301,95
13796,451,318,56,141,93,28,82,186,35,15,133,14,53,43,23,112,21
13797,885,673,124,360,157,32,283,254,69,67,212,33,71,59,49,165,47
13801,520,363,59,177,111,16,120,187,37,19,157,21,48,56,32,126,31
13802,263,219,41,113,65,0,99,85,20,15,44,4,8,14,18,38,6
13803,1556,1174,244,587,285,58,436,488,194,56,382,79,118,113,72,299,83
13804,146,122,25,65,26,6,36,60,14,12,24,3,2,12,7,24,0
13807,494,331,44,172,92,23,124,131,50,26,163,23,66,50,24,122,41
13808,747,541,95,281,124,41,168,232,91,50,206,37,52,69,48,169,37
13809,490,380,80,202,84,14,120,198,35,27,110,6,46,35,23,91,19
13810,526,387,68,163,125,31,116,198,48,25,139,12,41,62,24,109,30
13811,1548,1207,183,648,314,62,517,517,100,73,341,48,97,112,84,292,49
13812,895,674,116,347,151,60,241,284,107,42,221,34,58,57,72,166,55
13813,393,290,71,126,86,7,101,99,52,38,103,0,54,39,10,90,13
13815,5760,3591,758,1657,854,322,1161,1540,601,289,2169,360,633,662,514,1825,344
13820,7332,4038,697,2004,1024,313,1300,1712,674,352,3294,1307,771,603,613,2328,966
13825,1413,977,165,490,232,90,309,439,168,61,436,71,155,114,96,345,91
13827,4890,3341,527,1567,1010,237,1079,1708,381,173,1549,283,531,412,323,1283,266
13830,1930,1372,169,654,444,105,394,754,137,87,558,85,165,201,107,413,145
13832,216,164,36,86,36,6,70,62,21,11,52,6,19,22,5,34,18
13833,1617,1260,264,585,326,85,385,572,189,114,357,43,162,100,52,254,103
13834,65,40,23,12,0,5,9,10,21,0,25,5,6,8,6,20,5
13835,571,411,65,206,122,18,129,192,56,34,160,22,65,40,33,128,32
13838,2078,1341,189,678,300,174,339,591,287,124,737,90,136,292,219,621,116
13839,621,431,101,171,143,16,160,157,63,51,190,16,54,78,42,153,37
13841,142,112,33,54,22,3,56,37,18,1,30,4,8,12,6,25,5
13842,154,123,11,53,57,2,39,60,8,16,31,3,13,9,6,28,3
13843,659,460,95,213,139,13,173,193,66,28,199,33,64,57,45,162,37
13844,309,236,46,110,62,18,83,116,28,9,73,18,31,17,7,58,15
13846,123,79,4,38,28,9,28,44,7,0,44,10,8,12,14,38,6
13849,2030,1472,273,613,472,114,479,763,159,71,558,107,175,132,144,436,122
13850,8578,6096,733,2894,1965,504,2231,2980,451,434,2482,565,719,603,595,2141,341
13856,2773,1851,212,838,641,160,578,895,198,180,922,121,274,338,189,806,116
13859,118,59,0,43,16,0,23,31,5,0,59,0,32,21,6,59,0
13861,265,208,26,88,69,25,77,104,21,6,57,16,26,15,0,37,20
13862,1448,1050,206,524,250,70,404,414,156,76,398,80,129,114,75,311,87
13863,212,161,41,55,61,4,56,82,15,8,51,13,19,11,8,36,15
13864,400,300,87,108,82,23,85,138,42,35,100,26,40,13,21,79,21
13865,2409,1782,307,938,470,67,667,821,207,87,627,94,192,210,131,504,123
13901,8859,5096,865,2508,1263,460,1606,2228,732,530,3763,732,978,1115,938,3243,520
13903,7886,5009,843,2465,1274,427,1596,2121,806,486,2877,732,767,828,550,2319,558
13904,3864,2432,438,1154,675,165,769,1014,378,271,1432,232,506,358,336,1151,281
13905,11745,5938,1172,2584,1540,642,1641,2595,977,725,5807,1964,1509,1262,1072,4545,1262
14001,3709,2584,437,1311,581,255,1029,1138,232,185,1125,169,275,389,292,934,191
14004,3950,3024,387,1525,918,194,1061,1483,224,256,926,112,283,312,219,771,155
14005,623,452,58,253,135,6,176,222,34,20,171,42,40,69,20,142,29
14006,4220,2977,497,1579,707,194,1112,1253,381,231,1243,145,395,391,312,1045,198
14008,531,380,47,190,122,21,140,203,18,19,151,25,62,37,27,121,30
14009,2217,1517,260,770,387,100,525,713,163,116,700,113,206,179,202,595,105
14011,2263,1643,286,872,407,78,611,764,164,104,620,119,182,171,148,531,89
14012,915,718,131,358,194,35,280,316,74,48,197,29,66,55,47,147,50
14013,614,419,67,207,104,41,166,179,32,42,195,24,62,46,63,160,35
14020,9126,5830,1182,2685,1462,501,1877,2422,875,656,3296,642,815,879,960,2761,535
14024,621,484,84,263,115,22,187,202,58,37,137,25,39,41,32,111,26
14025,1216,882,181,410,230,61,325,449,74,34,334,79,106,82,67,262,72
14026,290,203,25,90,61,27,101,98,4,0,87,11,45,22,9,73,14
14028,691,499,73,269,113,44,189,215,58,37,192,11,85,60,36,132,60
14030,628,459,73,225,121,40,135,226,36,62,169,46,54,48,21,149,20
14031,3258,2328,151,1148,842,187,842,1177,127,182,930,138,208,272,312,816,114
14032,1813,1524,211,939,326,48,793,583,65,83,289,65,106,78,40,260,29
14033,710,587,44,379,128,36,216,290,59,22,123,3,54,42,24,97,26
14034,792,611,80,290,173,68,231,297,39,44,181,32,44,48,57,157,24
14036,1948,1456,236,757,374,89,622,618,129,87,492,87,144,147,114,372,120
14037,384,289,27,155,95,12,106,131,27,25,95,18,29,30,18,74,21
14039,36,25,2,18,4,1,10,13,1,1,11,1,6,4,0,11,0
14040,787,648,80,326,219,23,240,340,34,34,139,21,55,44,19,116,23
14042,1816,1240,263,607,301,69,491,560,120,69,576,92,158,194,132,464,112
14043,10657,7284,1184,3288,2272,540,2345,3482,674,783,3373,692,919,1106,656,2883,490
14047,2487,1924,298,1089,461,76,720,805,222,177,563,49,154,249,111,490,73
14048,6475,4041,877,1750,998,416,1075,1684,732,550,2434,342,707,750,635,2142,292
14051,6084,5101,530,3159,1197,215,2531,2227,172,171,983,150,400,288,145,812,171
14052,6930,5114,554,2698,1496,366,2082,2435,344,253,1816,320,452,484,560,1605,211
14054,520,402,61,194,126,21,153,181,38,30,118,26,50,30,12,92,26
14055,510,363,53,205,88,17,163,155,36,9,147,26,49,61,11,93,54
14057,2898,2239,242,1163,696,138,903,1039,155,142,659,86,204,229,140,575,84
14058,819,624,94,353,155,22,235,272,64,53,195,43,55,50,47,154,41
14059,3277,2542,212,1302,851,177,945,1303,148,146,735,58,168,304,205,640,95
14060,175,126,19,70,30,7,52,56,10,8,49,5,17,13,14,34,15
14062,1309,995,146,493,280,76,344,482,103,66,314,45,102,127,40,251,63
14063,5038,2992,465,1523,786,218,1047,1406,333,206,2046,857,423,441,325,1393,653
14065,685,555,127,281,127,20,216,216,98,25,130,24,44,52,10,101,29
14066,544,412,66,224,101,21,156,196,44,16,132,19,58,34,21,110,22
14067,1898,1422,221,769,393,39,520,646,163,93,476,65,166,177,68,366,110
14068,2319,1721,214,1097,335,75,933,596,110,82,598,45,228,105,220,533,65
14069,321,227,32,98,90,7,52,141,18,16,94,21,50,23,0,63,31
14070,2312,1469,285,683,402,99,441,588,232,208,843,89,282,299,173,739,104
14072,6916,5236,576,2949,1473,238,2072,2495,382,287,1680,294,558,480,348,1423,257
14075,16519,11496,1542,6090,3060,804,4397,5245,1083,771,5023,748,1485,1547,1243,4390,633
14080,1756,1312,191,744,320,57,541,578,117,76,444,92,140,112,100,343,101
14081,1327,827,182,396,206,43,248,326,135,118,500,83,158,153,106,394,106
14082,154,126,22,71,29,4,46,52,20,8,28,0,4,20,4,28,0
14083,22,22,0,19,3,0,9,13,0,0,0,0,0,0,0,0,0
14085,1890,1551,276,830,359,86,675,678,97,101,339,66,102,127,44,285,54
14086,10726,7922,1149,4421,1961,391,3280,3534,539,569,2804,373,886,787,758,2473,331
14091,379,293,59,164,62,8,84,109,64,36,86,6,35,35,10,76,10
14092,4468,3130,293,1486,980,371,978,1637,229,286,1338,240,301,472,325,1209,129
14094,20488,13584,2658,6994,3073,859,4864,5592,1861,1267,6904,1359,2211,2030,1304,5851,1053
14098,1044,766,117,434,165,50,270,340,104,52,278,32,73,86,87,232,46
14101,685,517,79,272,150,16,178,223,70,46,168,12,40,67,49,144,24
14102,355,305,33,166,99,7,146,135,8,16,50,10,22,10,8,40,10
14103,4408,3016,533,1453,815,215,912,1290,521,293,1392,206,395,455,336,1180,212
14105,1632,1269,199,640,340,90,498,563,122,86,363,55,114,95,99,311,52
14108,2144,1648,297,841,442,68,624,758,163,103,496,68,198,152,78,420,76
14111,1193,868,141,469,225,33,327,401,52,88,325,23,88,120,94,261,64
14113,280,208,27,77,76,28,74,111,4,19,72,13,32,19,8,67,5
14120,17216,11850,1983,5870,3124,873,4207,5545,1185,913,5366,1057,1709,1305,1295,4644,722
14125,1393,1077,182,578,251,66,451,416,136,74,316,40,100,108,68,259,57
14127,10332,7712,819,4072,2269,552,3039,3592,482,599,2620,371,724,874,651,2247,373
14129,683,492,106,226,130,30,132,192,96,72,191,36,71,45,39,158,33
14131,1983,1516,181,796,456,83,545,734,129,108,467,53,123,176,115,365,102
14132,2052,1535,141,848,454,92,561,766,106,102,517,97,148,137,135,443,74
14134,0,0,0,0,0,0,0,0,0,0,0,0,0,0,0,0,0
14136,2121,1552,253,769,444,86,595,677,189,91,569,95,137,141,196,497,72
14138,761,551,98,270,144,39,206,221,90,34,210,43,65,60,42,171,39
14139,832,584,80,369,115,20,244,236,38,66,248,17,113,73,45,223,25
14141,2987,2057,328,1067,550,112,836,909,198,114,930,140,243,286,261,790,140
14143,480,372,50,204,87,31,139,186,32,15,108,19,37,25,27,97,11
14145,576,451,74,235,101,41,196,174,43,38,125,29,46,38,12,106,19
14150,18934,12471,1882,5669,3662,1258,4000,5952,1247,1272,6463,1259,1769,1857,1578,5655,808
14167,631,502,80,291,107,24,202,213,60,27,129,32,54,16,27,105,24
14170,982,787,88,411,249,39,324,358,41,64,195,30,80,56,29,155,40
14171,806,626,113,327,167,19,226,299,65,36,180,33,60,56,31,138,42
14172,1245,932,133,422,303,74,294,455,96,87,313,26,123,83,81,270,43
14174,2208,1646,172,886,482,106,635,725,146,140,562,76,213,157,116,466,96
14201,6198,2609,986,1179,396,48,486,580,1125,418,3589,946,1432,886,325,3029,560
14202,1676,453,83,162,171,37,47,236,99,71,1223,304,428,365,126,1074,149
14203,428,108,35,67,6,0,6,0,89,13,320,46,124,130,20,296,24
14204,4740,2426,652,1004,620,150,433,524,947,522,2314,251,878,871,314,2180,134
14206,10314,5893,1258,2457,1474,704,1436,2323,1096,1038,4421,668,1207,1315,1231,3864,557
14207,9763,5654,1575,2529,1151,399,1486,1681,1653,834,4109,763,1298,1347,701,3548,561
14208,5072,2931,629,1236,688,378,340,811,1103,677,2141,226,636,738,541,1853,288
14209,4429,1653,454,749,351,99,289,541,528,295,2776,767,845,739,425,2341,435
14210,6722,4178,1191,1844,910,233,1135,1353,1100,590,2544,567,852,634,491,2136,408
14211,11846,7379,2013,3293,1574,499,1185,1577,2916,1701,4467,736,1692,1374,665,3934,533
14212,6848,3804,1099,1548,732,425,688,1013,1426,677,3044,400,1199,776,669,2731,313
14213,9956,5877,2110,2579,924,264,1454,1570,2194,659,4079,1123,1529,880,547,3200,879
14214,8353,4430,1101,1991,1031,307,1183,1314,1183,750,3923,1418,1276,876,353,2854,1069
14215,17481,11332,3104,5240,2373,615,2471,2907,3712,2242,6149,1397,2145,1730,877,5170,979
14216,10954,5789,1324,2612,1290,563,1687,2295,949,858,5165,1561,1643,1015,946,4232,933
14217,10798,6302,1082,3030,1469,721,2165,2764,701,672,4496,793,1288,1172,1243,3959,537
14218,8675,5138,985,2235,1283,635,1401,2115,869,753,3537,556,918,1229,834,3173,364
14219,5391,3513,730,1628,911,244,1133,1337,456,587,1878,427,520,532,399,1568,310
14220,10465,6617,1336,3187,1534,560,2248,2404,960,1005,3848,732,1143,1029,944,3265,583
14221,20631,13981,1353,6648,4528,1452,5000,7159,826,996,6650,1064,1439,2028,2119,5860,790
14222,7162,2219,616,949,508,146,495,1087,263,374,4943,2157,1509,842,435,3793,1150
14223,9924,6627,909,3139,1853,726,2466,3096,493,572,3297,450,815,955,1077,2868,429
14224,16029,11251,1253,5189,3697,1112,3811,5646,778,1016,4778,819,1303,1274,1382,4155,623
14225,15657,9997,1676,4154,2869,1298,2956,4762,992,1287,5660,915,1313,1783,1649,4981,679
14226,12564,7932,1344,3572,2104,912,2637,3666,824,805,4632,1076,1122,1186,1248,3904,728
14227,10428,6746,1002,2962,2235,547,1986,3596,481,683,3682,665,875,1128,1014,3093,589
14228,7517,4613,923,2390,1043,257,1653,1991,578,391,2904,1000,876,618,410,2213,691
14301,6468,3575,977,1459,695,444,762,1115,1121,577,2893,592,982,681,638,2525,368
14303,3361,1652,424,650,332,246,348,540,505,259,1709,274,503,389,543,1552,157
14304,12788,8397,1508,3762,2318,809,2646,4001,892,858,4391,647,1458,1266,1020,3864,527
14305,7701,5038,1089,2218,1311,420,1283,1752,1246,757,2663,402,791,817,653,2407,256
14411,4888,3387,720,1665,743,259,1252,1279,582,274,1501,210,470,487,334,1204,297
14414,2597,1792,376,948,374,94,659,810,238,85,805,131,267,246,161,662,143
14415,22,11,0,4,4,3,0,7,0,4,11,4,4,3,0,11,0
14416,1459,1094,193,584,249,68,437,508,99,50,365,82,94,119,70,273,92
14418,591,414,67,190,145,12,139,206,35,34,177,9,83,55,30,136,41
14420,6502,4187,832,2318,837,200,1740,1599,536,312,2315,843,611,419,442,1636,679
14422,900,689,105,401,157,26,268,335,60,26,211,53,75,27,56,161,50
14423,1838,1388,156,770,380,82,512,606,198,72,450,96,179,109,66,379,71
14424,9991,6521,1198,3399,1450,474,2328,2851,811,531,3470,651,1118,1081,620,2740,730
14425,3497,2630,563,1490,493,84,1113,941,350,226,867,174,376,233,84,642,225
14427,843,616,110,319,136,51,237,267,64,48,227,47,67,57,56,187,40
14428,2643,2124,293,1256,495,80,946,858,153,167,519,80,209,127,103,408,111
14432,2209,1658,312,792,418,136,561,732,258,107,551,59,192,131,169,488,63
14433,1745,1275,261,611,293,110,495,509,164,107,470,72,142,141,115,378,92
14435,1023,751,83,465,173,30,294,337,67,53,272,53,89,63,67,213,59
14437,3836,2631,544,1318,614,155,906,1178,403,144,1205,160,332,401,312,945,260
14441,135,90,12,42,28,8,26,44,11,9,45,2,19,14,10,30,15
14445,3465,2111,516,986,474,135,625,817,399,270,1354,367,408,332,247,1098,256
14450,15665,11433,1580,6454,2853,546,4866,4931,961,675,4232,893,1422,1302,615,3560,672
14454,2583,1417,225,741,384,67,524,647,162,84,1166,604,249,206,107,634,532
14456,7579,4726,826,2311,1147,442,1559,1963,764,440,2853,599,756,797,701,2393,460
14462,205,167,17,107,39,4,69,67,24,7,38,0,17,10,11,29,9
14464,2675,2081,382,1270,373,56,1007,717,237,120,594,168,190,180,56,465,129
14466,592,424,48,266,91,19,131,200,53,40,168,38,77,40,13,134,34
14467,3242,2389,426,1363,480,120,996,1012,267,114,853,193,277,241,142,691,162
14468,5767,4598,683,2602,1063,250,1894,1929,482,293,1169,148,435,401,185,951,218
14469,2190,1670,273,847,451,99,607,746,211,106,520,89,212,116,103,414,106
14470,2832,2044,411,1050,469,114,709,873,285,177,788,181,273,189,145,598,190
14471,1127,758,82,357,249,70,226,403,73,56,369,62,163,82,62,271,98
14472,3111,2364,192,1379,645,148,990,1109,130,135,747,114,256,174,203,625,122
14475,78,61,7,37,13,4,36,21,4,0,17,0,15,0,2,13,4
14476,880,729,92,380,216,41,261,344,102,22,151,25,68,38,20,124,27
14477,594,435,57,260,106,12,169,180,62,24,159,12,77,42,28,133,26
14478,343,211,4,92,98,17,53,127,27,4,132,28,39,38,27,120,12
14480,272,189,46,75,53,15,68,77,26,18,83,31,27,25,0,65,18
14481,696,528,98,257,147,26,195,259,35,39,168,41,51,52,24,134,34
14482,3625,2446,414,1289,616,127,924,1050,299,173,1179,306,315,291,267,948,231
14485,1622,1166,147,644,321,54,446,527,84,109,456,90,168,111,87,372,84
14487,2094,1588,286,929,316,57,694,635,169,90,506,78,194,146,88,408,98
14489,2857,1897,357,835,506,199,534,917,288,158,960,120,369,273,198,748,212
14502,3381,2641,631,1315,605,90,1083,1070,338,150,740,207,319,140,74,548,192
14504,574,355,70,147,83,55,111,174,42,28,219,26,66,65,62,176,43
14505,2093,1643,298,893,384,68,664,722,165,92,450,86,138,91,135,350,100
14506,430,369,36,213,120,0,198,140,24,7,61,9,25,21,6,44,17
14507,513,395,61,213,101,20,145,166,50,34,118,10,59,32,17,105,13
14510,2002,1349,261,639,333,116,357,488,308,196,653,81,268,151,153,536,117
14512,1849,1311,226,643,343,99,446,622,158,85,538,77,188,162,111,417,121
14513,5773,3968,782,2012,917,257,1216,1578,827,347,1805,248,570,526,461,1503,302
14514,1737,1203,230,577,271,125,431,518,188,66,534,167,145,76,146,431,103
14516,990,707,103,316,235,53,231,367,74,35,283,39,88,93,63,252,31
14517,1074,769,163,384,166,56,262,293,134,80,305,40,98,119,48,253,52
14519,4111,3095,588,1689,737,81,1160,1239,496,200,1016,205,301,304,206,779,237
14521,1065,657,110,312,171,64,240,281,91,45,408,69,88,140,111,329,79
14522,3471,2296,408,1140,594,154,863,1103,221,109,1175,174,460,329,212,897,278
14525,999,792,125,413,213,41,270,392,71,59,207,18,84,71,34,173,34
14526,7304,5503,626,3203,1322,352,2489,2314,414,286,1801,417,670,398,316,1495,306
14527,4984,3364,560,1550,981,273,1066,1567,492,239,1620,257,451,452,460,1316,304
14530,2290,1585,273,756,448,108,512,660,211,202,705,150,202,169,184,576,129
14532,1728,1255,212,670,311,62,439,570,163,83,473,79,149,135,110,397,76
14533,837,612,100,305,174,33,244,272,58,38,225,28,87,62,48,214,11
14534,10885,8753,643,4799,2689,622,3818,4190,426,319,2132,232,625,650,625,1813,319
14536,245,178,34,81,53,10,65,79,21,13,67,8,33,15,11,44,23
14541,712,549,89,263,145,52,207,252,64,26,163,31,51,48,33,128,35
14543,1158,919,64,487,318,50,303,523,45,48,239,28,105,41,65,165,74
14544,739,551,63,313,132,43,222,227,67,35,188,38,61,53,36,144,44
14545,85,63,8,38,16,1,29,27,3,4,22,2,13,4,3,18,4
14546,2174,1549,245,825,394,85,543,722,194,90,625,161,219,112,133,465,160
14548,1611,1127,233,594,253,47,423,514,137,53,484,61,179,148,96,363,121
14550,669,482,95,243,114,30,180,216,59,27,187,21,72,52,42,158,29
14551,1992,1429,299,746,306,78,506,576,240,107,563,96,149,210,108,437,126
14555,573,351,66,175,94,16,82,201,47,21,222,22,62,69,69,170,52
14559,5771,4466,646,2423,1207,190,1835,1988,376,267,1305,350,484,279,192,1091,214
14560,877,623,76,385,122,40,190,304,100,29,254,33,101,80,40,199,55
14561,1023,828,124,408,244,52,297,403,73,55,195,23,99,40,33,160,35
14564,3645,2664,355,1472,722,115,1158,1218,156,132,981,217,311,259,194,760,221
14568,1915,1522,323,989,176,34,835,556,95,36,393,90,147,126,30,340,53
14569,2461,1620,366,740,396,118,564,710,247,99,841,168,274,201,198,700,141
14571,450,309,62,141,90,16,135,130,26,18,141,19,75,32,15,107,34
14572,2052,1483,240,799,339,105,491,678,235,79,569,72,194,178,125,448,121
14580,16884,12287,1831,6510,3150,796,4914,5703,1010,660,4597,871,1523,1220,983,3885,712
14585,128,88,9,47,22,10,35,40,3,10,40,9,12,8,11,31,9
14586,2325,1631,315,954,326,36,731,684,110,106,694,294,196,134,70,490,204
14589,2983,2189,270,1133,639,147,832,1026,138,193,794,119,255,265,155,654,140
14590,2107,1433,241,686,402,104,427,660,247,99,674,96,225,210,143,512,162
14591,546,442,66,214,136,26,176,223,24,19,104,21,31,22,30,77,27
14604,1216,127,54,73,0,0,13,45,48,21,1089,367,320,290,112,1009,80
14605,4979,3280,1298,1352,530,100,487,310,1813,670,1699,389,672,472,166,1404,295
14606,11477,7710,1628,3620,2005,457,2387,2858,1563,902,3767,667,1464,835,801,3104,663
14607,9807,2045,734,786,420,105,362,988,401,294,7762,4357,2193,841,371,5868,1894
14608,5302,2846,969,1245,508,124,448,444,1280,674,2456,646,1011,659,140,2029,427
14609,17860,11063,2844,5080,2250,889,2838,3709,2838,1678,6797,1413,2524,1452,1408,5485,1312
14610,6645,3244,498,1420,889,437,983,1479,369,413,3401,1068,1016,571,746,2791,610
14611,7090,4406,1376,2039,812,179,625,830,1986,965,2684,538,966,839,341,2311,373
14612,13823,9466,1617,5304,1987,558,3739,4122,949,656,4357,877,1495,1102,883,3519,838
14613,5499,3372,1180,1625,409,158,877,678,1308,509,2127,597,937,409,184,1731,396
14614,38,0,0,0,0,0,0,0,0,0,38,0,12,26,0,38,0
14615,6695,3929,1067,1802,792,268,985,1444,895,605,2766,725,1011,598,432,2243,523
14616,11480,7527,1610,3370,1759,788,2327,3234,1213,753,3953,678,1112,1041,1122,3420,533
14617,9420,6570,804,3232,1742,792,2337,3184,487,562,2850,297,856,802,895,2508,342
14618,8848,5686,537,2977,1559,613,2107,2836,437,306,3162,496,943,986,737,2698,464
14619,5438,3729,861,1980,790,98,1028,973,1047,681,1709,405,615,471,218,1362,347
14620,11464,4698,1568,2125,660,345,1250,1676,1145,627,6766,2659,2069,1059,979,5178,1588
14621,13732,8352,2711,3591,1421,629,1894,1828,3188,1442,5380,775,1741,1503,1361,4673,707
14622,5209,3330,486,1558,869,417,1085,1677,248,320,1879,205,573,530,571,1541,338
14623,8939,4810,1166,2107,1216,321,1676,2048,440,646,4129,2024,1007,783,315,2587,1542
14624,14426,10607,1519,5441,2751,896,3876,5083,875,773,3819,848,1093,1119,759,3147,672
14625,4565,3152,314,1410,1121,307,1114,1608,160,270,1413,189,506,464,254,1221,192
14626,11473,8162,1126,3962,2390,684,2950,3833,734,645,3311,455,914,1088,854,2899,412
14701,17933,11172,2364,4994,2949,865,3411,4823,1992,946,6761,1320,2138,1716,1587,5728,1033
14706,2430,1697,241,874,458,124,714,725,149,109,733,169,181,175,208,569,164
14708,63,53,12,13,19,9,8,42,3,0,10,0,4,4,2,8,2
14709,595,422,74,190,116,42,148,197,50,27,173,25,49,67,32,147,26
14710,1456,1147,154,549,393,51,378,597,99,73,309,25,90,123,71,273,36
14711,750,491,88,235,139,29,179,211,69,32,259,28,77,85,69,229,30
14712,1411,1033,101,552,330,50,334,570,88,41,378,32,41,177,128,329,49
14714,106,94,30,27,30,7,28,47,18,1,12,1,1,7,3,12,0
14715,1244,897,162,462,194,79,331,345,142,79,347,59,84,126,78,286,61
14716,957,678,118,376,154,30,239,278,85,76,279,32,85,98,64,235,44
14717,267,194,40,80,57,17,60,81,38,15,73,13,13,39,8,69,4
14718,904,606,79,314,161,52,220,313,39,34,298,15,106,107,70,255,43
14719,1316,965,166,500,247,52,370,425,110,60,351,38,111,123,79,293,58
14721,33,29,8,9,10,2,13,14,2,0,4,0,2,2,0,2,2
14723,429,337,64,174,79,20,116,134,62,25,92,4,33,38,17,76,16
14724,933,731,134,337,204,56,274,381,56,20,202,30,62,64,46,186,16
14726,566,448,104,212,100,32,218,163,38,29,118,13,28,51,26,101,17
14727,2151,1537,210,811,404,112,514,736,161,126,614,85,211,214,104,492,122
14728,404,336,27,167,110,32,115,191,30,0,68,7,18,0,43,68,0
14729,366,262,56,139,61,6,113,88,46,15,104,12,38,27,27,77,27
14731,783,490,46,237,179,28,133,284,40,33,293,61,107,79,46,244,49
14733,1619,1037,187,489,272,89,364,447,149,77,582,98,155,150,179,482,100
14735,1017,734,148,315,228,43,259,327,84,64,283,44,103,74,62,250,33
14736,116,88,17,53,16,2,32,36,13,7,28,3,17,2,6,25,3
14737,1692,1227,237,599,311,80,446,534,142,105,465,57,164,143,101,369,96
14738,1413,1057,124,530,322,81,409,470,93,85,356,36,87,113,120,307,49
14739,1127,777,177,381,173,46,300,315,92,70,350,53,101,126,70,281,69
14740,417,324,50,173,88,13,131,143,40,10,93,23,28,20,22,70,23
14741,820,555,64,260,178,53,188,265,49,53,265,30,71,97,67,233,32
14743,778,565,108,241,174,42,194,259,79,33,213,26,76,82,29,168,45
14744,473,324,63,156,73,32,135,153,24,12,149,82,28,19,20,106,43
14747,953,693,137,327,178,51,248,334,72,39,260,25,81,118,36,208,52
14748,286,186,34,60,80,12,53,101,20,12,100,18,39,22,21,63,37
14750,2030,1358,203,677,349,129,477,623,85,173,672,94,154,232,192,623,49
14753,464,320,53,155,99,13,107,162,27,24,144,31,32,50,31,120,24
14754,194,145,42,69,27,7,66,57,16,6,49,8,23,14,4,39,10
14755,1116,808,128,398,225,57,304,347,102,55,308,42,104,91,71,276,32
14757,1580,1012,140,420,358,94,303,573,85,51,568,81,181,182,124,490,78
14760,8429,5224,1151,2407,1239,427,1677,2305,854,388,3205,644,953,923,685,2813,392
14767,642,507,96,234,144,33,209,224,49,25,135,35,27,40,33,109,26
14769,388,261,51,127,63,20,122,117,22,0,127,10,21,45,51,117,10
14770,1203,874,134,462,219,59,317,393,117,47,329,42,73,138,76,280,49
14772,1554,1124,197,528,310,89,422,474,119,109,430,56,112,160,102,351,79
14775,1039,756,167,341,200,48,251,358,109,38,283,41,53,109,80,237,46
14777,264,182,39,88,44,11,70,79,26,7,82,10,16,35,21,66,16
14779,2952,1875,438,896,429,112,544,747,397,187,1077,151,288,327,311,922,155
14781,755,557,123,279,123,32,233,238,61,25,198,31,64,49,54,159,39
14782,1031,759,145,346,237,31,224,375,85,75,272,36,94,67,75,230,42
14783,156,126,19,48,47,12,25,49,21,31,30,7,11,9,3,27,3
14784,328,267,82,102,79,4,114,122,20,11,61,4,26,23,8,49,12
14787,2205,1504,226,800,345,133,470,733,196,105,701,89,183,224,205,602,99
14801,2006,1454,325,668,370,91,496,633,221,104,552,101,183,164,104,411,141
14802,539,149,11,65,58,15,42,82,14,11,390,278,35,42,35,238,152
14803,480,317,35,162,103,17,130,164,18,5,163,82,33,29,19,117,46
14804,581,419,50,236,110,23,166,183,36,34,162,45,48,41,28,131,31
14805,465,313,71,154,73,15,114,128,62,9,152,34,73,33,12,114,38
14806,895,615,131,273,186,25,251,282,53,29,280,55,74,85,66,216,64
14807,1179,858,166,408,223,61,309,396,110,43,321,51,90,104,76,260,61
14808,250,180,35,105,35,5,75,75,19,11,70,10,11,33,16,57,13
14809,952,689,144,311,170,64,245,279,111,54,263,39,87,84,53,238,25
14810,4986,3201,535,1541,922,203,1011,1419,541,230,1785,198,593,548,446,1503,282
14812,1267,955,178,472,247,58,380,396,100,79,312,43,135,76,58,242,70
14813,1018,695,95,342,198,60,226,333,90,46,323,49,78,127,69,267,56
14814,673,555,52,273,190,40,209,271,30,45,118,25,29,43,21,118,0
14815,365,255,40,116,85,14,84,134,19,18,110,9,39,46,16,81,29
14816,211,150,37,84,29,0,94,47,0,9,61,10,49,2,0,42,19
14817,871,531,84,310,128,9,176,224,79,52,340,64,123,92,61,263,77
14818,713,513,87,259,132,35,166,259,61,27,200,45,65,55,35,165,35
14819,284,200,37,95,59,9,72,91,16,21,84,9,43,32,0,54,30
14820,254,209,43,87,67,12,91,76,24,18,45,5,14,16,10,32,13
14821,1290,956,149,516,250,41,350,435,109,62,334,26,97,141,70,264,70
14822,436,315,42,163,76,34,112,143,30,30,121,21,35,46,19,95,26
14823,1577,1104,166,529,327,82,324,567,151,62,473,91,135,122,125,407,66
14824,353,267,48,151,59,9,105,111,28,23,86,10,36,25,15,72,14
14825,339,270,61,129,70,10,119,110,36,5,69,4,22,29,14,60,9
14826,787,558,143,233,135,47,226,216,85,31,229,26,92,63,48,173,56
14830,8282,5137,975,2555,1209,398,1734,2231,717,455,3145,827,817,763,738,2654,491
14836,392,308,63,183,53,9,118,140,33,17,84,9,18,33,24,70,14
14837,1936,1387,261,636,363,127,463,613,202,109,549,69,127,201,152,450,99
14838,747,633,120,329,161,23,218,269,89,57,114,23,37,31,23,93,21
14839,273,195,35,102,48,10,67,94,23,11,78,19,18,26,15,69,9
14840,1443,1002,106,441,368,87,293,563,87,59,441,79,142,142,78,371,70
14841,327,229,24,111,90,4,58,137,29,5,98,6,56,28,8,69,29
14842,299,246,19,114,95,18,104,134,0,8,53,0,19,11,23,53,0
14843,5339,3378,766,1566,811,235,1011,1444,632,291,1961,331,581,616,433,1661,300
14845,7833,5667,739,2808,1731,389,1944,2780,558,385,2166,403,576,620,567,1815,351
14846,276,207,44,104,47,12,80,90,21,16,69,3,28,29,9,47,22
14847,946,683,119,313,194,57,230,355,68,30,263,25,79,97,62,217,46
14850,23704,10506,2276,5232,2229,769,3726,4615,1492,673,13198,7553,2704,1551,1390,8749,4449
14855,266,216,39,98,69,10,94,82,27,13,50,7,8,15,20,44,6
14857,0,0,0,0,0,0,0,0,0,0,0,0,0,0,0,0,0
14858,640,486,109,245,120,12,176,209,67,34,154,28,57,52,17,115,39
14859,417,305,59,151,71,24,96,132,58,19,112,28,27,30,27,84,28
14860,441,316,44,150,101,21,107,141,47,21,125,7,51,43,24,99,26
14861,556,424,71,183,140,30,120,243,33,28,132,21,43,35,33,110,22
14864,524,326,59,170,43,54,61,153,91,21,198,44,72,54,28,137,61
14865,1071,709,131,352,180,46,211,327,107,64,362,47,89,108,118,300,62
14867,2169,1447,352,754,262,79,552,510,290,95,722,147,314,174,87,536,186
14869,532,391,96,178,88,29,139,167,55,30,141,21,43,42,35,115,26
14870,3837,2583,353,1319,669,242,864,1177,344,198,1254,169,363,406,316,1102,152
14871,1868,1447,168,703,456,120,466,789,79,113,421,64,124,109,124,346,75
14872,184,130,29,56,25,20,48,46,25,11,54,10,7,22,15,44,10
14873,951,664,136,315,165,48,222,282,107,53,287,42,106,91,48,229,58
14874,76,58,7,29,20,2,11,28,7,12,18,0,4,11,3,16,2
14877,246,179,7,94,63,15,57,95,18,9,67,9,25,16,17,53,14
14878,278,242,28,93,102,19,79,149,1,13,36,2,17,9,8,29,7
14879,817,600,90,271,210,29,164,286,100,50,217,36,60,91,30,178,39
14880,621,474,68,233,140,33,157,242,44,31,147,24,32,52,39,103,44
14881,107,38,11,20,7,0,25,7,6,0,69,20,26,7,16,69,0
14882,1472,1016,164,517,285,50,335,472,153,56,456,153,148,116,39,345,111
14883,1505,1122,183,602,294,43,359,497,182,84,383,74,158,80,71,297,86
14884,134,95,9,47,36,3,27,56,4,8,39,10,8,14,7,25,14
14885,272,196,37,96,52,11,78,81,25,12,76,16,18,23,19,61,15
14886,2563,1805,293,1009,403,100,672,760,296,77,758,106,255,202,195,594,164
14889,557,390,68,203,102,17,121,189,54,26,167,19,66,49,33,135,32
14891,1834,1190,188,589,334,79,385,514,198,93,644,90,193,189,172,550,94
14892,3297,2188,444,1089,510,145,756,913,337,182,1109,208,259,320,322,924,185
14894,587,432,81,193,125,33,148,206,45,33,155,14,61,49,31,117,38
14895,4183,2653,544,1154,744,211,856,1284,312,201,1530,244,379,522,385,1292,238
14897,326,248,49,113,60,26,73,114,37,24,78,8,36,11,23,66,12
14898,508,389,98,169,94,28,150,164,42,33,119,22,35,38,24,97,22
14901,6158,3609,887,1683,753,286,945,1291,932,441,2549,530,818,686,515,2157,392
14903,3227,2026,314,1012,562,138,718,887,247,174,1201,188,376,263,374,1022,179
14904,6866,4369,1025,1952,1016,376,1238,1605,1061,465,2497,411,927,682,477,2100,397
14905,4033,2519,439,1210,632,238,783,1157,359,220,1514,274,383,443,414,1293,221
15001,14045,9876,1459,4316,3171,930,2873,4715,1141,1147,4169,459,1195,1345,1170,3800,369
15003,5791,3505,671,1434,926,474,905,1678,466,456,2286,382,545,595,764,2034,252
15004,116,79,22,25,26,6,22,31,16,10,37,6,3,0,28,28,9
15005,3786,2744,305,1341,876,222,841,1555,167,181,1042,126,264,333,319,956,86
15006,143,103,0,49,37,17,38,28,0,37,40,6,27,7,0,34,6
15007,134,86,0,60,18,8,39,28,12,7,48,9,14,13,12,39,9
15009,6079,4181,377,2099,1292,413,1410,2219,294,258,1898,209,508,509,672,1775,123
15010,11535,7916,1259,3647,2401,609,2381,3768,933,834,3619,565,989,1083,982,3213,406
15012,6963,4945,780,2067,1540,558,1495,2568,422,460,2018,228,454,690,646,1837,181
15014,1517,929,157,432,240,100,259,442,117,111,588,140,107,145,196,520,68
15015,497,396,30,192,155,19,108,257,6,25,101,13,47,28,13,83,18
15017,6156,3622,711,1721,870,320,1228,1786,284,324,2534,606,710,534,684,2276,258
15018,271,168,30,48,56,34,27,109,11,21,103,0,13,45,45,93,10
15019,797,581,118,231,186,46,187,277,73,44,216,16,88,42,70,180,36
15020,144,123,21,64,38,0,39,69,8,7,21,0,15,6,0,16,5
15021,3039,2265,356,1084,650,175,751,1121,180,213,774,62,216,244,252,714,60
15022,5136,3211,533,1390,868,420,895,1593,324,399,1925,281,402,555,687,1736,189
15024,3415,2412,311,1171,668,262,699,1261,226,226,1003,102,309,349,243,902,101
15025,7189,4725,781,2258,1148,538,1345,2095,644,641,2464,389,709,730,636,2205,259
15026,1455,1127,175,549,325,78,440,563,50,74,328,42,126,103,57,294,34
15027,999,673,104,287,231,51,198,362,47,66,326,21,65,113,127,302,24
15028,65,44,6,21,9,8,13,25,6,0,21,3,7,5,6,16,5
15030,478,267,64,116,51,36,65,108,37,57,211,33,61,50,67,187,24
15031,223,140,20,56,44,20,69,38,13,20,83,0,33,24,26,83,0
15033,2466,1471,270,580,417,204,373,627,212,259,995,92,253,245,405,887,108
15034,954,575,96,253,170,56,178,298,28,71,379,61,93,111,114,347,32
15035,1113,667,94,315,156,102,164,310,89,104,446,68,125,125,128,422,24
15037,4677,3544,393,1602,1176,373,1108,1875,195,366,1133,142,284,413,294,1004,129
15038,130,83,6,41,23,13,11,35,13,24,47,13,0,10,24,47,0
15042,2877,2290,310,1352,512,116,968,947,153,222,587,91,185,210,101,499,88
15043,914,749,123,406,176,44,271,332,100,46,165,22,58,64,21,149,16
15044,8222,6495,791,3790,1519,395,3018,2805,354,318,1727,197,582,478,470,1542,185
15045,2159,1325,199,586,369,171,320,625,185,195,834,109,218,252,255,735,99
15046,838,628,128,273,180,47,233,308,52,35,210,23,57,80,50,180,30
15049,493,259,50,83,86,40,55,172,17,15,234,35,91,68,40,200,34
15050,905,715,116,388,176,35,274,302,68,71,190,26,51,58,55,157,33
15051,244,142,5,57,52,28,40,73,17,12,102,9,29,16,48,93,9
15052,1494,1176,192,598,300,86,399,563,133,81,318,12,99,105,102,278,40
15053,52,28,0,18,0,10,0,10,6,12,24,0,4,6,14,24,0
15054,209,139,22,83,16,18,27,73,20,19,70,12,19,27,12,65,5
15055,576,413,57,189,142,25,103,210,47,53,163,38,83,20,22,126,37
15056,568,337,51,151,90,45,86,150,52,49,231,24,53,80,74,219,12
15057,4245,3191,428,1562,912,289,1204,1505,206,276,1054,190,332,250,282,915,139
15059,2011,1293,276,510,363,144,359,521,204,209,718,98,134,271,215,655,63
15060,411,291,38,140,78,35,82,141,37,31,120,19,30,36,35,107,13
15061,5506,3888,625,1821,1108,334,1236,1929,419,304,1618,283,386,487,462,1415,203
15062,3916,2443,318,936,741,448,536,1249,337,321,1473,109,331,472,561,1347,126
15063,5100,3460,386,1558,1074,442,1012,1807,272,369,1640,192,449,477,522,1488,152
15064,127,74,15,20,24,15,8,29,9,28,53,17,11,5,20,44,9
15065,5200,3456,561,1501,1047,347,998,1699,344,415,1744,191,470,413,670,1588,156
15066,5719,3912,905,1776,971,260,1230,1741,586,355,1807,234,539,523,511,1586,221
15067,965,671,102,306,194,69,190,357,54,70,294,60,77,70,87,254,40
15068,17499,11518,1728,5379,3129,1282,3624,5336,1245,1313,5981,946,1610,1705,1720,5318,663
15071,3871,2641,439,1386,706,110,874,1305,270,192,1230,393,482,246,109,995,235
15072,42,42,8,23,6,5,14,22,0,6,0,0,0,0,0,0,0
15074,4048,2684,446,1272,755,211,821,1252,315,296,1364,245,344,423,352,1158,206
15075,74,62,13,21,14,14,10,38,6,8,12,0,0,7,5,12,0
15076,351,234,31,107,67,29,61,108,41,24,117,18,47,17,35,105,12
15078,215,122,40,56,18,8,41,42,16,23,93,13,18,42,20,93,0
15081,229,143,30,68,23,22,44,66,18,15,86,10,35,23,18,73,13
15082,140,114,18,72,14,10,66,48,0,0,26,10,0,8,8,26,0
15083,340,227,44,64,87,32,79,109,10,29,113,14,27,44,28,102,11
15084,4466,2929,458,1457,749,265,885,1358,330,356,1537,277,531,371,358,1308,229
15085,3334,2345,349,1112,636,248,798,1190,145,212,989,116,240,292,341,890,99
15086,115,97,9,75,13,0,45,52,0,0,18,9,0,0,9,9,9
15087,73,45,0,34,7,4,7,22,6,10,28,12,5,11,0,28,0
15088,253,160,36,67,47,10,38,57,32,33,93,7,43,24,19,82,11
15089,3108,2174,383,1047,538,206,675,987,265,247,934,86,233,314,301,847,87
15090,6243,4923,632,3147,995,149,2550,1898,252,223,1320,237,540,317,226,1132,188
15101,8758,6803,773,3540,2022,468,2702,3294,369,438,1955,478,570,556,351,1665,290
15102,12204,8796,953,4361,2795,687,3303,4276,511,706,3408,555,900,1088,865,3093,315
15104,4738,3006,713,1247,654,392,540,842,916,708,1732,199,476,633,424,1596,136
15106,8692,5120,757,2212,1507,644,1350,2477,632,661,3572,682,991,925,974,3140,432
15108,14896,9958,1521,5059,2683,695,3677,4669,780,832,4938,1138,1644,1249,907,4266,672
15110,3182,1888,559,711,431,187,297,611,651,329,1294,155,395,323,421,1177,117
15112,1658,929,201,417,217,94,242,365,179,143,729,151,221,190,167,679,50
15116,5813,4420,529,2050,1390,451,1635,2235,170,380,1393,232,361,429,371,1272,121
15120,8913,5379,857,2351,1516,655,1428,2231,830,890,3534,527,801,1166,1040,3164,370
15122,9208,6229,998,2672,1789,770,1700,2952,798,779,2979,321,720,914,1024,2735,244
15126,2625,1866,382,1036,349,99,884,617,178,187,759,188,313,138,120,645,114
15129,4361,3192,521,1809,732,130,1278,1322,373,219,1169,354,462,219,134,986,183
15131,3985,2578,280,1067,889,342,630,1500,226,222,1407,173,352,410,472,1279,128
15132,10648,6438,1383,2681,1714,660,1464,2402,1509,1063,4210,544,1316,1227,1123,3693,517
15133,2897,1938,304,836,552,246,557,996,181,204,959,69,244,338,308,868,91
15135,2273,1674,256,767,461,190,575,878,109,112,599,50,176,189,184,560,39
15136,9511,6175,1134,2806,1599,636,1583,2606,976,1010,3336,464,1075,865,932,2938,398
15137,4808,3090,571,1250,904,365,696,1490,533,371,1718,266,566,468,418,1548,170
15139,3118,1720,241,753,520,206,550,756,142,272,1398,271,389,384,354,1240,158
15140,1671,907,197,440,185,85,272,325,139,171,764,134,240,220,170,661,103
15142,226,189,19,124,38,8,78,92,10,9,37,0,21,16,0,17,20
15143,6658,4721,497,2449,1402,373,1690,2374,326,331,1937,284,529,623,501,1745,192
15144,2030,1316,209,601,379,127,398,583,158,177,714,140,214,159,201,646,68
15145,3583,2024,382,934,535,173,538,872,282,332,1559,354,389,423,393,1379,180
15146,12403,8167,966,3970,2477,754,2528,3981,831,827,4236,1045,1118,1119,954,3785,451
15147,7819,5204,721,2324,1544,615,1438,2515,640,611,2615,342,737,760,776,2359,256
15148,1384,733,155,306,168,104,199,262,117,155,651,142,171,156,182,598,53
15201,6481,3444,680,1366,922,476,768,1359,604,713,3037,480,916,859,782,2628,409
15202,10053,5155,1126,2397,1176,456,1568,2239,695,653,4898,1500,1355,1134,909,4267,631
15203,4967,1921,324,725,584,288,370,903,198,450,3046,1257,771,578,440,2353,693
15204,3811,2586,512,1171,650,253,598,1071,515,402,1225,174,361,395,295,1096,129
15205,10041,5774,1266,2747,1324,437,1766,2442,881,685,4267,1267,1280,929,791,3657,610
15206,14980,7662,1818,3371,1715,758,1533,2658,1945,1526,7318,2126,2425,1772,995,6405,913
15207,5625,3438,545,1515,906,472,902,1341,543,652,2187,316,631,714,526,1914,273
15208,5519,3377,777,1493,819,288,582,854,1136,805,2142,299,684,661,498,1937,205
15209,5465,3507,550,1657,981,319,1155,1582,360,410,1958,418,644,463,433,1651,307
15210,12626,8000,1690,3625,1902,783,2076,2766,1674,1484,4626,861,1379,1276,1110,3951,675
15211,5979,2801,523,1199,782,297,628,1280,338,555,3178,1186,876,650,466,2383,795
15212,14084,7804,1742,3623,1730,709,1871,2702,1766,1465,6280,1284,1846,1804,1346,5378,902
15213,10585,2829,839,909,627,454,465,1320,413,631,7756,4807,1122,1010,817,5341,2415
15214,6773,4475,1061,1940,1128,346,1023,1498,1229,725,2298,353,827,643,475,1931,367
15215,5647,3428,535,1619,992,282,1233,1458,341,396,2219,398,720,529,572,1986,233
15216,10981,6325,1176,2970,1587,592,2062,2816,645,802,4656,1427,1329,997,903,4009,647
15217,12041,6363,961,2903,1805,694,2136,3192,375,660,5678,2272,1451,841,1114,4412,1266
15218,7196,3838,713,1749,952,424,885,1669,663,621,3358,801,1303,708,546,2896,462
15219,6662,3092,971,1227,565,329,320,649,1316,807,3570,673,867,1243,787,3160,410
15220,8930,5133,1076,2087,1390,580,1586,2646,364,537,3797,1177,1086,927,607,3221,576
15221,16879,9201,1819,3950,2424,1008,1970,3599,2010,1622,7678,1529,2679,2086,1384,6786,892
15222,790,102,18,45,14,25,7,64,19,12,688,129,166,267,126,606,82
15223,3549,2074,304,953,605,212,644,866,309,255,1475,306,475,387,307,1309,166
15224,5683,2811,659,1105,788,259,485,983,705,638,2872,958,793,672,449,2397,475
15225,644,305,59,129,75,42,79,130,51,45,339,65,120,89,65,302,37
15226,6184,3954,721,1735,995,503,1083,1890,424,557,2230,461,581,626,562,1927,303
15227,12998,8232,1077,3909,2332,914,2390,3858,978,1006,4766,1193,1305,1265,1003,4243,523
15228,7262,4723,650,2604,1130,339,2039,1996,362,326,2539,610,799,655,475,2324,215
15229,5743,3693,634,1697,976,386,1255,1615,414,409,2050,464,591,522,473,1763,287
15232,6620,1837,684,592,378,183,524,1021,146,146,4783,3054,959,545,225,3635,1148
15233,1468,655,147,313,157,38,60,246,195,154,813,229,251,271,62,635,178
15234,6385,4162,636,1670,1347,509,1291,2051,269,551,2223,573,722,491,437,1953,270
15235,16493,11181,1615,4942,3356,1268,3026,5407,1168,1580,5312,612,1668,1814,1218,4695,617
15236,12509,8861,1126,4012,2709,1014,2932,4527,550,852,3648,438,948,1146,1116,3352,296
15237,17286,11775,1510,5892,3419,954,4509,5917,574,775,5511,1169,1513,1460,1369,4866,645
15238,5254,3862,196,2042,1269,355,1518,1860,193,291,1392,171,466,436,319,1239,153
15239,7941,6136,1064,2933,1800,339,2342,2825,491,478,1805,458,601,441,305,1516,289
15241,7294,6015,468,3263,1688,596,2706,2835,241,233,1279,85,244,502,448,1175,104
15243,5270,3863,450,1792,1181,440,1440,1941,209,273,1407,77,382,456,492,1320,87
15301,20148,13233,2305,6109,3667,1152,4026,6346,1486,1375,6915,958,1939,2221,1797,6081,834
15310,160,115,19,51,28,17,37,58,14,6,45,2,10,24,9,39,6
15311,509,405,54,218,115,18,172,193,17,23,104,23,23,45,13,81,23
15312,1407,1081,147,554,273,107,360,536,77,108,326,54,99,100,73,277,49
15313,149,107,13,55,33,6,36,60,6,5,42,0,16,20,6,40,2
15314,1599,1093,250,436,273,134,302,495,163,133,506,47,141,155,163,447,59
15315,302,208,45,86,47,30,52,107,22,27,94,3,22,31,38,88,6
15316,163,129,17,67,39,6,29,81,10,9,34,12,8,9,5,30,4
15317,12390,9222,1071,4665,2726,760,3384,4623,514,701,3168,612,865,943,748,2810,358
15320,2110,1443,273,710,312,148,533,627,122,161,667,77,170,202,218,576,91
15321,663,519,98,289,99,33,204,219,48,48,144,24,61,18,41,131,13
15322,913,668,123,301,164,80,176,340,58,94,245,14,66,75,90,223,22
15323,1769,1396,239,683,364,110,521,663,112,100,373,31,107,132,103,342,31
15324,313,202,38,83,66,15,57,94,29,22,111,12,20,32,47,103,8
15325,308,204,15,103,77,9,36,107,51,10,104,0,36,29,39,84,20
15327,626,417,97,184,93,43,127,211,51,28,209,33,60,67,49,186,23
15329,724,597,87,283,193,34,230,276,30,61,127,25,63,23,16,105,22
15330,1886,1503,164,815,448,76,516,788,67,132,383,22,145,117,99,332,51
15331,485,290,47,146,59,38,92,135,19,44,195,12,49,69,65,180,15
15332,3056,2194,291,985,672,246,688,1213,111,182,862,128,308,264,162,771,91
15333,912,673,107,279,200,87,213,357,50,53,239,20,27,77,115,236,3
15334,78,67,4,32,23,8,18,37,3,9,11,0,6,0,5,9,2
15337,325,253,42,136,55,20,86,140,20,7,72,10,25,21,16,69,3
15338,674,496,90,230,111,65,170,234,53,39,178,8,46,68,56,170,8
15340,570,437,47,236,104,50,164,240,13,20,133,7,33,39,54,127,6
15341,370,289,48,149,73,19,121,132,13,23,81,11,25,28,17,76,5
15342,2163,1398,158,646,440,154,427,664,143,164,765,131,177,213,244,664,101
15344,542,401,49,190,108,54,124,220,32,25,141,12,31,70,28,134,7
15345,729,520,92,270,128,30,185,226,60,49,209,29,46,72,62,184,25
15346,326,208,35,89,67,17,52,128,11,17,118,17,12,63,26,115,3
15347,9,9,0,9,0,0,0,0,0,9,0,0,0,0,0,0,0
15348,122,87,10,36,34,7,40,32,8,7,35,0,5,20,10,35,0
15349,803,610,114,296,164,36,204,319,35,52,193,19,59,73,42,164,29
15350,282,206,17,72,102,15,46,123,21,16,76,0,25,27,24,60,16
15351,367,259,78,111,49,21,87,96,49,27,108,16,29,31,32,108,0
15352,340,241,59,105,58,19,93,94,33,21,99,8,28,52,11,83,16
15353,50,41,7,23,9,2,15,17,5,4,9,3,2,2,2,9,0
15357,618,455,73,195,119,68,169,228,25,33,163,22,46,47,48,147,16
15358,360,212,42,64,82,24,70,108,6,28,148,21,27,61,39,144,4
15359,78,57,4,33,16,4,16,27,8,6,21,2,8,5,6,21,0
15360,716,562,81,306,133,42,221,259,26,56,154,30,52,56,16,124,30
15361,77,64,20,22,5,17,11,17,26,10,13,0,0,8,5,13,0
15362,254,197,43,90,51,13,80,91,16,10,57,9,17,17,14,49,8
15363,340,199,51,79,50,19,29,93,43,34,141,0,31,44,66,131,10
15364,253,196,37,92,50,17,69,90,14,23,57,6,20,14,17,46,11
15367,1783,1445,167,973,260,45,806,441,94,104,338,36,138,111,53,303,35
15368,202,161,45,80,26,10,71,72,7,11,41,4,5,23,9,37,4
15370,5162,3464,674,1648,920,222,1189,1485,451,339,1698,357,501,413,427,1441,257
15376,661,508,93,262,122,31,198,230,43,37,153,22,53,44,34,133,20
15377,301,248,41,119,71,17,86,121,20,21,53,10,16,19,8,44,9
15378,76,66,17,24,18,7,21,39,0,6,10,0,5,0,5,10,0
15379,58,38,4,18,12,4,12,24,2,0,20,0,4,5,11,15,5
15380,347,270,65,129,65,11,94,106,32,38,77,3,24,30,20,69,8
15401,15042,9927,1772,4507,2684,964,2677,4318,1465,1467,5115,606,1328,1731,1450,4705,410
15410,465,342,44,118,127,53,72,185,28,57,123,9,31,38,45,117,6
15411,303,201,22,84,71,24,47,132,12,10,102,8,24,39,31,94,8
15412,121,97,9,48,36,4,26,54,5,12,24,0,11,4,9,20,4
15413,164,125,28,42,47,8,25,48,24,28,39,0,8,22,9,31,8
15417,3874,2616,446,1282,607,281,750,1139,380,347,1258,126,282,473,377,1118,140
15419,1515,619,96,254,183,86,104,352,81,82,896,422,121,188,165,601,295
15420,55,29,11,9,0,9,11,18,0,0,26,0,0,17,9,26,0
15422,130,88,17,40,8,23,25,32,17,14,42,0,7,26,9,31,11
15423,816,602,88,292,184,38,221,333,8,40,214,19,54,84,57,195,19
15424,985,654,128,266,207,53,202,328,54,70,331,47,78,114,92,295,36
15425,9157,6303,1147,2903,1729,524,1731,2962,972,638,2854,435,687,972,760,2543,311
15427,459,349,25,177,109,38,83,163,33,70,110,16,14,42,38,110,0
15428,763,566,96,237,184,49,167,297,54,48,197,16,67,57,57,180,17
15429,34,24,5,0,19,0,0,19,5,0,10,0,5,0,5,5,5
15430,133,106,32,39,28,7,39,40,27,0,27,0,16,0,11,27,0
15431,2195,1529,233,771,374,151,548,663,113,205,666,81,211,209,165,575,91
15432,166,104,14,44,34,12,24,50,10,20,62,4,22,23,13,60,2
15433,445,296,45,129,80,42,84,152,53,7,149,13,30,62,44,114,35
15434,155,106,14,39,38,15,26,42,18,20,49,8,10,14,17,47,2
15436,1279,841,211,405,174,51,301,366,74,100,438,52,125,125,136,402,36
15437,942,698,159,307,205,27,213,391,53,41,244,88,63,47,46,170,74
15438,957,691,75,364,161,91,194,369,52,76,266,26,89,59,92,254,12
15440,112,87,11,57,19,0,37,37,13,0,25,0,0,17,8,25,0
15442,1120,797,105,352,256,84,208,428,49,112,323,22,73,107,121,291,32
15443,141,111,37,52,22,0,53,38,11,9,30,0,21,0,9,30,0
15444,251,158,50,71,37,0,59,58,12,29,93,0,22,33,38,93,0
15445,1411,970,172,400,309,89,251,497,123,99,441,53,144,125,119,430,11
15446,75,40,0,18,22,0,0,27,0,13,35,0,6,8,21,29,6
15447,27,27,0,11,16,0,0,16,11,0,0,0,0,0,0,0,0
15448,82,50,13,12,25,0,0,30,13,7,32,8,7,17,0,32,0
15450,129,104,20,54,22,8,40,50,14,0,25,0,8,9,8,25,0
15451,371,281,68,128,66,19,108,137,19,17,90,19,8,40,23,80,10
15454,61,32,0,18,14,0,10,8,8,6,29,12,0,9,8,29,0
15455,121,57,7,27,23,0,7,41,0,9,64,6,6,14,38,64,0
15456,1037,761,208,316,196,41,242,346,72,101,276,32,81,58,105,225,51
15458,1035,739,114,348,241,36,244,325,94,76,296,38,75,88,95,265,31
15459,634,490,103,229,126,32,170,220,63,37,144,21,39,43,41,112,32
15460,55,37,3,20,10,4,5,26,1,5,18,0,3,9,6,17,1
15461,1838,1297,240,548,301,208,346,573,176,202,541,26,140,144,231,488,53
15462,172,122,41,49,16,16,43,59,11,9,50,0,10,31,9,50,0
15464,567,447,94,203,119,31,157,240,19,31,120,18,28,52,22,106,14
15466,229,165,28,71,43,23,49,66,12,38,64,9,7,24,24,57,7
15468,1272,877,190,373,243,71,284,344,112,137,395,58,66,178,93,375,20
15469,1009,776,176,382,169,49,353,309,55,59,233,34,69,83,47,202,31
15470,479,343,44,173,103,23,117,202,13,11,136,15,50,26,45,132,4
15472,165,76,22,41,7,6,11,32,14,19,89,0,25,26,38,67,22
15473,1548,1078,138,496,349,95,335,583,71,89,470,52,114,165,139,434,36
15474,1052,744,178,316,182,68,205,347,105,87,308,37,88,93,90,290,18
15475,659,365,48,167,107,43,139,147,38,41,294,22,45,98,129,276,18
15476,109,61,10,38,0,13,25,19,10,7,48,0,0,31,17,48,0
15477,421,266,23,116,95,32,61,148,26,31,155,33,29,42,51,147,8
15478,2481,1791,261,924,466,140,625,927,120,119,690,103,217,214,156,584,106
15479,799,601,73,259,197,72,209,284,25,83,198,32,40,59,67,182,16
15480,926,707,104,376,184,43,218,320,87,82,219,22,70,62,65,174,45
15482,355,229,35,75,100,19,62,119,21,27,126,16,20,41,49,114,12
15483,301,184,31,73,56,24,38,107,14,25,117,14,42,27,34,104,13
15484,35,13,0,13,0,0,13,0,0,0,22,5,0,9,8,13,9
15485,57,36,13,17,6,0,12,18,2,4,21,2,9,4,6,16,5
15486,1090,814,124,382,254,54,294,417,45,58,276,37,98,89,52,238,38
15489,139,86,16,43,27,0,35,36,0,15,53,0,16,28,9,44,9
15490,402,336,102,143,70,21,125,191,10,10,66,11,24,21,10,55,11
15492,27,19,4,10,5,0,4,15,0,0,8,0,0,8,0,8,0
15501,6929,4686,935,2159,1202,390,1550,2378,516,242,2243,350,625,696,572,1996,247
15520,103,70,0,50,20,0,10,41,10,9,33,0,10,16,7,33,0
15521,662,517,118,219,149,31,210,243,39,25,145,15,55,37,38,130,15
15522,5064,3464,505,1621,993,345,1030,1891,330,213,1600,233,443,476,448,1418,182
15530,1976,1461,295,708,363,95,609,646,82,124,515,96,109,161,149,457,58
15531,1666,1182,220,506,340,116,363,593,132,94,484,78,162,119,125,432,52
15532,30,19,3,6,10,0,5,12,0,2,11,0,0,5,6,11,0
15533,536,389,82,154,117,36,119,187,52,31,147,29,36,57,25,125,22
15534,385,308,63,121,84,40,102,167,18,21,77,8,20,23,26,73,4
15535,854,678,115,314,208,41,273,335,29,41,176,18,45,71,42,150,26
15536,177,128,24,55,41,8,43,65,12,8,49,5,20,18,6,45,4
15537,3410,2512,494,1079,722,217,788,1298,220,206,898,103,232,341,222,811,87
15538,309,227,34,91,75,27,77,129,8,13,82,9,19,30,24,80,2
15539,207,141,34,63,25,19,60,39,26,16,66,34,4,23,5,64,2
15540,113,88,9,48,21,10,33,44,5,6,25,0,8,13,4,25,0
15541,1520,1124,218,537,273,96,483,527,76,38,396,79,98,123,96,352,44
15542,517,437,72,214,129,22,156,211,38,32,80,13,13,34,20,74,6
15544,96,82,19,44,10,9,30,41,0,11,14,0,0,0,14,14,0
15545,1170,855,146,373,261,75,284,441,73,57,315,29,47,144,95,284,31
15546,168,110,30,20,50,10,20,50,10,30,58,9,0,13,36,45,13
15547,113,82,11,36,35,0,20,50,2,10,31,3,12,6,10,29,2
15550,714,512,88,234,158,32,173,261,40,38,202,26,67,70,39,167,35
15551,313,257,41,110,92,14,90,139,15,13,56,10,11,15,20,52,4
15552,2380,1780,351,780,499,150,607,880,176,117,600,86,129,194,191,549,51
15553,70,50,7,17,20,6,14,32,2,2,20,6,8,4,2,18,2
15554,1020,773,143,359,218,53,256,419,46,52,247,42,92,53,60,206,41
15557,1523,1120,205,471,356,88,378,586,92,64,403,74,101,123,105,359,44
15558,920,671,124,294,175,78,257,303,42,69,249,28,49,89,83,224,25
15559,696,530,74,233,180,43,142,328,28,32,166,9,64,54,39,141,25
15560,111,62,2,29,24,7,18,31,5,8,49,11,15,12,11,38,11
15562,60,46,10,21,11,4,22,20,0,4,14,0,0,8,6,14,0
15563,1419,1064,155,512,316,81,369,528,51,116,355,50,85,149,71,295,60
15601,23388,15385,2512,7328,4136,1409,5166,7593,1308,1318,8003,1493,2336,2241,1933,7024,979
15610,995,743,108,397,207,31,298,371,35,39,252,6,106,117,23,221,31
15611,100,79,8,37,30,4,43,24,8,4,21,4,4,13,0,19,2
15612,204,171,32,78,54,7,59,85,0,27,33,0,21,12,0,27,6
15613,5946,4442,588,2184,1367,303,1502,2241,305,394,1504,180,461,501,362,1307,197
15615,83,67,0,20,41,6,17,46,0,4,16,0,7,5,4,16,0
15617,175,117,20,55,34,8,44,56,7,10,58,9,10,20,19,54,4
15618,676,503,66,226,148,63,155,271,30,47,173,23,36,46,68,162,11
15620,286,208,41,79,72,16,60,93,16,39,78,15,8,30,25,78,0
15622,558,368,98,109,139,22,136,183,18,31,190,40,61,44,45,168,22
15623,349,270,16,148,75,31,106,127,7,30,79,7,8,44,20,66,13
15624,232,172,24,64,67,17,49,89,8,26,60,12,10,30,8,60,0
15625,16,16,0,16,0,0,16,0,0,0,0,0,0,0,0,0,0
15626,2112,1424,194,653,443,134,432,764,109,119,688,88,157,270,173,647,41
15627,2833,2064,402,970,508,184,687,920,210,247,769,90,184,262,233,701,68
15628,285,223,87,61,60,15,98,95,25,5,62,5,28,29,0,57,5
15629,339,208,52,80,53,23,65,65,47,31,131,8,39,43,41,125,6
15631,430,310,54,119,87,50,81,148,29,52,120,12,25,48,35,114,6
15632,3204,2251,233,1204,647,167,897,991,220,143,953,134,340,244,235,832,121
15633,179,115,17,56,14,28,33,45,7,30,64,12,0,28,24,64,0
15634,194,139,38,65,30,6,63,52,13,11,55,0,20,29,6,41,14
15635,90,62,30,18,14,0,23,26,7,6,28,0,5,6,17,28,0
15636,950,789,137,478,115,59,442,284,41,22,161,4,59,65,33,155,6
15637,982,672,104,285,221,62,183,362,60,67,310,45,72,79,114,281,29
15639,884,682,159,260,203,60,221,305,94,62,202,47,40,56,59,151,51
15640,105,82,7,41,23,11,35,35,0,12,23,5,4,10,4,23,0
15641,202,157,19,71,45,22,47,79,23,8,45,10,17,7,11,41,4
15642,17382,13271,1706,6669,3974,922,4586,6767,928,990,4111,686,1199,1300,926,3709,402
15644,8218,5649,952,2621,1488,588,1773,2732,595,549,2569,352,629,826,762,2335,234
15646,151,107,6,69,23,9,44,48,4,11,44,4,10,14,16,39,5
15647,46,39,6,33,0,0,7,13,19,0,7,7,0,0,0,0,7
15650,11262,7654,1060,3537,2238,819,2409,3915,597,733,3608,479,973,1152,1004,3242,366
15655,237,138,22,81,23,12,37,88,12,1,99,19,21,20,39,74,25
15656,4151,2935,435,1306,895,299,856,1571,238,270,1216,123,323,339,431,1098,118
15658,3915,2756,335,1232,894,295,845,1597,156,158,1159,162,287,411,299,1067,92
15660,144,85,22,30,26,7,25,55,5,0,59,0,5,37,17,59,0
15661,255,208,43,77,65,23,69,93,17,29,47,5,14,13,15,47,0
15662,70,62,8,31,16,7,23,28,0,11,8,4,4,0,0,4,4
15663,237,180,25,92,49,14,43,113,12,12,57,11,11,21,14,44,13
15665,537,402,88,206,83,25,187,156,25,34,135,25,32,37,41,132,3
15666,6748,4757,813,2175,1351,418,1449,2565,363,380,1991,245,515,647,584,1864,127
15668,4800,3935,280,2112,1282,261,1528,2049,118,240,865,122,231,349,163,781,84
15670,1577,1250,166,605,403,76,430,648,81,91,327,58,89,114,66,275,52
15671,373,323,46,122,112,43,81,179,41,22,50,0,14,10,26,50,0
15672,1433,888,136,482,217,53,264,432,69,123,545,111,201,122,111,486,59
15673,577,422,62,207,110,43,132,191,52,47,155,17,26,61,51,141,14
15674,196,126,5,72,36,13,36,55,13,22,70,4,16,21,29,63,7
15675,561,427,102,199,100,26,204,135,37,51,134,30,37,41,26,110,24
15676,275,158,23,63,61,11,40,93,0,25,117,25,56,12,24,83,34
15677,229,174,9,96,59,10,51,99,9,15,55,0,23,28,4,36,19
15678,153,85,0,32,25,28,21,52,0,12,68,9,16,35,8,59,9
15679,1241,911,132,439,285,55,309,466,50,86,330,52,74,120,84,268,62
15680,113,81,13,44,19,5,25,34,7,15,32,4,2,19,7,28,4
15681,1897,1321,216,582,382,141,418,623,137,143,576,64,126,205,181,515,61
15683,3380,2327,417,994,709,207,760,1043,254,270,1053,134,242,349,328,965,88
15684,338,237,56,129,40,12,88,93,34,22,101,5,47,37,12,90,11
15685,197,152,10,90,29,23,75,52,9,16,45,0,18,19,8,45,0
15686,486,386,41,180,138,27,139,224,15,8,100,19,26,31,24,90,10
15687,610,429,63,199,132,35,109,257,33,30,181,41,37,49,54,149,32
15688,316,175,30,63,67,15,41,118,5,11,141,33,22,76,10,141,0
15689,109,85,40,23,22,0,12,47,26,0,24,8,0,0,16,16,8
15690,4052,2646,544,1135,709,258,794,1312,283,257,1406,157,334,426,489,1222,184
15692,295,219,46,104,26,43,82,92,33,12,76,10,24,30,12,72,4
15693,176,140,27,76,11,26,56,62,13,9,36,0,14,13,9,36,0
15695,152,96,20,0,43,33,20,58,0,18,56,7,21,16,12,56,0
15696,197,126,25,58,28,15,45,56,9,16,71,4,19,38,10,60,11
15697,1579,980,187,373,287,133,290,508,66,116,599,120,205,146,128,537,62
15698,313,235,34,126,52,23,86,88,39,22,78,14,7,11,46,78,0
15701,12857,6992,1081,3292,2031,588,2125,3621,585,661,5865,2705,1199,1082,879,4010,1855
15710,121,98,27,38,20,13,47,25,4,22,23,0,0,13,10,23,0
15711,176,124,20,41,52,11,26,73,9,16,52,8,15,8,21,49,3
15712,38,33,6,17,10,0,10,10,11,2,5,0,0,2,3,5,0
15713,147,128,34,59,24,11,56,58,8,6,19,0,6,13,0,19,0
15714,2423,1723,311,732,459,221,534,805,164,220,700,106,158,200,236,627,73
15715,274,198,37,84,59,18,52,98,26,22,76,15,26,18,17,71,5
15716,110,68,5,36,12,15,12,33,8,15,42,9,4,20,9,42,0
15717,4625,3173,508,1462,926,277,989,1562,276,346,1452,203,430,438,381,1307,145
15721,108,81,8,39,21,13,29,40,7,5,27,4,4,10,9,18,9
15722,1161,868,111,426,231,100,306,386,69,107,293,34,71,88,100,267,26
15723,25,21,0,11,5,5,8,13,0,0,4,0,4,0,0,4,0
15724,1022,785,118,390,229,48,274,349,77,85,237,28,56,94,59,198,39
15725,719,467,90,252,97,28,170,222,47,28,252,47,53,92,60,210,42
15728,1508,1096,246,486,267,97,384,500,104,108,412,71,88,91,162,361,51
15729,573,447,82,219,95,51,151,225,39,32,126,25,31,46,24,101,25
15730,58,39,10,20,5,4,15,17,1,6,19,3,2,6,8,16,3
15731,126,78,12,42,19,5,12,49,5,12,48,8,16,10,14,48,0
15732,658,491,102,242,111,36,185,227,43,36,167,27,69,47,24,129,38
15733,47,29,5,6,16,2,5,16,1,7,18,2,0,6,10,18,0
15734,134,88,30,24,22,12,37,34,11,6,46,12,16,18,0,43,3
15736,158,110,15,58,27,10,24,59,19,8,48,13,15,4,16,48,0
15739,209,126,33,57,22,14,58,39,12,17,83,10,14,23,36,78,5
15741,100,74,13,44,15,2,21,38,7,8,26,6,5,11,4,26,0
15742,387,282,43,129,96,14,95,142,27,18,105,7,32,21,45,88,17
15744,56,31,5,13,11,2,13,16,0,2,25,3,7,8,7,22,3
15745,134,78,11,38,22,7,35,25,0,18,56,4,22,13,17,51,5
15747,877,699,159,341,176,23,304,312,59,24,178,9,66,39,64,157,21
15748,2896,2083,360,980,528,215,680,1043,167,193,813,127,193,251,242,724,89
15752,44,26,7,7,6,6,9,11,0,6,18,2,7,6,3,18,0
15753,189,146,29,60,55,2,42,69,21,14,43,7,14,16,6,34,9
15754,201,147,5,96,38,8,49,48,31,19,54,0,5,21,28,54,0
15756,71,42,7,23,12,0,15,20,5,2,29,2,6,12,9,27,2
15757,682,503,73,236,150,44,209,226,25,43,179,22,46,75,36,165,14
15759,1028,767,134,395,195,43,319,339,52,57,261,48,56,99,58,231,30
15760,47,40,0,29,11,0,3,24,8,5,7,3,0,0,4,7,0
15761,53,38,4,17,9,8,13,9,3,13,15,0,5,7,3,15,0
15762,251,206,27,108,54,17,85,105,6,10,45,6,2,19,18,42,3
15763,7,6,0,4,2,0,2,2,0,2,1,0,0,0,1,1,0
15764,63,54,6,16,22,10,9,39,2,4,9,1,0,4,4,8,1
15765,593,488,91,247,113,37,168,257,35,28,105,13,36,44,12,99,6
15767,5754,3955,662,1932,979,382,1394,1778,427,356,1799,276,498,517,508,1600,199
15770,130,110,15,42,43,10,38,54,9,9,20,0,11,2,7,17,3
15771,366,288,47,121,94,26,105,149,20,14,78,6,16,28,28,76,2
15772,635,447,66,205,132,44,132,218,47,50,188,7,46,73,62,163,25
15773,178,141,15,65,37,24,42,69,4,26,37,0,18,5,14,35,2
15774,1198,961,148,478,280,55,336,497,64,64,237,42,86,73,36,202,35
15775,545,386,50,179,99,58,118,198,35,35,159,17,29,43,70,148,11
15776,25,17,2,13,2,0,6,9,2,0,8,0,3,3,2,8,0
15777,44,39,10,9,13,7,9,16,0,14,5,0,0,5,0,5,0
15778,68,55,13,19,19,4,15,29,5,6,13,0,6,3,4,13,0
15779,51,30,7,23,0,0,17,13,0,0,21,4,0,7,10,21,0
15780,60,40,11,13,9,7,12,24,4,0,20,0,2,4,14,20,0
15781,85,52,12,19,14,7,17,26,3,6,33,0,13,15,5,27,6
15783,40,31,11,16,2,2,16,8,6,1,9,0,2,2,5,9,0
15784,31,28,5,13,6,4,8,16,4,0,3,3,0,0,0,0,3
15801,8334,5633,966,2573,1619,475,1835,2824,559,415,2701,572,690,676,763,2324,377
15821,79,55,8,24,21,2,17,28,4,6,24,3,10,7,4,22,2
15823,656,456,68,228,125,35,147,237,45,27,200,33,61,79,27,179,21
15824,2120,1530,263,727,418,122,488,744,168,130,590,59,162,176,193,548,42
15825,3962,2742,473,1322,737,210,881,1399,292,170,1220,175,305,337,403,1088,132
15827,273,172,29,87,49,7,71,71,15,15,101,2,28,39,32,91,10
15828,119,100,12,53,26,9,28,54,7,11,19,0,5,12,2,14,5
15829,497,376,76,174,100,26,143,166,45,22,121,17,38,39,27,106,15
15832,186,121,12,54,44,11,45,64,8,4,65,5,29,24,7,58,7
15834,2177,1436,226,580,456,174,439,705,156,136,741,108,201,202,230,659,82
15840,802,573,103,260,152,58,202,307,35,29,229,33,81,59,56,196,33
15841,82,54,18,11,20,5,19,25,5,5,28,6,4,4,14,26,2
15845,1562,1036,178,482,288,88,342,465,139,90,526,77,135,156,158,484,42
15846,1510,1129,226,529,312,62,438,491,86,114,381,52,133,94,102,317,64
15847,103,75,22,22,29,2,29,37,7,2,28,6,3,14,5,18,10
15848,366,274,35,154,72,13,102,131,22,19,92,13,22,23,34,83,9
15849,625,427,91,193,123,20,147,196,43,41,198,15,46,89,48,169,29
15851,2577,1903,364,843,538,158,678,872,178,175,674,80,193,210,191,630,44
15853,3011,2005,335,988,553,129,676,944,197,188,1006,141,281,312,272,869,137
15856,325,247,30,151,56,10,100,117,16,14,78,17,27,19,15,66,12
15857,5740,4023,622,1944,1108,349,1513,1771,349,390,1717,282,398,507,530,1535,182
15860,477,337,48,142,120,27,112,182,18,25,140,11,49,46,34,120,20
15861,80,59,9,21,25,4,10,32,10,7,21,0,3,10,8,21,0
15863,140,110,32,46,20,12,38,55,14,3,30,6,11,9,4,28,2
15864,704,559,91,295,134,39,227,253,32,47,145,13,43,49,40,135,10
15865,588,373,71,153,104,45,118,163,53,39,215,20,51,76,68,191,24
15866,79,61,6,26,21,8,22,26,5,8,18,2,4,10,2,16,2
15868,427,287,45,108,101,33,78,170,11,28,140,9,43,48,40,117,23
15870,593,406,62,192,129,23,156,208,20,22,187,25,64,47,51,169,18
15901,2755,1197,312,383,327,175,176,444,316,261,1558,142,384,491,541,1462,96
15902,5786,3524,719,1516,1002,287,874,1529,617,504,2262,346,668,668,580,1976,286
15904,6673,4482,578,1838,1406,660,1278,2578,244,382,2191,248,590,635,718,2016,175
15905,9532,6425,851,2853,1989,732,2130,3360,358,577,3107,425,845,967,870,2861,246
15906,5319,3424,662,1284,978,500,776,1625,523,500,1895,293,481,578,543,1753,142
15909,2727,1956,295,871,585,205,546,967,219,224,771,103,165,241,262,685,86
15920,358,266,56,123,64,23,74,123,34,35,92,16,30,29,17,76,16
15923,715,511,93,221,166,31,157,218,71,65,204,11,39,88,66,184,20
15924,481,354,73,155,76,50,122,174,34,24,127,20,22,46,39,105,22
15925,48,32,14,5,8,5,14,8,5,5,16,0,0,12,4,16,0
15926,1171,799,152,335,227,85,243,418,61,77,372,29,70,140,133,346,26
15927,492,325,58,118,85,64,85,161,37,42,167,4,24,53,86,147,20
15928,702,552,70,201,204,77,160,335,21,36,150,14,44,29,63,131,19
15929,23,21,4,9,8,0,8,9,2,2,2,0,2,0,0,2,0
15930,69,34,0,20,14,0,20,14,0,0,35,0,9,7,19,35,0
15931,3403,2458,369,1154,708,227,877,1164,184,233,945,116,302,226,301,840,105
15934,92,76,14,27,35,0,20,41,15,0,16,9,0,0,7,16,0
15935,1239,973,86,545,219,123,308,478,55,132,266,23,43,123,77,257,9
15936,657,452,73,218,109,52,153,222,30,47,205,10,44,73,78,198,7
15937,294,216,22,86,72,36,33,97,42,44,78,0,9,34,35,78,0
15938,1037,752,131,316,235,70,261,345,48,98,285,32,61,89,103,266,19
15940,573,431,69,219,107,36,189,184,28,30,142,25,54,29,34,122,20
15942,832,648,69,291,230,58,208,351,32,57,184,13,66,66,39,176,8
15943,2070,1416,248,644,393,131,469,663,136,148,654,65,111,219,259,608,46
15944,1412,1087,158,496,361,72,329,579,96,83,325,36,108,101,80,293,32
15946,2840,1973,262,937,540,234,615,959,134,265,867,84,213,304,266,785,82
15948,237,174,33,71,28,42,66,86,22,0,63,4,9,14,36,63,0
15949,198,150,19,70,43,18,39,81,10,20,48,2,8,16,22,44,4
15952,570,479,75,193,187,24,135,247,41,56,91,8,31,8,44,91,0
15954,1100,812,133,352,260,67,243,463,52,54,288,21,68,116,83,264,24
15955,1368,1009,236,465,235,73,368,445,91,105,359,43,80,157,79,336,23
15956,1354,926,164,498,202,62,297,392,96,141,428,60,95,132,141,413,15
15957,140,103,5,57,22,19,44,41,0,18,37,2,0,27,8,37,0
15958,860,656,82,332,187,55,247,309,59,41,204,21,32,77,74,184,20
15961,235,185,45,101,26,13,81,84,4,16,50,4,11,21,14,44,6
15963,4909,3355,455,1568,969,363,990,1686,315,364,1554,141,339,499,575,1444,110
16001,17683,11310,2126,5228,3021,935,3588,5271,1374,1077,6373,1142,1695,1768,1768,5719,654
16002,5758,4542,613,2486,1168,275,1760,2175,267,340,1216,224,338,427,227,989,227
16020,368,274,41,125,83,25,78,142,21,33,94,24,27,21,22,77,17
16022,199,160,29,74,48,9,68,66,19,7,39,8,10,15,6,27,12
16023,1534,1106,184,521,262,139,400,564,62,80,428,31,119,86,192,376,52
16024,156,132,30,49,37,16,50,55,10,17,24,5,3,6,10,21,3
16025,2072,1558,239,778,433,108,588,787,93,90,514,81,137,177,119,473,41
16027,200,170,37,85,38,10,88,65,9,8,30,6,8,9,7,22,8
16028,921,619,99,281,177,62,205,316,56,42,302,18,70,111,103,295,7
16029,301,195,46,85,38,26,70,103,10,12,106,24,31,26,25,100,6
16030,141,112,34,54,24,0,30,51,23,8,29,8,5,9,7,26,3
16033,2193,1662,262,864,441,95,625,816,120,101,531,121,152,139,119,425,106
16034,675,509,98,261,128,22,206,230,34,39,166,25,59,45,37,145,21
16035,37,24,2,22,0,0,4,18,2,0,13,0,6,0,7,11,2
16036,136,99,16,42,33,8,39,46,11,3,37,7,14,14,2,34,3
16037,1729,1318,166,684,409,59,487,632,83,116,411,110,143,128,30,348,63
16038,1258,940,172,453,260,55,308,492,82,58,318,63,93,99,63,276,42
16040,393,294,42,156,71,25,116,119,40,19,99,19,29,32,19,77,22
16041,789,626,113,302,164,47,201,311,69,45,163,17,57,41,48,136,27
16045,612,357,70,167,88,32,107,157,63,30,255,38,54,40,123,236,19
16046,3497,2703,511,1585,465,142,1360,1085,135,123,794,218,232,202,142,667,127
16049,1265,923,157,439,250,77,312,454,77,80,342,40,96,106,100,294,48
16050,593,457,79,232,127,19,176,214,37,30,136,13,41,52,30,111,25
16051,1322,957,174,440,266,77,293,487,116,61,365,53,130,131,51,318,47
16052,860,661,137,347,142,35,252,286,83,40,199,37,70,54,38,177,22
16053,1273,964,124,507,260,73,403,451,43,67,309,21,175,67,46,274,35
16054,193,136,34,48,40,14,37,63,21,15,57,6,27,4,20,49,8
16055,2904,2311,325,1209,658,119,852,1191,149,119,593,64,249,179,101,478,115
16056,1901,1296,246,650,314,86,484,567,131,114,605,90,178,195,142,540,65
16057,4024,2506,428,1217,663,198,864,1270,195,177,1518,784,365,230,139,854,664
16059,2536,1980,235,982,625,138,786,933,120,141,556,31,215,217,93,486,70
16061,895,710,112,366,203,29,275,363,44,28,185,45,56,54,30,157,28
16063,2981,1786,247,944,397,198,633,907,182,64,1195,215,282,271,427,1044,151
16066,8399,6574,1282,4019,1016,257,3294,2581,418,281,1825,382,576,473,394,1534,291
16101,14423,9806,1808,4142,2745,1111,2737,4354,1438,1277,4617,606,1201,1397,1413,4184,433
16102,2423,1782,308,842,484,148,605,782,228,167,641,50,176,185,230,568,73
16105,6290,4451,565,1865,1438,583,1442,2483,140,386,1839,155,355,564,765,1730,109
16110,118,87,9,40,24,14,22,55,5,5,31,2,11,9,9,26,5
16111,355,290,92,128,68,2,133,119,24,14,65,11,15,29,10,58,7
16112,707,506,93,191,143,79,128,258,55,65,201,30,61,34,76,184,17
16113,186,161,13,95,42,11,58,87,4,12,25,2,8,10,5,23,2
16114,229,171,31,95,38,7,72,87,5,7,58,11,14,23,10,46,12
16115,1348,992,92,491,328,81,327,519,74,72,356,53,129,111,63,323,33
16116,1484,1050,168,530,298,54,366,508,87,89,434,44,91,160,139,381,53
16117,7195,5084,885,2299,1310,590,1668,2455,512,449,2111,235,511,734,631,1921,190
16120,867,682,124,321,198,39,296,301,45,40,185,37,49,67,32,153,32
16121,2539,1655,372,576,420,287,313,560,464,318,884,82,236,326,240,811,73
16123,824,647,114,306,193,34,248,320,37,42,177,25,54,41,57,151,26
16124,787,627,117,255,198,57,211,338,43,35,160,25,47,64,24,120,40
16125,7371,5192,763,2408,1493,528,1696,2634,487,375,2179,326,548,760,545,1919,260
16127,5205,3593,592,1685,998,318,1239,1808,279,267,1612,335,409,392,476,1412,200
16130,787,596,89,250,206,51,182,342,29,43,191,27,50,67,47,168,23
16131,339,266,62,114,75,15,94,111,36,25,73,5,31,17,20,58,15
16132,137,98,36,32,14,16,36,42,20,0,39,0,5,11,23,39,0
16133,596,474,91,220,123,40,174,241,29,30,122,9,41,35,37,102,20
16134,1597,1145,191,484,385,85,337,639,94,75,452,54,96,175,127,383,69
16136,387,267,46,92,87,42,65,130,20,52,120,9,28,44,39,113,7
16137,4668,3375,593,1622,928,232,1191,1611,300,273,1293,214,446,402,231,1088,205
16140,76,59,9,31,19,0,31,24,0,4,17,0,5,6,6,17,0
16141,732,525,92,270,115,48,192,216,60,57,207,21,88,71,27,180,27
16142,1848,1328,220,617,362,129,551,624,67,86,520,160,113,118,129,443,77
16143,1211,903,145,426,278,54,303,463,68,69,308,53,99,89,67,282,26
16145,1075,808,140,375,216,77,266,413,79,50,267,50,72,85,60,225,42
16146,6857,4249,900,1856,1083,410,1137,1728,816,568,2608,481,810,590,727,2314,294
16148,5813,3848,525,1608,1200,515,1102,2003,424,319,1965,260,506,649,550,1807,158
16150,3781,2707,399,1224,759,325,896,1311,224,276,1074,125,361,284,304,948,126
16151,66,49,3,25,16,5,17,19,7,6,17,6,0,2,9,15,2
16153,1003,715,148,304,214,49,268,355,45,47,288,32,65,95,96,255,33
16154,1186,840,142,489,144,65,315,338,126,61,346,54,114,117,61,302,44
16155,5,5,0,0,5,0,0,5,0,0,0,0,0,0,0,0,0
16156,1157,918,130,448,252,88,353,447,44,74,239,30,85,75,49,207,32
16157,1392,985,138,458,316,73,305,504,86,90,407,34,133,116,124,352,55
16159,2508,1914,269,901,598,146,684,895,165,170,594,96,195,134,169,520,74
16160,411,293,40,132,90,31,76,157,23,37,118,10,33,37,38,103,15
16161,327,193,25,71,86,11,45,94,17,37,134,20,38,47,29,125,9
16201,7447,5105,945,2367,1375,418,1684,2529,525,367,2342,269,703,769,601,2039,303
16210,425,336,61,119,122,34,114,185,23,14,89,5,14,53,17,82,7
16212,190,116,9,42,48,17,29,73,2,12,74,6,12,17,39,66,8
16213,86,50,9,25,11,5,20,21,2,7,36,3,7,12,14,32,4
16214,3769,1909,455,792,501,161,594,851,240,224,1860,900,375,363,222,1216,644
16217,75,46,7,19,15,5,14,24,3,5,29,0,10,13,6,26,3
16218,424,337,68,156,81,32,117,158,47,15,87,8,40,23,16,73,14
16222,847,634,99,283,191,61,199,324,64,47,213,24,69,71,49,195,18
16223,40,32,2,18,10,2,13,19,0,0,8,0,0,4,4,6,2
16224,441,342,57,155,103,27,127,182,18,15,99,15,25,32,27,87,12
16226,3742,2552,405,1127,706,314,695,1220,321,316,1190,117,282,321,470,1084,106
16228,176,134,32,51,27,24,42,54,18,20,42,8,5,14,15,38,4
16229,2064,1514,218,809,362,125,546,762,93,113,550,86,125,168,171,518,32
16230,223,172,48,61,48,15,45,82,27,18,51,3,8,30,10,48,3
16232,1822,1323,254,605,381,83,443,643,148,89,499,73,155,151,120,435,64
16233,527,358,74,166,99,19,130,173,22,33,169,18,52,60,39,150,19
16234,23,17,4,3,10,0,1,16,0,0,6,0,0,4,2,4,2
16235,445,315,42,127,124,22,109,179,9,18,130,10,51,46,23,116,14
16236,114,69,38,16,15,0,10,24,28,7,45,0,23,16,6,45,0
16238,180,109,25,55,13,16,52,44,9,4,71,18,25,22,6,60,11
16239,587,382,18,195,152,17,103,221,26,32,205,15,56,99,35,187,18
16240,615,462,77,229,125,31,179,232,25,26,153,21,48,48,36,127,26
16242,2046,1426,256,631,400,139,483,729,97,117,620,71,143,189,217,556,64
16244,145,103,34,35,21,13,51,35,6,11,42,6,16,7,13,39,3
16245,96,69,10,29,25,5,20,32,9,8,27,2,8,13,4,22,5
16246,101,84,24,28,21,11,28,38,12,6,17,3,6,6,2,17,0
16248,1451,1047,237,445,273,92,357,498,120,72,404,40,101,143,120,371,33
16249,806,601,82,300,156,63,174,323,69,35,205,24,61,52,68,177,28
16250,142,92,17,47,25,3,40,28,21,3,50,12,7,21,10,43,7
16253,34,28,6,5,15,2,7,11,4,6,6,0,3,3,0,6,0
16254,1331,948,160,429,282,77,317,487,77,67,383,76,133,125,49,318,65
16255,727,552,101,242,169,40,177,275,50,50,175,18,36,75,46,151,24
16256,478,401,120,181,82,18,223,145,15,18,77,5,27,32,13,66,11
16258,690,464,79,234,126,25,150,210,44,60,226,39,73,71,43,183,43
16259,804,597,120,286,149,42,208,282,57,50,207,19,51,84,53,184,23
16260,123,83,14,39,27,3,18,45,13,7,40,2,17,15,6,38,2
16262,1143,840,139,387,262,52,279,436,73,52,303,39,105,76,83,249,54
16263,169,110,17,50,19,24,31,59,10,10,59,0,17,25,17,51,8
16301,7285,4826,885,2291,1273,377,1473,2154,785,414,2459,344,698,746,671,2157,302
16311,226,168,32,83,49,4,64,85,13,6,58,2,24,24,8,52,6
16313,808,591,115,245,176,55,173,304,57,57,217,27,86,62,42,188,29
16314,2144,1676,287,853,436,100,616,833,107,120,468,62,132,148,126,407,61
16316,2422,1586,256,694,484,152,479,843,143,121,836,151,310,224,151,688,148
16317,584,459,72,210,157,20,130,261,49,19,125,26,30,43,26,91,34
16319,423,337,58,122,125,32,96,198,27,16,86,5,23,23,35,80,6
16321,62,44,13,21,8,2,15,15,8,6,18,0,4,9,5,14,4
16322,37,22,3,8,11,0,3,17,2,0,15,2,5,4,4,11,4
16323,6850,4709,827,2217,1364,301,1401,2260,627,421,2141,311,532,755,543,1896,245
16326,201,162,24,72,58,8,56,96,2,8,39,10,5,11,13,35,4
16327,1137,874,182,398,249,45,307,431,83,53,263,42,78,83,60,220,43
16329,133,92,24,38,30,0,25,39,15,13,41,13,16,5,7,26,15
16331,129,105,13,52,30,10,35,60,6,4,24,2,4,12,6,24,0
16332,63,41,6,23,4,8,9,27,5,0,22,7,3,5,7,15,7
16333,174,115,23,38,43,11,42,59,5,9,59,3,21,21,14,55,4
16334,193,156,30,62,58,6,62,72,14,8,37,8,8,11,10,29,8
16335,11624,7333,1436,3308,1883,706,2201,3528,1025,579,4291,860,1230,1192,1009,3600,691
16340,894,661,92,306,221,42,217,357,46,41,233,23,88,78,44,203,30
16341,822,607,81,262,219,45,187,346,45,29,215,33,67,63,52,177,38
16342,817,584,95,295,160,34,187,296,51,50,233,21,94,75,43,197,36
16343,177,144,37,70,29,8,68,21,15,40,33,0,24,9,0,23,10
16344,193,135,30,46,38,21,27,73,17,18,58,0,15,24,19,54,4
16345,1465,1110,146,579,311,74,410,581,60,59,355,65,105,106,79,289,66
16346,1350,932,206,457,196,73,331,455,100,46,418,47,171,113,87,384,34
16347,1016,668,114,271,222,61,207,315,86,60,348,36,114,109,89,288,60
16350,1015,792,133,394,213,52,284,354,78,76,223,28,83,56,56,201,22
16351,781,539,56,235,211,37,150,287,48,54,242,19,66,103,54,215,27
16352,115,80,2,43,31,4,27,46,4,3,35,2,12,12,9,28,7
16353,1362,933,140,388,337,68,295,512,68,58,429,40,96,157,136,384,45
16354,4867,3272,610,1505,909,248,1100,1502,403,267,1595,265,368,523,439,1407,188
16360,531,434,70,195,135,34,154,216,35,29,97,21,24,30,22,77,20
16361,26,23,7,4,6,6,4,16,3,0,3,0,1,2,0,3,0
16362,377,293,53,160,74,6,108,126,40,19,84,22,15,39,8,74,10
16364,381,287,40,137,91,19,100,145,22,20,94,22,27,28,17,80,14
16365,8319,5291,901,2551,1477,362,1729,2599,613,350,3028,520,922,845,741,2642,386
16370,74,58,9,16,29,4,19,27,3,9,16,0,5,5,6,15,1
16371,1386,966,151,442,286,87,305,452,119,90,420,57,97,143,123,369,51
16372,225,153,47,60,31,15,53,58,34,8,72,16,10,18,28,67,5
16373,1366,1021,162,438,321,100,341,529,88,63,345,46,111,97,91,291,54
16374,676,487,64,216,172,35,150,263,41,33,189,23,66,72,28,170,19
16401,1678,1204,252,561,321,70,412,546,152,94,474,72,145,148,109,407,67
16402,289,234,45,115,62,12,99,95,27,13,55,5,26,12,12,47,8
16403,2248,1643,303,866,396,78,604,792,142,105,605,117,188,180,120,496,109
16404,1179,907,192,388,262,65,379,409,68,51,272,39,80,95,58,234,38
16405,255,186,36,91,45,14,60,101,16,9,69,7,22,28,12,56,13
16406,1333,968,183,473,253,59,337,429,100,102,365,35,100,144,86,310,55
16407,4449,3217,649,1490,802,276,1125,1458,377,257,1232,236,360,324,312,1091,141
16410,608,503,94,250,134,25,204,242,33,24,105,13,36,39,17,79,26
16411,524,393,88,204,85,16,162,161,53,17,131,10,34,60,27,125,6
16412,4180,2460,510,1266,552,132,930,1062,274,194,1720,981,438,176,125,996,724
16415,2774,2251,242,1267,599,143,935,1041,168,107,523,93,168,155,107,443,80
16416,104,79,18,48,13,0,38,28,11,2,25,3,6,14,2,25,0
16417,3220,2392,480,1186,627,99,939,923,280,250,828,127,300,224,177,712,116
16420,277,210,29,103,59,19,74,104,12,20,67,10,23,23,11,54,13
16421,934,744,82,431,170,61,321,339,47,37,190,17,31,43,99,162,28
16422,21,16,4,4,6,2,6,8,0,2,5,3,0,0,2,5,0
16423,1552,1152,261,548,286,57,415,499,169,69,400,67,124,141,68,333,67
16424,2077,1452,201,643,474,134,415,772,131,134,625,58,185,223,159,522,103
16426,1466,1131,154,621,287,69,429,451,128,123,335,78,131,101,25,249,86
16427,99,75,15,38,22,0,28,29,13,5,24,6,2,11,5,16,8
16428,4858,3550,647,1803,864,236,1389,1567,346,248,1308,223,347,414,324,1181,127
16433,1956,1459,297,668,388,106,503,707,149,100,497,87,160,167,83,421,76
16434,847,665,177,304,157,27,326,256,61,22,182,22,55,52,53,164,18
16435,792,603,132,312,131,28,229,240,83,51,189,44,59,45,41,148,41
16436,228,170,31,88,39,12,79,66,16,9,58,6,27,16,9,50,8
16438,3091,2333,512,1119,584,118,827,982,308,216,758,98,245,219,196,654,104
16440,332,240,50,120,58,12,108,96,24,12,92,14,47,15,16,73,19
16441,3237,2535,437,1413,532,153,977,1072,309,177,702,88,278,257,79,613,89
16442,1039,848,131,510,179,28,361,363,78,46,191,35,68,40,48,153,38
16443,557,429,51,260,104,14,133,205,70,21,128,12,53,25,38,90,38
16501,1271,142,29,53,52,8,12,58,49,23,1129,223,157,386,363,1056,73
16502,7120,3922,1206,1750,741,225,1139,1207,970,606,3198,1035,1014,670,479,2604,594
16503,6487,4188,1524,1672,756,236,838,1010,1704,636,2299,509,912,544,334,1841,458
16504,6551,4304,851,1937,1038,478,1438,1751,521,594,2247,352,649,583,663,1926,321
16505,7770,4804,666,2364,1267,507,1574,2370,500,360,2966,377,850,904,835,2634,332
16506,9052,6377,968,3175,1731,503,2435,3107,443,392,2675,486,775,814,600,2354,321
16507,4099,2117,660,966,341,150,631,512,624,350,1982,637,719,395,231,1628,354
16508,6681,4317,936,1903,1037,441,1384,1920,516,497,2364,569,614,581,600,2017,347
16509,10829,7247,1257,3160,2131,699,2395,3812,557,483,3582,792,1131,830,829,3113,469
16510,9187,6848,1299,3276,1854,419,2379,3060,831,578,2339,564,684,749,342,1938,401
16511,4511,3154,628,1375,871,280,907,1446,499,302,1357,139,390,392,436,1206,151
16601,13576,8889,1804,3989,2465,631,2749,3939,1219,982,4687,921,1377,1359,1030,3970,717
16602,12903,8375,1528,3775,2334,738,2416,3810,1144,1005,4528,732,1266,1312,1218,3918,610
16611,1056,812,127,436,213,36,277,394,77,64,244,32,76,76,60,218,26
16613,594,466,87,243,98,38,201,197,47,21,128,12,43,36,37,117,11
16616,53,33,7,13,9,4,11,18,2,2,20,0,3,6,11,20,0
16617,1269,921,150,423,264,84,299,434,66,122,348,42,77,96,133,314,34
16619,113,77,18,38,14,7,24,38,10,5,36,2,4,16,14,34,2
16620,169,131,26,68,35,2,47,61,17,6,38,12,6,12,8,32,6
16621,270,220,51,88,74,7,76,110,28,6,50,4,13,24,9,43,7
16622,76,56,12,24,16,4,21,31,0,4,20,6,6,6,2,20,0
16623,165,131,26,46,46,13,35,79,10,7,34,7,3,13,11,33,1
16624,46,30,7,13,8,2,12,14,4,0,16,0,2,6,8,16,0
16625,1513,1093,275,471,281,66,302,497,178,116,420,82,95,113,130,358,62
16627,829,561,80,259,173,49,172,299,32,58,268,39,66,91,72,238,30
16630,1958,1253,219,590,345,99,425,480,161,187,705,140,215,149,201,626,79
16631,64,60,26,16,18,0,26,14,16,4,4,0,0,0,4,4,0
16633,43,31,8,14,9,0,14,13,4,0,12,3,0,5,4,11,1
16634,75,54,11,24,15,4,24,20,4,6,21,0,4,11,6,17,4
16635,4914,3611,524,1734,1044,309,1195,1816,308,292,1303,170,382,491,260,1178,125
16636,333,254,40,107,82,25,87,135,4,28,79,9,23,25,22,77,2
16637,819,546,117,268,124,37,197,197,83,69,273,49,93,101,30,217,56
16638,41,31,15,9,4,3,13,16,0,2,10,0,0,0,10,10,0
16639,604,433,93,194,107,39,108,215,50,60,171,17,32,62,60,150,21
16640,306,239,33,108,71,27,90,116,11,22,67,14,14,30,9,48,19
16641,1114,764,121,399,199,45,296,288,75,105,350,40,96,91,123,311,39
16645,58,48,8,23,8,9,22,18,2,6,10,0,3,7,0,7,3
16646,1014,739,118,316,205,100,229,353,75,82,275,39,50,57,129,249,26
16647,270,207,39,96,54,18,72,108,13,14,63,4,23,27,9,55,8
16648,6094,4309,603,2163,1186,357,1467,2124,414,304,1785,279,455,598,453,1633,152
16650,690,465,96,210,131,28,182,207,35,41,225,41,55,78,51,202,23
16651,1465,1040,209,426,304,101,335,486,110,109,425,35,76,152,162,403,22
16652,5730,3808,692,1719,1103,294,1218,1924,371,295,1922,304,556,542,520,1667,255
16655,591,442,93,206,114,29,169,214,29,30,149,23,38,38,50,135,14
16656,509,400,74,218,83,25,162,178,28,32,109,11,23,43,32,97,12
16657,535,389,50,161,160,18,120,227,17,25,146,5,53,44,44,128,18
16659,130,107,28,44,28,7,38,50,8,11,23,4,2,6,11,21,2
16661,438,300,47,140,72,41,106,129,28,37,138,6,25,44,63,117,21
16662,2168,1519,274,704,388,153,560,730,106,123,649,86,113,186,264,601,48
16663,71,50,5,18,17,10,15,22,4,9,21,5,0,14,2,18,3
16664,675,562,139,252,134,37,244,264,22,32,113,8,48,34,23,104,9
16665,105,68,20,27,21,0,24,30,12,2,37,5,11,13,8,35,2
16666,1296,882,170,348,280,84,246,434,100,102,414,39,135,113,127,344,70
16667,521,416,85,174,146,11,155,206,28,27,105,16,21,32,36,92,13
16668,1529,1046,158,482,316,90,332,518,83,113,483,48,119,144,172,446,37
16669,868,651,130,315,166,40,240,327,35,49,217,27,67,86,37,187,30
16670,79,48,5,26,15,2,17,27,0,4,31,10,0,8,13,23,8
16671,218,159,27,70,39,23,50,76,7,26,59,7,5,20,27,52,7
16672,46,36,8,21,5,2,11,13,7,5,10,0,0,6,4,8,2
16673,2017,1512,274,675,433,130,494,774,149,95,505,120,111,148,126,442,63
16674,299,222,40,94,67,21,58,125,32,7,77,9,27,29,12,68,9
16677,108,88,8,15,58,7,18,53,0,17,20,0,0,15,5,12,8
16678,1279,903,201,379,260,63,286,408,111,98,376,63,85,96,132,343,33
16679,459,350,51,157,112,30,117,155,29,49,109,19,19,41,30,100,9
16680,209,146,19,68,44,15,51,66,13,16,63,3,19,9,32,59,4
16681,76,54,13,10,23,8,21,23,0,10,22,0,9,6,7,22,0
16682,52,46,7,12,27,0,7,17,12,10,6,0,0,0,6,6,0
16683,222,164,29,78,46,11,54,87,6,17,58,16,26,9,7,47,11
16685,121,90,22,32,32,4,35,45,7,3,31,3,5,15,8,29,2
16686,5317,3766,649,1749,1091,277,1202,1754,485,325,1551,268,408,463,412,1389,162
16689,178,145,28,66,41,10,51,78,8,8,33,4,5,14,10,31,2
16691,136,91,10,41,30,10,36,53,2,0,45,4,20,8,13,44,1
16692,317,233,43,105,63,22,91,98,14,30,84,10,19,27,28,77,7
16693,1656,1204,249,534,318,103,419,594,102,89,452,73,124,109,146,402,50
16694,56,47,9,22,14,2,18,27,2,0,9,0,5,4,0,9,0
16695,397,326,61,142,86,37,125,167,15,19,71,4,13,34,20,69,2
16701,7519,4868,1050,2096,1303,419,1573,2106,749,440,2651,473,711,843,624,2282,369
16720,556,401,79,193,107,22,127,191,56,27,155,21,57,55,22,128,27
16724,90,52,13,24,8,7,18,17,12,5,38,5,15,7,11,30,8
16725,103,69,4,17,37,11,21,42,0,6,34,0,22,12,0,18,16
16726,183,151,20,79,37,15,55,64,23,9,32,6,12,7,7,22,10
16727,90,74,22,36,10,6,47,23,0,4,16,0,10,6,0,16,0
16729,401,279,61,120,81,17,80,142,38,19,122,22,37,30,33,111,11
16730,114,83,2,48,18,15,29,40,8,6,31,4,15,0,12,26,5
16731,1191,841,147,384,241,69,269,434,96,42,350,67,73,126,84,313,37
16732,171,119,20,74,15,10,55,48,13,3,52,12,0,30,10,45,7
16733,152,106,12,63,27,4,41,53,7,5,46,7,10,18,11,40,6
16734,116,86,19,36,27,4,31,40,10,5,30,8,6,13,3,20,10
16735,2834,1823,332,823,499,169,546,900,232,145,1011,189,214,305,303,893,118
16738,514,364,48,170,122,24,109,194,32,29,150,22,41,48,39,133,17
16740,537,376,102,151,87,36,113,170,71,22,161,23,51,45,42,152,9
16743,1763,1211,214,591,299,107,422,541,169,79,552,99,125,197,131,465,87
16744,106,87,11,29,36,11,25,54,8,0,19,0,7,0,12,15,4
16745,212,172,24,90,35,23,59,67,27,19,40,2,14,13,11,38,2
16746,531,387,83,155,122,27,135,180,43,29,144,25,46,37,36,126,18
16748,1224,868,175,374,245,74,335,414,63,56,356,46,88,114,108,310,46
16749,1573,1105,163,513,341,88,368,568,108,61,468,78,110,151,129,407,61
16750,178,140,18,67,45,10,53,63,14,10,38,2,18,12,6,30,8
16751,38,24,0,16,4,4,7,17,0,0,14,0,4,6,4,14,0
16801,15933,5918,1330,2653,1356,579,2048,3069,478,323,10015,7295,1148,877,695,5131,4884
16802,0,0,0,0,0,0,0,0,0,0,0,0,0,0,0,0,0
16803,8264,4380,1046,2137,1021,176,1683,2098,296,303,3884,2547,704,419,214,2240,1644
16820,397,296,52,138,84,22,85,169,25,17,101,16,38,26,21,81,20
16822,811,606,115,290,177,24,177,326,57,46,205,22,50,69,64,176,29
16823,8413,5816,1370,2643,1517,286,2094,2849,521,352,2597,569,788,748,492,2199,398
16825,105,94,20,55,15,4,23,56,10,5,11,0,4,4,3,11,0
16826,366,263,59,124,59,21,87,137,21,18,103,7,42,22,32,86,17
16827,1525,1169,135,683,293,58,474,521,119,55,356,57,126,109,64,300,56
16828,1507,1057,169,488,302,98,264,652,87,54,450,78,146,146,80,364,86
16829,266,203,27,92,62,22,65,92,12,34,63,6,17,19,21,57,6
16830,6128,3944,841,1737,1013,353,1250,1923,454,317,2184,307,581,759,537,1931,253
16832,153,112,22,49,31,10,40,50,7,15,41,13,18,7,3,26,15
16833,2150,1569,276,758,423,112,510,741,155,163,581,100,127,153,201,528,53
16834,122,92,19,48,25,0,36,33,12,11,30,4,4,18,4,24,6
16836,533,406,74,204,101,27,144,194,36,32,127,11,34,49,33,104,23
16837,75,69,0,29,35,5,17,26,5,21,6,0,0,6,0,6,0
16838,745,546,105,250,132,59,185,268,34,59,199,23,44,80,52,167,32
16839,207,171,39,83,39,10,70,76,14,11,36,4,5,8,19,36,0
16840,202,145,28,31,60,26,20,86,22,17,57,7,7,16,27,43,14
16841,1739,1338,224,625,389,100,436,705,83,114,401,57,119,152,73,336,65
16843,184,98,28,14,50,6,29,49,12,8,86,8,23,41,14,63,23
16844,1036,807,153,437,185,32,287,390,79,51,229,40,59,94,36,186,43
16845,295,190,42,71,57,20,67,88,14,21,105,2,42,34,27,94,11
16847,162,142,22,55,48,17,55,64,16,7,20,0,0,8,12,19,1
16848,179,127,33,50,28,16,33,62,23,9,52,10,13,11,18,48,4
16849,247,171,43,81,27,20,61,85,17,8,76,2,40,4,30,69,7
16851,289,244,45,139,52,8,102,105,30,7,45,7,38,0,0,32,13
16852,85,60,22,24,8,6,40,20,0,0,25,3,4,9,9,23,2
16853,467,332,75,138,104,15,100,148,48,36,135,25,58,29,23,107,28
16854,355,236,59,90,63,24,79,107,30,20,119,16,37,31,35,102,17
16855,138,99,25,26,42,6,24,57,4,14,39,9,7,18,5,32,7
16856,22,19,3,4,4,8,4,15,0,0,3,0,0,0,3,3,0
16858,1496,1085,222,500,277,86,350,539,113,83,411,56,112,162,81,345,66
16859,213,172,46,69,49,8,35,95,18,24,41,5,13,11,12,37,4
16860,117,84,14,45,25,0,36,42,6,0,33,0,21,7,5,25,8
16861,121,90,14,32,36,8,18,62,8,2,31,2,16,6,7,30,1
16863,334,243,38,126,61,18,92,130,5,16,91,13,29,27,22,71,20
16864,23,21,2,7,12,0,4,10,5,2,2,0,0,2,0,2,0
16865,730,604,105,294,173,32,262,291,14,37,126,25,32,52,17,106,20
16866,3589,2346,530,1006,666,144,750,1156,242,198,1243,197,336,395,315,1112,131
16870,1821,1464,238,890,282,54,661,628,97,78,357,89,110,97,61,303,54
16871,35,26,5,3,16,2,0,16,3,7,9,0,0,4,5,9,0
16872,444,369,72,153,116,28,150,173,18,28,75,10,25,18,22,69,6
16874,534,405,70,195,114,26,146,204,26,29,129,14,39,48,28,116,13
16875,1305,1037,173,554,268,42,442,470,68,57,268,54,90,63,61,237,31
16876,120,83,14,37,30,2,34,47,2,0,37,8,7,11,11,31,6
16877,580,453,88,239,100,26,208,192,25,28,127,21,55,23,28,108,19
16878,978,757,136,389,188,44,277,359,57,64,221,24,66,93,38,176,45
16879,89,64,14,28,19,3,36,22,3,3,25,4,8,8,5,22,3
16881,797,635,96,311,203,25,210,328,61,36,162,15,47,63,37,142,20
16882,127,96,16,54,12,14,43,41,10,2,31,4,2,9,16,29,2
16901,4046,2805,462,1299,786,258,934,1436,280,155,1241,191,354,398,298,1073,168
16911,140,113,25,52,25,11,43,53,10,7,27,4,12,3,8,22,5
16912,723,448,91,187,127,43,133,207,73,35,275,40,48,87,100,251,24
16914,900,721,107,347,218,49,291,348,46,36,179,27,53,52,47,142,37
16915,2333,1639,309,728,443,159,601,780,147,111,694,124,194,218,158,607,87
16917,542,387,80,162,126,19,122,194,45,26,155,28,49,35,43,127,28
16918,63,44,6,18,16,4,6,27,7,4,19,2,8,9,0,19,0
16920,763,486,98,194,147,47,140,228,52,66,277,42,61,75,99,251,26
16921,282,180,11,78,78,13,43,112,15,10,102,7,37,33,25,79,23
16922,851,604,85,267,162,90,164,327,65,48,247,29,62,90,66,212,35
16923,523,379,52,175,127,25,123,185,46,25,144,17,35,54,38,128,16
16925,1305,992,179,446,301,66,323,498,104,67,313,36,117,97,63,279,34
16926,282,237,41,101,79,16,91,120,17,9,45,6,10,21,8,40,5
16927,269,203,54,95,48,6,93,84,16,10,66,6,18,23,19,64,2
16928,552,397,53,183,121,40,117,213,46,21,155,29,26,59,41,127,28
16929,862,655,113,286,208,48,186,334,87,48,207,34,65,51,57,170,37
16930,459,347,46,160,110,31,118,195,20,14,112,21,33,32,26,90,22
16932,252,205,41,100,54,10,74,108,16,7,47,9,9,18,11,36,11
16933,2444,1599,297,786,419,97,594,740,179,86,845,332,194,194,125,639,206
16935,477,367,55,162,129,21,122,184,43,18,110,15,36,31,28,86,24
16936,934,707,120,334,211,42,248,361,57,41,227,30,75,75,47,191,36
16937,47,41,5,18,15,3,14,26,0,1,6,0,0,6,0,6,0
16938,307,242,23,112,86,21,74,134,9,25,65,4,15,24,22,57,8
16939,115,74,15,27,21,11,14,37,17,6,41,7,6,12,16,32,9
16940,237,194,34,91,45,24,53,98,23,20,43,12,10,12,9,40,3
16941,26,26,4,17,5,0,12,14,0,0,0,0,0,0,0,0,0
16942,330,246,50,122,67,7,80,111,29,26,84,7,16,32,29,61,23
16943,212,166,21,72,59,14,40,94,23,9,46,4,10,13,19,40,6
16946,957,678,145,313,178,42,237,319,89,33,279,61,71,87,60,210,69
16947,1819,1233,194,602,339,98,389,610,149,85,586,89,139,160,198,495,91
16948,698,533,110,232,148,43,159,273,64,37,165,30,24,77,34,141,24
16950,1186,862,168,358,287,49,293,430,68,71,324,27,99,103,95,284,40
17002,252,207,42,86,68,11,88,104,4,11,45,6,10,18,11,43,2
17003,3603,2630,460,1315,686,169,1007,1303,172,148,973,206,328,257,182,792,181
17004,1552,1195,253,482,321,139,528,545,39,83,357,59,67,109,122,339,18
17005,137,99,18,36,41,4,30,61,0,8,38,4,10,13,11,33,5
17006,432,327,49,147,97,34,115,172,16,24,105,13,13,37,42,97,8
17007,1989,1642,237,820,499,86,561,887,95,99,347,37,191,46,73,315,32
17009,848,580,124,278,144,34,216,301,40,23,268,55,62,84,67,253,15
17010,95,78,27,41,10,0,22,50,6,0,17,0,8,0,9,17,0
17011,13515,8852,1307,3871,2754,920,2773,4752,752,575,4663,841,1360,1243,1219,4077,586
17013,20447,13834,2530,6685,3611,1008,4726,6667,1451,990,6613,1543,1919,1814,1337,5598,1015
17016,106,67,12,16,15,24,12,50,0,5,39,0,0,5,34,39,0
17017,645,501,108,209,139,45,141,286,36,38,144,15,61,38,30,117,27
17018,1557,1194,100,700,323,71,394,599,107,94,363,48,147,96,72,287,76
17019,5826,4457,745,2403,1169,140,1856,2104,262,235,1369,299,494,355,221,1113,256
17020,3405,2502,480,1299,623,100,882,1229,221,170,903,133,319,242,209,767,136
17021,411,314,73,111,107,23,84,179,34,17,97,15,12,51,19,82,15
17022,9946,7152,1441,3481,1625,605,2633,3493,658,368,2794,738,684,538,834,2418,376
17023,1219,870,188,408,233,41,340,407,81,42,349,64,83,80,122,303,46
17024,652,515,79,279,135,22,191,261,39,24,137,18,42,54,23,123,14
17025,5652,3828,880,1815,899,234,1327,1711,478,312,1824,492,641,471,220,1443,381
17026,1041,782,136,385,228,33,318,339,50,75,259,41,84,76,58,192,67
17027,81,44,10,16,18,0,26,18,0,0,37,17,9,0,11,22,15
17028,1372,1029,172,592,194,71,400,415,137,77,343,45,158,109,31,303,40
17029,47,36,6,0,30,0,6,23,0,7,11,0,5,6,0,6,5
17032,2897,2253,403,1136,605,109,791,1129,195,138,644,89,233,172,150,542,102
17033,6310,3960,632,1725,1128,475,1375,1957,309,319,2350,612,547,555,636,2016,334
17034,1304,712,175,289,214,34,152,326,156,78,592,158,192,124,118,496,96
17035,311,245,47,124,66,8,95,118,21,11,66,10,22,20,14,52,14
17036,7360,5355,878,2716,1469,292,2024,2580,472,279,2005,527,785,401,292,1720,285
17037,376,292,71,119,88,14,104,151,22,15,84,13,26,20,25,78,6
17038,2451,1824,322,886,538,78,596,932,161,135,627,104,252,171,100,513,114
17040,880,684,130,354,163,37,238,359,52,35,196,36,56,64,40,159,37
17041,96,78,22,25,19,12,40,21,6,11,18,0,9,9,0,18,0
17042,13445,9190,1730,4228,2461,771,3103,4526,943,618,4255,646,1342,1155,1112,3670,585
17043,2723,1444,368,628,310,138,490,591,214,149,1279,366,429,267,217,1097,182
17044,9291,6146,1423,2449,1736,538,2007,2819,654,666,3145,514,752,1096,783,2772,373
17045,1194,875,171,408,246,50,290,467,63,55,319,49,84,105,81,273,46
17046,11113,7834,1813,3647,1907,467,2391,3360,1303,780,3279,507,1060,948,764,2790,489
17047,823,630,125,306,165,34,250,288,41,51,193,25,53,55,60,176,17
17048,1721,1179,243,481,365,90,364,625,121,69,542,69,137,172,164,463,79
17049,1200,892,178,379,250,85,315,462,62,53,308,54,80,59,115,269,39
17051,1761,1324,238,624,367,95,421,697,112,94,437,67,95,141,134,385,52
17052,625,476,111,194,133,38,164,235,42,35,149,17,51,48,33,135,14
17053,1925,1362,193,730,368,71,453,663,115,131,563,93,178,143,149,458,105
17055,22533,15795,2491,8250,4326,728,5975,7651,1300,869,6738,1785,2158,1519,1276,5741,997
17057,8640,5712,1110,2794,1406,402,1872,2561,790,489,2928,661,898,878,491,2498,430
17058,665,485,130,205,118,32,172,217,51,45,180,34,56,43,47,146,34
17059,2681,2004,389,876,608,131,725,1030,141,108,677,99,197,195,186,588,89
17060,447,356,105,162,75,14,150,149,34,23,91,19,4,43,25,85,6
17061,2773,1895,389,849,551,106,617,967,182,129,878,171,249,209,249,768,110
17062,1415,1057,207,536,257,57,401,521,69,66,358,38,114,105,101,297,61
17063,1361,985,173,447,305,60,334,477,87,87,376,60,92,153,71,326,50
17064,302,190,23,81,82,4,47,136,0,7,112,15,52,25,20,91,21
17065,1494,1086,240,502,256,88,393,472,141,80,408,94,139,107,68,332,76
17066,2349,1547,334,641,453,119,402,721,295,129,802,59,220,330,193,728,74
17067,4503,3324,631,1441,978,274,1198,1673,202,251,1179,171,254,403,351,1045,134
17068,1436,1075,261,535,241,38,405,463,124,83,361,82,121,97,61,310,51
17069,53,34,5,18,9,2,2,17,9,6,19,10,4,4,1,17,2
17070,6346,4016,769,2013,986,248,1263,1962,522,269,2330,526,818,594,392,1884,446
17072,44,44,10,34,0,0,17,9,10,8,0,0,0,0,0,0,0
17073,1601,1218,263,575,302,78,493,630,56,39,383,32,121,134,96,326,57
17074,2768,2038,430,954,542,112,655,920,261,202,730,95,257,208,170,628,102
17075,100,84,20,27,34,3,32,27,16,9,16,0,8,6,2,15,1
17076,31,31,0,21,10,0,12,10,0,9,0,0,0,0,0,0,0
17077,73,64,0,32,27,5,14,35,10,5,9,0,4,5,0,5,4
17078,7491,5093,873,2339,1405,476,1719,2700,386,288,2398,464,755,613,566,2096,302
17080,137,102,20,47,23,12,30,56,12,4,35,9,10,8,8,26,9
17081,57,22,0,8,14,0,0,15,0,7,35,8,0,18,9,35,0
17082,1148,865,173,417,223,52,317,428,82,38,283,43,72,101,67,256,27
17083,37,30,11,10,9,0,9,17,4,0,7,3,0,0,4,4,3
17084,1478,1135,194,506,338,97,422,588,51,74,343,38,107,108,90,282,61
17086,873,712,168,299,204,41,292,362,33,25,161,20,38,47,56,142,19
17087,953,745,164,348,185,48,313,348,42,42,208,32,55,82,39,171,37
17088,375,293,17,125,121,30,60,189,17,27,82,24,16,20,22,73,9
17090,2008,1549,416,715,356,62,627,694,164,64,459,100,212,103,44,331,128
17093,186,139,10,80,49,0,55,72,12,0,47,10,27,0,10,36,11
17094,934,692,141,307,206,38,237,359,51,45,242,38,47,82,75,212,30
17097,361,269,59,98,99,13,65,136,37,31,92,16,17,43,16,71,21
17098,1072,759,154,340,216,49,230,379,89,61,313,65,71,87,90,278,35
17099,441,318,72,191,43,12,125,116,30,47,123,14,29,21,59,104,19
17101,1392,130,34,69,22,5,8,55,23,44,1262,354,332,335,241,1187,75
17102,4200,1366,417,668,213,68,158,343,549,316,2834,807,1117,675,235,2406,428
17103,4670,2857,768,1391,509,189,617,764,944,532,1813,354,727,490,242,1511,302
17104,7725,5062,1710,2230,883,239,1055,1236,1932,839,2663,389,1169,772,333,2189,474
17109,10301,6016,1294,2516,1544,662,1756,2773,741,746,4285,1221,1356,988,720,3650,635
17110,9011,5694,1042,2980,1333,339,1767,2092,1026,809,3317,875,1238,768,436,2710,607
17111,10801,7165,1434,3685,1648,398,2405,3257,936,567,3636,824,1272,894,646,3142,494
17112,11871,8849,1129,4774,2511,435,3307,4439,653,450,3022,615,1140,782,485,2526,496
17113,4450,2893,563,1308,681,341,770,1099,567,457,1557,178,514,517,348,1384,173
17201,19297,13346,2783,5887,3649,1027,4401,6677,1373,895,5951,1162,1660,1499,1630,5082,869
17211,150,108,14,54,31,9,39,47,9,13,42,3,17,14,8,38,4
17212,244,193,47,100,36,10,73,98,14,8,51,14,8,20,9,43,8
17213,254,177,32,87,54,4,58,86,16,17,77,10,20,32,15,74,3
17214,464,285,75,116,69,25,65,182,31,7,179,33,95,24,27,154,25
17215,127,83,14,38,23,8,24,30,14,15,44,8,10,13,13,35,9
17219,95,65,14,29,20,2,27,33,3,2,30,0,13,9,8,26,4
17220,262,199,39,86,64,10,63,104,12,20,63,11,18,17,17,62,1
17221,196,127,42,51,29,5,40,57,21,9,69,3,20,22,24,54,15
17222,3290,2425,378,1013,804,230,759,1381,123,162,865,169,236,334,126,736,129
17223,139,111,29,44,36,2,37,55,10,9,28,10,4,8,6,26,2
17224,636,518,138,215,142,23,129,261,104,24,118,13,45,25,35,108,10
17225,6188,4717,1060,2164,1235,258,1854,2263,341,259,1471,303,466,450,252,1217,254
17228,397,299,58,126,97,18,95,165,26,13,98,13,20,48,17,85,13
17229,543,405,82,167,130,26,131,189,53,32,138,17,36,55,30,128,10
17233,1947,1304,269,560,391,84,394,645,178,87,643,126,188,198,131,556,87
17235,270,184,31,78,69,6,27,127,18,12,86,17,8,36,25,78,8
17236,3039,2332,408,1124,674,126,803,1200,181,148,707,95,229,219,164,628,79
17237,582,448,104,189,138,17,133,233,52,30,134,31,33,40,30,116,18
17238,671,499,98,219,147,35,187,233,34,45,172,23,43,63,43,154,18
17239,76,64,16,29,16,3,29,24,4,7,12,0,6,4,2,11,1
17240,1088,904,207,427,214,56,405,420,51,28,184,30,54,50,50,137,47
17241,4196,3236,631,1617,807,181,1194,1580,287,175,960,174,290,264,232,779,181
17243,637,421,81,198,112,30,146,207,36,32,216,18,46,89,63,206,10
17244,945,761,164,376,186,35,293,387,44,37,184,44,52,49,39,157,27
17249,171,128,25,56,42,5,42,70,5,11,43,8,4,17,14,39,4
17252,1292,958,216,378,262,102,321,511,69,57,334,53,95,132,54,277,57
17253,128,92,23,43,17,9,32,48,4,8,36,10,4,6,16,31,5
17254,37,22,0,11,5,6,0,22,0,0,15,15,0,0,0,0,15
17255,385,302,69,124,83,26,108,160,21,13,83,18,25,25,15,73,10
17257,7917,5189,1169,2412,1344,264,1898,2498,476,317,2728,1185,582,538,423,1794,934
17260,302,222,29,119,58,16,90,98,17,17,80,7,23,40,10,69,11
17262,474,370,100,152,88,30,178,154,25,13,104,10,26,30,38,94,10
17264,946,689,135,284,222,48,236,353,50,50,257,35,58,92,72,217,40
17265,80,59,6,37,13,3,22,32,4,1,21,2,7,8,4,15,6
17266,236,178,22,105,40,11,49,106,14,9,58,10,21,12,15,50,8
17267,1007,774,174,309,244,47,250,380,79,65,233,34,76,65,58,197,36
17268,10287,7314,1585,3134,1871,724,2490,3621,659,544,2973,501,842,873,757,2596,377
17270,32,32,0,32,0,0,11,16,5,0,0,0,0,0,0,0,0
17271,207,163,20,78,57,8,51,89,13,10,44,4,10,18,12,34,10
17301,1229,974,202,518,206,48,360,479,73,62,255,61,71,69,54,193,62
17302,946,715,118,411,172,14,316,290,41,68,231,29,76,71,55,189,42
17304,832,675,133,359,153,30,315,266,35,59,157,21,59,59,18,126,31
17306,196,161,38,62,46,15,54,81,14,12,35,8,5,2,20,30,5
17307,2047,1560,274,711,440,135,507,795,129,129,487,94,157,105,131,397,90
17309,791,597,109,306,149,33,257,290,3,47,194,13,69,73,39,152,42
17311,253,181,28,94,47,12,72,87,10,12,72,12,17,23,20,65,7
17313,3855,2683,583,1325,622,153,912,1233,317,221,1172,314,346,261,251,971,201
17314,2017,1636,376,915,304,41,715,648,191,82,381,55,132,132,62,326,55
17315,8891,6681,1393,3328,1640,320,2452,3192,685,352,2210,504,773,634,299,1783,427
17316,2540,1907,400,935,477,95,758,808,162,179,633,121,222,181,109,480,153
17317,306,211,51,107,35,18,101,70,26,14,95,17,29,29,20,72,23
17318,111,63,6,33,14,10,0,54,9,0,48,11,31,6,0,39,9
17319,3571,2722,565,1621,500,36,1181,1039,353,149,849,173,425,164,87,627,222
17320,2590,2023,370,1035,518,100,796,964,153,110,567,83,214,174,96,450,117
17321,739,605,77,351,147,30,227,323,34,21,134,17,43,56,18,112,22
17322,1985,1612,315,829,406,62,647,748,128,89,373,71,146,85,71,298,75
17324,1606,1217,224,614,311,68,453,609,75,80,389,21,176,96,96,295,94
17325,9475,6372,1011,3015,1812,534,1968,3216,735,453,3103,701,896,886,620,2605,498
17327,2705,2093,249,1119,578,147,710,1049,208,126,612,112,173,206,121,513,99
17329,827,718,86,395,208,29,259,351,66,42,109,20,23,38,28,85,24
17331,17377,12352,2381,5923,3216,832,4496,5839,1114,903,5025,1073,1517,1302,1133,4261,764
17339,2102,1638,209,924,454,51,614,833,115,76,464,87,223,95,59,387,77
17340,3585,2798,527,1315,768,188,1090,1284,287,137,787,214,214,211,148,657,130
17343,53,24,0,10,14,0,0,14,0,10,29,0,15,7,7,29,0
17344,1420,881,165,399,232,85,288,456,86,51,539,122,96,167,154,418,121
17345,2666,1946,443,927,466,110,583,960,247,156,720,191,262,169,98,596,124
17347,1754,1274,197,630,366,81,418,651,93,112,480,109,160,102,109,399,81
17349,2539,2037,300,1128,525,84,766,1050,130,91,502,52,181,126,143,396,106
17350,4281,3204,743,1480,756,225,1124,1422,428,230,1077,165,310,289,313,863,214
17352,439,344,70,164,89,21,125,155,26,38,95,13,29,35,18,65,30
17353,1165,939,158,504,227,50,380,403,83,73,226,28,82,73,43,169,57
17355,111,75,9,53,12,1,35,27,8,5,36,8,21,3,4,32,4
17356,7131,5296,1233,2403,1312,348,1928,2509,540,319,1835,438,580,509,308,1503,332
17360,1691,1365,190,771,340,64,535,694,72,64,326,64,101,116,45,233,93
17361,1829,1335,152,682,418,83,536,685,37,77,494,66,93,141,194,453,41
17362,4180,3366,574,1832,800,160,1338,1643,232,153,814,170,226,220,198,641,173
17363,2992,2457,428,1422,492,115,1073,1044,170,170,535,107,184,158,86,433,102
17364,1382,1002,183,540,215,64,353,479,124,46,380,47,121,165,47,340,40
17365,1079,825,169,387,225,44,282,409,101,33,254,48,114,47,45,199,55
17366,1710,1272,299,705,219,49,520,501,174,77,438,108,147,109,74,299,139
17368,2810,1991,378,998,501,114,679,933,267,112,819,121,416,157,125,704,115
17370,1855,1430,358,747,298,27,507,671,180,72,425,68,199,86,72,340,85
17372,1343,1025,224,481,245,75,383,471,100,71,318,46,111,96,65,253,65
17401,543,132,60,57,15,0,22,23,59,28,411,146,200,58,7,316,95
17402,17380,11942,1807,5561,3581,993,3931,6287,924,800,5438,1333,1494,1415,1196,4457,981
17403,16529,10259,2145,4579,2607,928,2848,4294,1969,1148,6270,1544,1722,1481,1523,5101,1169
17404,23023,15443,3417,7114,3656,1256,4979,6859,2107,1498,7580,1805,2432,1848,1495,6123,1457
17406,2495,1934,319,928,606,81,635,1019,146,134,561,96,215,113,137,444,117
17407,631,500,62,263,138,37,176,267,32,25,131,6,26,49,50,123,8
17501,1838,1306,238,552,398,118,404,730,71,101,532,119,163,135,115,446,86
17502,885,676,129,382,135,30,288,313,32,43,209,38,90,45,36,183,26
17505,453,344,73,117,115,39,134,175,18,17,109,0,39,16,54,109,0
17508,65,49,0,24,25,0,32,17,0,0,16,0,5,11,0,16,0
17509,1355,1148,258,551,285,54,517,480,83,68,207,30,56,67,54,196,11
17512,6848,4609,968,2232,1100,309,1447,2022,733,407,2239,454,623,616,546,1841,398
17516,1629,1332,155,758,343,76,506,643,97,86,297,84,126,49,38,236,61
17517,4861,3924,828,1978,940,178,1611,1874,273,166,937,142,344,259,192,788,149
17518,377,303,52,170,69,12,129,147,8,19,74,13,31,21,9,63,11
17519,1573,1362,313,610,365,74,699,547,25,91,211,26,41,70,74,177,34
17520,1816,1436,254,729,361,92,484,716,161,75,380,64,128,112,76,320,60
17522,10837,7852,1669,3704,1937,542,3120,3676,614,442,2985,721,889,736,639,2480,505
17527,1806,1499,361,695,384,59,674,629,91,105,307,75,80,89,63,279,28
17529,1339,1114,319,430,289,76,578,468,41,27,225,25,53,69,78,189,36
17532,1130,893,166,490,203,34,397,377,37,82,237,47,94,63,33,186,51
17535,617,525,149,240,107,29,271,189,18,47,92,15,40,28,9,76,16
17536,797,690,126,331,189,44,323,309,28,30,107,9,50,39,9,94,13
17538,2296,1876,234,1128,426,88,877,771,103,125,420,57,138,123,102,365,55
17540,3107,2418,452,1142,692,132,1027,1090,160,141,689,158,215,195,121,556,133
17543,13414,10099,1845,5308,2206,740,4179,4776,745,399,3315,608,902,791,1014,2862,453
17545,7254,5536,977,2592,1576,391,2082,2820,350,284,1718,298,488,567,365,1448,270
17547,2293,1656,433,874,262,87,646,603,233,174,637,175,202,160,100,512,125
17551,2999,1811,249,842,498,222,569,953,159,130,1188,510,259,232,187,814,374
17552,5556,4053,912,1994,987,160,1512,1890,408,243,1503,440,438,397,228,1216,287
17554,2241,1563,322,822,352,67,498,742,207,116,678,158,284,169,67,578,100
17555,2097,1796,349,880,441,126,903,746,50,97,301,31,93,86,91,252,49
17557,4635,3501,633,1614,922,332,1270,1790,273,168,1134,212,251,377,294,994,140
17560,1776,1403,188,757,376,82,504,712,77,110,373,31,151,103,88,315,58
17562,1155,982,196,453,259,74,420,462,43,57,173,38,60,61,14,130,43
17563,1193,973,230,428,264,51,414,403,76,80,220,39,83,55,43,181,39
17565,839,663,69,394,148,52,302,299,40,22,176,8,90,57,21,132,44
17566,3464,2752,603,1383,590,176,1170,1154,256,172,712,125,168,265,154,607,105
17569,1828,1423,319,771,289,44,632,650,65,76,405,67,123,115,100,343,62
17570,98,77,0,46,31,0,41,31,5,0,21,5,16,0,0,16,5
17572,1192,869,121,323,339,86,342,449,26,52,323,66,77,87,93,276,47
17576,41,33,0,9,14,10,0,33,0,0,8,0,0,0,8,8,0
17578,2293,1884,377,1007,428,72,830,855,148,51,409,90,115,55,149,355,54
17579,2007,1542,226,824,407,85,679,688,89,86,465,131,127,104,103,377,88
17581,356,280,71,133,50,26,118,119,21,22,76,22,30,22,2,50,26
17582,707,553,79,336,134,4,243,247,17,46,154,31,55,43,25,137,17
17584,3336,2455,387,1119,627,322,949,1246,131,129,881,102,164,196,419,842,39
17601,17969,12977,1710,6372,3767,1128,4654,6802,858,663,4992,1018,1413,1522,1039,4237,755
17602,17185,11218,2709,5057,2460,992,3455,4399,2084,1280,5967,1250,2219,1369,1129,4926,1041
17603,23323,14268,3550,6181,3345,1192,4170,6264,2435,1399,9055,2495,2997,2054,1509,7181,1874
17701,18830,11323,2362,5102,2878,981,3243,4967,1994,1119,7507,1855,2096,1950,1606,6198,1309
17702,4453,3058,497,1427,872,262,1067,1456,317,218,1395,334,370,323,368,1188,207
17721,603,425,82,179,136,28,159,198,36,32,178,29,45,56,48,152,26
17724,1999,1422,315,579,407,121,486,679,157,100,577,86,145,159,187,496,81
17728,2045,1594,231,795,466,102,550,789,145,110,451,51,167,163,70,365,86
17729,62,34,0,11,19,4,4,28,2,0,28,1,6,13,8,23,5
17730,102,59,22,30,7,0,14,22,16,7,43,16,6,21,0,27,16
17731,158,91,8,29,39,15,13,67,1,10,67,20,11,28,8,62,5
17737,2434,1694,290,836,428,140,539,851,191,113,740,139,215,202,184,628,112
17738,65,41,3,19,12,7,11,28,0,2,24,2,2,18,2,22,2
17739,10,5,3,2,0,0,0,5,0,0,5,2,0,3,0,3,2
17740,4992,3690,774,1755,947,214,1354,1648,418,270,1302,192,395,388,327,1100,202
17742,30,24,7,10,7,0,7,15,0,2,6,0,1,2,3,6,0
17744,1270,933,159,449,280,45,318,465,72,78,337,71,104,106,56,260,77
17745,7130,4382,956,1726,1306,394,1252,2193,562,375,2748,687,631,737,693,2171,577
17747,943,763,171,342,203,47,302,378,50,33,180,12,48,67,53,160,20
17748,41,41,13,20,8,0,20,18,3,0,0,0,0,0,0,0,0
17749,134,83,19,34,22,8,29,42,5,7,51,18,22,7,4,33,18
17750,47,29,5,15,0,9,16,5,4,4,18,5,0,0,13,18,0
17751,2618,1996,337,926,598,135,636,1059,189,112,622,103,177,201,141,517,105
17752,1882,1427,325,644,349,109,488,680,128,131,455,76,111,154,114,382,73
17754,4789,3525,383,1724,993,425,1199,1872,264,190,1264,173,312,421,358,1111,153
17756,4316,3243,545,1527,932,239,1076,1643,302,222,1073,189,299,322,263,906,167
17758,417,305,42,128,101,34,98,161,18,28,112,17,30,38,27,96,16
17760,183,123,19,58,37,9,38,63,8,14,60,7,9,29,15,47,13
17762,283,201,53,81,56,11,79,88,23,11,82,13,21,20,28,76,6
17763,96,77,9,30,36,2,15,36,15,11,19,2,6,5,6,18,1
17764,1209,730,118,328,217,67,183,320,130,97,479,49,104,160,166,428,51
17765,362,293,48,148,84,13,87,155,32,19,69,9,15,27,18,59,10
17767,28,12,0,8,0,4,0,12,0,0,16,0,4,3,9,13,3
17768,126,86,13,35,37,1,24,54,8,0,40,9,3,24,4,30,10
17771,1359,1011,176,477,290,68,322,526,84,79,348,72,141,90,45,270,78
17772,841,675,131,320,199,25,265,318,41,51,166,29,51,46,40,140,26
17774,455,337,67,146,99,25,119,162,29,27,118,22,38,37,21,98,20
17776,231,150,25,50,67,8,33,101,8,8,81,11,21,31,18,55,26
17777,2645,1886,344,871,541,130,626,961,179,120,759,132,229,214,184,668,91
17778,71,58,5,30,21,2,16,32,8,2,13,0,0,11,2,13,0
17801,7154,4740,995,2151,1268,326,1529,2202,610,399,2414,455,705,648,606,2104,310
17810,698,575,122,271,157,25,232,285,32,26,123,24,24,45,30,105,18
17812,550,401,95,160,120,26,132,202,38,29,149,6,32,58,53,135,14
17813,713,540,120,221,154,45,193,269,53,25,173,30,55,48,40,140,33
17814,1794,1312,205,588,407,112,406,698,101,107,482,91,139,159,93,424,58
17815,10430,6567,1196,3031,1836,504,2125,3289,639,514,3863,1324,922,851,766,2814,1049
17820,2265,1630,228,840,444,118,547,848,133,102,635,78,174,209,174,566,69
17821,7266,4907,820,2400,1368,319,1778,2377,422,330,2359,410,759,667,523,2064,295
17823,462,345,46,173,102,24,127,191,17,10,117,13,27,32,45,112,5
17824,1620,1211,145,624,331,111,440,653,40,78,409,35,101,171,102,371,38
17825,18,18,0,14,4,0,5,4,9,0,0,0,0,0,0,0,0
17827,304,214,30,88,80,16,56,112,22,24,90,8,16,39,27,83,7
17829,67,51,9,26,14,2,17,25,6,3,16,2,0,8,6,16,0
17830,803,590,82,297,175,36,207,343,26,14,213,26,45,81,61,185,28
17832,317,206,28,93,62,23,59,100,12,35,111,23,29,27,32,102,9
17833,130,90,31,32,21,6,32,37,15,6,40,16,8,3,13,34,6
17834,1540,1004,153,389,358,104,288,538,89,89,536,64,129,145,198,489,47
17835,101,71,14,33,20,4,32,35,2,2,30,5,8,9,8,26,4
17836,112,80,14,31,24,11,21,53,2,4,32,4,9,6,13,25,7
17837,5516,3420,463,1559,985,413,1141,1830,291,158,2096,577,401,555,563,1746,350
17840,160,135,17,79,29,10,46,33,38,18,25,0,3,18,4,25,0
17841,1724,1363,284,653,355,71,477,687,126,73,361,50,105,124,82,285,76
17842,2846,2174,472,1033,560,109,802,1071,189,112,672,111,217,178,166,569,103
17844,3596,2702,538,1358,636,170,1074,1313,197,118,894,136,225,323,210,798,96
17845,766,579,141,253,169,16,226,279,47,27,187,36,42,67,42,150,37
17846,1409,1036,185,469,297,85,365,515,78,78,373,59,107,121,86,286,87
17847,4726,3179,626,1377,905,271,1012,1606,369,192,1547,245,453,480,369,1368,179
17850,265,183,46,84,47,6,67,86,20,10,82,16,22,26,18,71,11
17851,3758,2108,326,889,620,273,535,952,298,323,1650,136,328,577,609,1511,139
17853,991,790,171,376,207,36,331,365,41,53,201,20,62,76,43,170,31
17855,379,276,70,114,84,8,97,135,28,16,103,9,22,47,25,88,15
17856,1303,1083,192,533,280,78,377,566,77,63,220,43,61,59,57,173,47
17857,3093,2087,311,989,617,170,635,1134,204,114,1006,174,259,290,283,827,179
17859,1051,778,151,369,214,44,260,429,53,36,273,35,83,103,52,234,39
17860,522,411,37,182,160,32,131,239,9,32,111,8,35,31,37,103,8
17861,85,58,6,31,21,0,31,16,3,8,27,0,4,5,18,27,0
17862,219,162,38,68,49,7,65,75,13,9,57,11,19,13,14,53,4
17864,790,617,144,311,124,38,282,264,42,29,173,33,50,52,38,152,21
17865,48,42,6,22,12,2,13,22,7,0,6,1,0,3,2,6,0
17866,3706,2340,411,948,683,298,692,1148,231,269,1366,155,311,442,458,1233,133
17867,49,42,8,16,12,6,19,18,3,2,7,2,0,3,2,7,0
17868,473,347,39,155,118,35,123,181,17,26,126,14,49,27,36,110,16
17870,5535,3751,662,1691,1045,353,1286,1867,313,285,1784,380,425,582,397,1434,350
17872,4491,2649,538,1169,688,254,780,1125,411,333,1842,214,481,533,614,1648,194
17878,474,349,52,147,119,31,108,174,38,29,125,28,35,35,27,92,33
17881,865,562,102,255,153,52,173,282,55,52,303,45,57,90,111,275,28
17882,59,40,11,13,16,0,13,20,0,7,19,4,6,7,2,17,2
17884,107,70,19,41,10,0,21,25,22,2,37,8,10,11,8,34,3
17885,64,40,10,11,17,2,16,19,5,0,24,0,12,5,7,22,2
17886,292,219,62,76,72,9,85,109,7,18,73,9,18,22,24,70,3
17887,140,66,6,39,15,6,15,39,0,12,74,14,10,40,10,65,9
17888,177,128,21,43,51,13,42,71,6,9,49,2,10,14,23,44,5
17889,968,794,104,410,249,31,281,429,39,45,174,21,62,72,19,146,28
17901,10150,6593,1053,3100,1857,583,2082,2943,858,710,3557,613,860,1090,994,3124,433
17920,114,73,6,29,29,9,11,45,5,12,41,2,7,23,9,34,7
17921,2709,1817,322,802,535,158,537,950,184,146,892,76,239,287,290,797,95
17922,1643,1322,218,685,349,70,528,631,78,85,321,52,89,119,61,268,53
17923,206,125,26,54,26,19,49,51,9,16,81,7,22,21,31,71,10
17925,163,114,19,37,43,15,23,77,2,12,49,5,7,14,23,45,4
17927,6,4,0,0,0,4,0,0,0,4,2,0,0,0,2,2,0
17929,636,471,118,199,113,41,157,228,39,47,165,47,45,32,41,138,27
17930,167,103,30,36,25,12,35,42,13,13,64,17,14,23,10,60,4
17931,2464,1550,253,716,414,167,477,818,110,145,914,129,141,369,275,875,39
17933,37,16,0,5,11,0,5,7,0,4,21,7,6,8,0,21,0
17934,217,113,25,51,24,13,40,42,9,22,104,10,24,45,25,95,9
17935,939,596,110,227,186,73,122,261,86,127,343,19,104,133,87,306,37
17936,295,204,30,107,48,19,77,76,30,21,91,3,19,37,32,88,3
17938,935,651,122,274,184,71,227,348,39,37,284,36,51,106,91,265,19
17941,266,210,32,104,57,17,76,101,17,16,56,5,16,16,19,45,11
17943,116,58,14,20,14,10,13,45,0,0,58,0,27,9,22,58,0
17944,76,44,9,16,15,4,16,19,5,4,32,4,4,12,12,32,0
17945,57,40,7,22,9,2,20,11,5,4,17,2,5,2,8,15,2
17946,76,59,5,26,28,0,17,31,0,11,17,0,17,0,0,17,0
17948,2528,1536,293,585,439,219,363,649,236,288,992,71,212,351,358,940,52
17949,165,107,25,44,26,12,28,48,15,16,58,5,19,17,17,58,0
17951,140,109,5,62,28,14,26,46,23,14,31,10,4,9,8,26,5
17952,125,87,8,39,25,15,24,49,2,12,38,7,7,9,15,33,5
17953,186,117,11,65,35,6,38,47,14,18,69,11,13,17,28,64,5
17954,2104,1276,286,439,387,164,329,629,177,141,828,142,194,149,343,734,94
17957,107,94,22,42,26,4,33,48,3,10,13,0,5,0,8,8,5
17959,714,453,69,185,129,70,101,225,53,74,261,31,56,88,86,233,28
17960,1146,868,103,451,242,72,301,481,50,36,278,44,88,75,71,230,48
17961,2560,1820,278,895,519,128,675,895,134,116,740,113,237,212,178,647,93
17963,3525,2586,388,1291,709,198,866,1286,173,261,939,128,242,277,292,790,149
17964,285,221,38,93,67,23,91,110,2,18,64,9,12,23,20,57,7
17965,967,643,115,268,180,80,183,269,84,107,324,52,46,114,112,301,23
17967,1021,707,71,368,198,70,259,325,52,71,314,38,96,100,80,267,47
17968,157,117,11,64,29,13,41,70,2,4,40,3,7,15,15,39,1
17970,1640,986,206,294,347,139,213,445,107,221,654,113,121,154,266,605,49
17972,4478,3075,539,1402,901,233,991,1557,278,249,1403,244,313,423,423,1206,197
17974,111,83,7,38,29,9,17,48,0,18,28,5,9,6,8,28,0
17976,3514,1986,406,757,530,293,509,852,295,330,1528,154,344,515,515,1371,157
17978,121,96,26,38,19,13,38,44,8,6,25,6,3,10,6,21,4
17979,98,57,14,13,22,8,20,25,0,12,41,5,0,18,18,41,0
17980,1350,918,174,407,271,66,278,420,109,111,432,60,105,134,133,376,56
17981,1075,683,162,289,190,42,213,330,78,62,392,40,94,152,106,324,68
17982,196,134,8,61,59,6,42,68,6,18,62,8,13,15,26,56,6
17983,658,511,58,232,166,55,134,292,23,62,147,15,27,48,57,132,15
17985,404,304,51,161,73,19,107,157,18,22,100,8,34,33,25,87,13
18011,1807,1370,278,746,297,49,584,589,108,89,437,128,141,85,83,371,66
18012,32,32,8,9,15,0,17,7,0,8,0,0,0,0,0,0,0
18013,6537,4718,780,2309,1173,456,1839,2153,371,355,1819,245,551,548,475,1552,267
18014,4530,3328,543,1507,1025,253,1021,1782,265,260,1202,114,424,369,295,987,215
18015,10462,6846,1461,3353,1546,486,2288,2660,1108,790,3616,1100,906,878,732,2774,842
18017,14147,9987,1474,4561,2912,1040,3102,5067,1010,808,4160,515,1031,1215,1399,3692,468
18018,13276,7710,1532,3330,2087,761,2293,3666,971,780,5566,1442,1503,1189,1432,4691,875
18020,6650,5187,561,2962,1326,338,2183,2342,337,325,1463,258,449,431,325,1287,176
18030,384,257,33,120,80,24,74,126,32,25,127,21,47,27,32,108,19
18031,1396,923,148,401,290,84,278,501,61,83,473,60,172,134,107,355,118
18032,3708,2475,464,1237,604,170,802,1096,349,228,1233,280,369,226,358,1021,212
18034,2000,1653,217,829,463,144,648,862,76,67,347,37,152,105,53,274,73
18035,21,21,0,8,13,0,8,13,0,0,0,0,0,0,0,0,0
18036,4313,3443,385,2007,842,209,1404,1649,146,244,870,139,244,291,196,707,163
18037,2821,2056,305,1050,537,164,751,907,181,217,765,118,233,247,167,653,112
18038,1165,947,132,632,102,81,416,387,90,54,218,12,64,93,49,166,52
18040,3329,2613,394,1439,650,130,1146,1122,176,169,716,52,298,225,141,599,117
18041,2041,1550,292,793,367,98,595,663,165,127,491,92,186,138,75,382,109
18042,14783,9230,2170,4313,2026,721,2954,3368,1568,1340,5553,1368,1981,1315,889,4473,1080
18045,8354,6180,814,2991,1863,512,2257,3185,352,386,2174,233,496,727,718,1870,304
18049,7165,4961,719,2458,1354,430,1739,2468,383,371,2204,546,570,547,541,1895,309
18051,1316,1082,137,575,320,50,410,590,62,20,234,47,71,81,35,197,37
18052,10442,6861,1316,3105,1855,585,2321,3431,560,549,3581,765,1063,1060,693,2990,591
18053,851,664,106,308,216,34,227,330,62,45,187,31,64,60,32,144,43
18054,1521,1141,121,577,368,75,434,576,49,82,380,82,113,100,85,295,85
18055,4318,2905,447,1343,836,279,916,1496,228,265,1413,238,383,384,408,1168,245
18056,327,235,31,102,86,16,60,144,21,10,92,17,15,24,36,70,22
18058,2823,2165,321,1190,525,129,788,1055,181,141,658,115,171,226,146,517,141
18059,409,320,87,205,28,0,175,100,28,17,89,0,47,42,0,64,25
18062,5459,4064,541,2086,1169,268,1541,2033,291,199,1395,254,556,366,219,1155,240
18063,235,148,5,57,65,21,29,105,5,9,87,0,42,22,23,79,8
18064,7728,5811,726,3145,1543,397,2271,2762,373,405,1917,348,581,576,412,1604,313
18066,1740,1379,232,804,271,72,627,589,103,60,361,51,160,70,80,294,67
18067,6285,4607,782,2204,1254,367,1616,2194,348,449,1678,351,440,461,426,1417,261
18069,2148,1766,193,957,469,147,827,766,84,89,382,43,112,158,69,307,75
18070,293,243,45,129,51,18,95,129,4,15,50,8,22,15,5,42,8
18071,3985,2748,535,1269,673,271,962,1295,231,260,1237,211,356,278,392,957,280
18072,2451,1856,309,915,469,163,709,872,156,119,595,144,118,168,165,497,98
18073,2559,1970,277,1101,478,114,807,935,108,120,589,120,191,132,146,504,85
18074,1964,1599,220,914,391,74,696,735,93,75,365,52,155,100,58,298,67
18076,949,624,94,311,173,46,236,292,26,70,325,38,72,89,126,273,52
18077,1028,773,103,396,226,48,294,371,49,59,255,30,102,75,48,206,49
18078,2355,1845,247,1001,538,59,734,954,78,79,510,46,139,173,152,421,89
18079,107,82,10,44,8,20,22,15,7,38,25,0,8,17,0,25,0
18080,4474,3332,537,1831,741,223,1216,1457,302,357,1142,231,414,252,245,909,233
18081,49,26,0,13,13,0,13,6,0,7,23,17,6,0,0,13,10
18083,222,160,44,75,36,5,50,75,26,9,62,7,16,26,13,55,7
18085,365,272,25,138,95,14,81,148,24,19,93,11,24,23,35,86,7
18086,79,62,26,20,10,6,13,29,10,10,17,5,7,5,0,17,0
18087,318,208,39,96,59,14,25,82,48,53,110,36,26,41,7,90,20
18088,2877,2128,305,1024,649,150,768,1010,138,212,749,120,236,209,184,608,141
18091,2126,1530,232,842,370,86,541,747,137,105,596,108,153,203,132,484,112
18092,1056,822,88,427,270,37,313,416,17,76,234,32,106,25,71,159,75
18101,1083,534,222,212,43,57,128,111,238,57,549,137,197,187,28,398,151
18102,16350,9717,2861,4431,1820,605,2707,2905,2650,1455,6633,1427,2265,1558,1383,5564,1069
18103,24205,16080,3536,6959,4285,1300,5072,7189,2223,1596,8125,1886,2664,2008,1567,6746,1379
18104,15510,10125,1366,4886,2763,1110,3363,5146,842,774,5385,924,1313,1375,1773,4617,768
18106,2398,1715,224,930,435,126,725,821,105,64,683,90,193,216,184,561,122
18201,15326,9278,1605,3889,2818,966,2455,4300,1285,1238,6048,898,1394,1874,1882,5433,615
18210,1600,1281,154,668,375,84,473,608,153,47,319,41,74,141,63,267,52
18211,495,408,48,224,119,17,181,188,7,32,87,7,44,20,16,64,23
18214,801,607,96,308,172,31,193,293,65,56,194,5,67,75,47,170,24
18216,552,357,49,146,121,41,95,163,38,61,195,34,41,62,58,178,17
18218,1056,618,104,274,135,105,147,277,94,100,438,54,72,89,223,402,36
18219,664,476,48,222,148,58,167,247,38,24,188,22,51,48,67,163,25
18220,157,117,19,47,41,10,46,59,5,7,40,1,10,17,12,38,2
18221,146,114,8,52,48,6,40,55,8,11,32,9,18,5,0,25,7
18222,2545,1892,291,967,469,165,652,1017,117,106,653,84,195,234,140,553,100
18224,2628,1592,266,581,562,183,455,808,125,204,1036,142,295,248,351,965,71
18225,38,32,6,14,6,6,6,12,14,0,6,0,0,6,0,6,0
18229,2828,1969,342,923,557,147,672,899,192,206,859,138,266,272,183,707,152
18230,26,10,0,5,3,2,5,3,0,2,16,6,2,4,4,16,0
18231,216,133,18,61,37,17,37,58,15,23,83,8,12,20,43,78,5
18232,1881,1120,190,527,274,129,323,433,179,185,761,55,142,258,306,708,53
18234,178,121,17,55,43,6,43,39,23,16,57,5,18,23,11,50,7
18235,7350,5243,888,2400,1591,364,1643,2689,484,427,2107,255,645,656,551,1757,350
18237,1416,902,154,383,265,100,270,449,72,111,514,66,100,207,141,493,21
18239,55,31,7,24,0,0,7,15,9,0,24,0,0,24,0,15,9
18240,1611,1000,133,453,315,99,213,537,138,112,611,85,156,203,167,561,50
18241,326,195,17,102,62,14,67,76,34,18,131,29,34,35,33,108,23
18242,89,40,5,16,8,11,8,25,4,3,49,5,21,11,12,45,4
18244,183,127,22,53,44,8,37,69,5,16,56,4,19,24,9,46,10
18245,168,132,21,49,53,9,56,63,3,10,36,6,30,0,0,19,17
18246,86,63,18,20,16,9,29,22,0,12,23,0,0,0,23,23,0
18248,280,186,39,73,54,20,48,76,17,45,94,9,18,42,25,80,14
18249,1382,1095,89,581,322,103,365,620,43,67,287,15,100,100,72,237,50
18250,1290,900,149,396,281,74,255,406,142,97,390,76,100,118,96,341,49
18251,40,20,2,9,9,0,11,4,0,5,20,5,0,4,11,20,0
18252,4864,3170,492,1416,934,328,874,1608,309,379,1694,213,385,578,518,1544,150
18254,346,260,46,105,66,43,96,120,13,31,86,5,19,31,31,83,3
18255,1621,1181,140,574,350,117,428,546,120,87,440,53,113,149,125,381,59
18256,162,113,13,55,40,5,37,66,0,10,49,11,8,22,8,43,6
18301,12253,8918,1453,4931,2099,435,3598,3690,982,648,3335,692,1238,897,508,2534,801
18321,586,435,36,262,110,27,206,145,27,57,151,2,68,54,27,129,22
18322,849,604,92,288,163,61,199,271,66,68,245,44,76,86,39,209,36
18323,24,24,0,18,6,0,18,6,0,0,0,0,0,0,0,0,0
18324,2505,1974,316,1087,486,85,759,868,238,109,531,76,253,132,70,399,132
18325,880,573,68,242,227,36,156,327,61,29,307,42,122,111,32,240,67
18326,1626,1167,174,593,352,48,428,533,103,103,459,49,110,168,132,394,65
18327,342,197,68,77,32,20,56,83,41,17,145,46,52,29,18,105,40
18328,2384,1883,319,1078,443,43,856,780,156,91,501,83,204,154,60,414,87
18330,2406,1956,255,1192,427,82,906,813,167,70,450,82,168,158,42,320,130
18331,173,124,0,63,54,7,35,67,0,22,49,0,40,9,0,29,20
18332,663,517,112,274,102,29,234,180,76,27,146,54,43,27,22,87,59
18333,238,212,44,103,56,9,87,72,44,9,26,0,0,16,10,26,0
18334,915,671,90,415,162,4,270,247,75,79,244,52,117,56,19,159,85
18336,1571,1135,169,569,298,99,395,507,134,99,436,47,108,157,124,394,42
18337,4178,3138,456,1724,773,185,1356,1314,277,191,1040,175,313,377,175,827,213
18340,67,43,7,20,14,2,14,27,2,0,24,4,2,7,11,18,6
18341,65,42,0,26,16,0,12,22,8,0,23,0,9,0,14,23,0
18343,1373,997,177,481,271,68,336,535,66,60,376,58,81,176,61,317,59
18344,1225,847,158,427,193,69,339,348,100,60,378,94,78,139,67,305,73
18346,792,561,77,325,142,17,195,278,64,24,231,0,72,89,70,198,33
18347,1237,846,128,321,312,85,224,486,96,40,391,94,84,186,27,325,66
18349,37,37,0,27,0,10,27,0,0,10,0,0,0,0,0,0,0
18350,625,469,64,195,187,23,129,267,73,0,156,13,39,93,11,138,18
18351,221,145,35,57,38,15,52,52,16,25,76,10,28,22,16,69,7
18353,3954,3159,465,1835,714,145,1416,1381,179,183,795,144,280,247,124,598,197
18354,424,357,47,214,91,5,97,227,33,0,67,8,29,23,7,56,11
18355,657,501,59,274,129,39,154,245,36,66,156,11,39,66,40,127,29
18356,59,25,6,6,7,6,6,19,0,0,34,11,16,0,7,23,11
18357,19,10,0,10,0,0,10,0,0,0,9,0,9,0,0,0,9
18360,10109,6971,923,3535,1998,515,2613,3259,608,491,3138,765,908,862,603,2386,752
18370,356,233,31,84,105,13,62,153,13,5,123,18,60,42,3,104,19
18372,1027,760,79,450,192,39,306,309,75,70,267,29,120,99,19,210,57
18403,2521,1836,294,896,509,137,636,801,158,241,685,99,158,222,206,607,78
18405,839,628,115,275,167,71,236,320,44,28,211,30,55,84,42,186,25
18407,5984,3873,677,1619,1143,434,1144,1694,498,537,2111,264,457,696,694,1911,200
18411,8152,6005,664,3163,1769,409,2461,2943,237,364,2147,367,576,599,605,1945,202
18413,88,64,12,30,16,6,30,27,3,4,24,7,0,8,9,21,3
18414,2024,1517,209,826,387,95,611,703,95,108,507,69,162,160,116,454,53
18415,510,347,32,161,112,42,129,157,19,42,163,12,55,69,27,137,26
18417,482,361,45,172,119,25,115,196,35,15,121,15,37,44,25,104,17
18419,1608,1192,185,637,282,88,466,509,118,99,416,91,148,106,71,343,73
18420,110,66,13,36,12,5,24,33,5,4,44,2,10,21,11,34,10
18421,1988,1328,223,575,377,153,435,630,145,118,660,90,141,200,229,606,54
18424,1860,1362,196,664,419,83,491,667,102,102,498,66,175,177,80,394,104
18425,503,328,35,150,108,35,111,161,39,17,175,27,52,56,40,162,13
18426,1689,1193,147,482,473,91,318,693,83,99,496,48,161,196,91,413,83
18428,3980,2858,304,1168,1168,218,815,1618,260,165,1122,127,274,401,320,970,152
18430,25,20,6,9,2,3,8,11,1,0,5,2,0,0,3,5,0
18431,5306,3534,574,1621,1038,301,1166,1650,366,352,1772,226,431,632,483,1547,225
18433,2644,1873,271,876,555,171,656,855,151,211,771,106,226,264,175,683,88
18434,1787,1108,100,510,365,133,307,551,121,129,679,71,159,206,243,601,78
18435,170,122,4,74,30,14,50,58,11,3,48,0,20,21,7,42,6
18436,4481,3496,441,1593,1239,223,1106,1804,334,252,985,172,280,295,238,824,161
18437,93,57,11,27,10,9,20,22,13,2,36,7,9,18,2,33,3
18438,416,307,48,123,111,25,78,185,18,26,109,10,31,38,30,92,17
18439,263,182,9,72,78,23,23,119,20,20,81,6,27,22,26,65,16
18441,79,56,12,25,17,2,25,26,2,3,23,2,5,13,3,23,0
18443,153,116,13,78,25,0,61,34,13,8,37,4,5,18,10,29,8
18444,4694,3581,540,1878,945,218,1250,1650,362,319,1113,151,356,345,261,964,149
18445,718,531,63,248,180,40,201,254,43,33,187,24,50,71,42,159,28
18446,1403,1052,165,518,315,54,373,490,100,89,351,45,123,105,78,284,67
18447,4095,2737,366,1326,816,229,855,1385,184,313,1358,146,296,479,437,1274,84
18451,95,75,8,36,29,2,36,37,2,0,20,3,7,10,0,14,6
18452,2158,1494,170,660,427,237,443,794,86,171,664,94,100,227,243,643,21
18453,416,294,30,136,96,32,122,137,3,32,122,12,51,33,26,100,22
18455,34,27,2,20,2,3,9,18,0,0,7,2,0,3,2,7,0
18456,194,138,32,43,37,26,39,77,13,9,56,6,21,17,12,50,6
18457,29,18,4,4,10,0,8,10,0,0,11,0,0,7,4,11,0
18458,878,629,81,310,197,41,231,348,27,23,249,27,70,103,49,218,31
18459,33,24,4,15,3,2,14,6,2,2,9,0,2,2,5,9,0
18460,115,67,10,39,14,4,26,39,2,0,48,0,15,19,14,44,4
18461,201,133,23,51,45,14,28,72,13,20,68,14,12,23,19,54,14
18462,188,146,21,65,54,6,31,95,6,14,42,0,11,28,3,39,3
18464,410,292,37,132,96,27,80,168,28,16,118,6,44,52,16,89,29
18465,612,429,66,200,133,30,149,211,32,37,183,18,52,64,49,143,40
18466,3884,3189,571,1869,658,91,1275,1147,479,288,695,59,346,213,77,551,144
18469,83,58,9,35,14,0,26,27,0,5,25,10,8,7,0,15,10
18470,857,625,104,294,183,44,226,305,51,43,232,29,75,72,56,197,35
18471,238,177,9,110,53,5,77,76,11,13,61,2,18,25,16,57,4
18472,1460,1066,181,513,282,90,387,496,105,78,394,31,114,138,111,352,42
18473,246,169,53,69,32,15,36,66,48,19,77,8,34,25,10,73,4
18503,466,58,4,9,12,33,0,38,9,11,408,17,90,169,132,408,0
18504,9425,5861,1047,2658,1515,641,1781,2347,787,946,3564,461,877,1105,1121,3217,347
18505,8810,5203,946,2289,1356,612,1384,2307,695,817,3607,681,925,1010,991,3251,356
18507,2042,1458,161,669,464,164,415,794,103,146,584,89,122,223,150,525,59
18508,4903,3040,599,1332,839,270,852,1269,454,465,1863,293,495,576,499,1695,168
18509,5388,3057,536,1382,786,353,1049,1287,332,389,2331,501,564,697,569,2039,292
18510,5019,2639,433,1264,669,273,819,1019,432,369,2380,658,438,620,664,1898,482
18512,5605,3490,556,1413,1054,467,1091,1523,383,493,2115,449,487,579,600,1871,244
18517,2191,1522,279,586,485,172,363,696,199,264,669,76,202,242,149,617,52
18518,3752,2470,383,1073,698,316,780,1150,183,357,1282,166,289,401,426,1173,109
18519,2342,1491,255,650,392,194,465,685,152,189,851,154,153,237,307,770,81
18601,80,66,29,19,13,5,30,25,11,0,14,0,14,0,0,14,0
18602,101,61,3,34,17,7,24,35,2,0,40,0,17,9,14,36,4
18603,8095,5402,1082,2369,1475,476,1538,2517,743,604,2693,382,778,843,690,2343,350
18610,1187,971,143,604,184,40,437,372,91,71,216,21,69,90,36,186,30
18611,44,26,5,13,8,0,14,10,2,0,18,5,8,2,3,14,4
18612,5479,3945,531,1901,1154,359,1496,1968,190,291,1534,209,452,468,405,1337,197
18614,1089,716,97,319,227,73,224,372,70,50,373,37,112,110,114,316,57
18615,694,505,77,243,146,39,184,258,38,25,189,16,72,60,41,170,19
18616,289,216,26,84,90,16,49,137,19,11,73,5,8,38,22,64,9
18617,819,503,167,156,129,51,124,189,114,76,316,55,77,36,148,273,43
18618,1570,1081,209,531,259,82,377,500,120,84,489,88,172,140,89,399,90
18619,119,79,9,35,28,7,21,48,5,5,40,6,17,11,6,34,6
18621,1825,1401,222,724,374,81,524,614,133,130,424,83,129,110,102,341,83
18622,114,88,19,25,38,6,22,50,5,11,26,4,11,7,4,25,1
18623,1037,769,168,351,189,61,283,315,97,74,268,25,83,101,59,216,52
18624,166,117,19,39,49,10,20,82,4,11,49,4,12,24,9,36,13
18625,89,73,9,31,24,9,28,33,0,12,16,3,3,7,3,15,1
18626,103,65,18,26,17,4,16,35,9,5,38,2,13,9,14,33,5
18628,119,51,3,18,18,12,8,32,5,6,68,4,7,25,32,59,9
18629,646,458,81,223,118,36,159,233,31,35,188,27,65,64,32,146,42
18630,1214,922,180,422,266,54,321,397,123,81,292,61,93,92,46,235,57
18631,480,381,39,169,149,24,81,230,43,27,99,6,24,36,33,99,0
18632,199,108,10,56,31,11,27,62,13,6,91,19,22,38,12,84,7
18634,6200,3797,668,1556,1182,391,1114,1733,459,491,2403,358,516,787,742,2148,255
18635,1552,1120,218,563,279,60,448,507,80,85,432,98,121,97,116,360,72
18636,600,395,75,188,102,30,124,185,47,39,205,31,54,77,43,184,21
18640,7307,4893,845,2129,1363,556,1434,2169,594,696,2414,326,561,769,758,2187,227
18641,2696,1781,251,750,570,210,494,786,168,333,915,148,254,267,246,834,81
18642,1776,1136,104,479,440,113,328,486,89,233,640,97,163,185,195,592,48
18643,5680,3776,641,1708,1140,287,1175,1757,400,444,1904,267,467,521,649,1693,211
18644,3245,2173,260,1026,679,208,745,1074,115,239,1072,174,214,284,400,958,114
18651,4075,2616,529,1183,698,206,781,1057,378,400,1459,160,360,382,557,1290,169
18653,50,39,10,13,12,4,15,10,2,12,11,3,3,2,3,11,0
18655,2611,1908,362,856,487,203,647,924,152,185,703,113,161,235,194,626,77
18656,855,635,90,356,160,29,226,289,63,57,220,18,98,62,42,191,29
18657,4872,3426,575,1725,945,181,1287,1586,345,208,1446,256,397,447,346,1246,200
18660,1266,970,128,502,277,63,341,455,87,87,296,46,74,105,71,260,36
18661,2221,1601,227,809,460,105,536,748,111,206,620,85,178,226,131,532,88
18701,1416,242,53,41,74,74,20,146,9,67,1174,308,189,240,437,1012,162
18702,21040,12583,2429,5410,3429,1315,3501,5455,1882,1745,8457,1502,2263,2706,1986,7458,999
18704,14257,8675,1512,3916,2262,985,2654,3643,1095,1283,5582,846,1443,1681,1612,5091,491
18705,6817,4361,616,1869,1322,554,1225,2127,363,646,2456,392,563,745,756,2197,259
18706,3277,2122,362,941,621,198,606,941,239,336,1155,157,330,367,301,1029,126
18707,5170,4124,551,2267,1090,216,1650,2028,245,201,1046,180,297,292,277,937,109
18708,3391,2565,330,1331,755,149,974,1278,163,150,826,175,241,214,196,698,128
18709,1438,792,148,353,220,71,218,375,86,113,646,58,166,205,217,585,61
18801,3357,2388,398,1096,711,183,811,1181,239,157,969,166,264,313,226,825,144
18810,2430,1659,331,837,397,94,635,649,252,123,771,112,221,248,190,694,77
18812,648,516,51,294,150,21,190,256,53,17,132,22,54,42,14,110,22
18813,66,37,6,23,8,0,15,18,3,1,29,0,8,13,8,27,2
18814,64,46,7,23,14,2,16,22,7,1,18,2,8,5,3,13,5
18816,69,57,6,24,13,14,22,25,2,8,12,0,3,6,3,12,0
18817,126,98,10,39,37,12,34,54,8,2,28,4,9,7,8,25,3
18818,456,337,58,169,90,20,128,157,30,22,119,14,45,44,16,96,23
18820,33,25,5,12,8,0,10,11,4,0,8,0,2,4,2,8,0
18821,531,335,60,166,87,22,113,155,44,23,196,28,45,59,64,173,23
18822,1390,946,157,445,303,41,322,427,120,77,444,62,129,150,103,379,65
18823,89,57,11,30,12,4,20,21,12,4,32,6,2,13,11,28,4
18824,465,337,30,181,96,30,107,166,34,30,128,14,38,43,33,113,15
18825,82,61,10,24,21,6,23,26,5,7,21,3,5,8,5,21,0
18826,694,514,75,218,179,42,187,259,36,32,180,26,54,60,40,149,31
18827,59,43,11,20,11,1,17,15,11,0,16,0,7,5,4,12,4
18828,73,37,10,16,9,2,15,17,5,0,36,2,10,19,5,31,5
18829,288,212,44,104,42,22,85,95,19,13,76,15,10,34,17,69,7
18830,309,227,37,107,72,11,64,131,17,15,82,5,48,21,8,64,18
18831,436,321,53,169,71,28,147,131,26,17,115,4,58,42,11,101,14
18832,611,461,95,224,130,12,169,212,58,22,150,24,55,42,29,125,25
18833,756,543,75,254,167,47,157,284,59,43,213,26,61,71,55,178,35
18834,1357,1006,188,476,280,62,365,438,127,76,351,73,105,104,69,296,55
18837,1249,974,185,449,282,58,363,476,85,50,275,51,70,89,65,220,55
18839,65,44,2,30,6,6,12,15,11,6,21,3,10,5,3,13,8
18840,4545,2944,485,1302,870,287,957,1391,269,327,1601,252,488,470,391,1363,238
18842,84,57,6,41,7,3,16,26,10,5,27,2,3,9,13,24,3
18844,610,454,75,209,131,39,155,214,53,32,156,24,50,45,37,120,36
18845,158,125,11,68,31,15,31,67,15,12,33,5,8,16,4,31,2
18846,334,250,54,115,72,9,91,112,32,15,84,16,32,20,16,63,21
18847,2144,1531,248,716,430,137,480,716,211,124,613,85,166,213,149,529,84
18848,3744,2584,452,1221,721,190,874,1198,323,189,1160,227,336,341,256,961,199
18850,769,592,103,271,182,36,206,314,42,30,177,31,75,47,24,152,25
18851,263,213,19,100,86,8,61,128,17,7,50,3,26,12,9,40,10
18853,1572,1123,191,525,349,58,366,577,104,76,449,72,125,156,96,371,78
18854,576,402,89,169,119,25,141,182,47,32,174,37,69,41,27,129,45
18901,17031,12287,1841,6699,3052,695,5663,5264,640,720,4744,827,1419,1226,1272,3997,747
18914,6370,5012,795,2797,1178,242,2410,2047,278,277,1358,217,580,367,194,1142,216
18915,282,202,32,112,50,8,68,111,8,15,80,47,21,12,0,67,13
18917,840,517,161,258,75,23,226,170,82,39,323,123,103,66,31,242,81
18920,209,147,0,80,67,0,55,71,9,12,62,0,11,34,17,56,6
18923,119,99,6,49,32,12,32,39,16,12,20,15,0,5,0,0,20
18925,1032,855,85,412,343,15,382,404,26,43,177,30,84,35,28,143,34
18927,69,38,8,6,18,6,6,32,0,0,31,8,11,12,0,26,5
18929,2531,2271,456,1398,373,44,1346,807,67,51,260,32,102,106,20,231,29
18930,940,729,69,460,177,23,274,382,44,29,211,29,85,70,27,189,22
18932,158,119,8,48,43,20,42,65,5,7,39,0,25,8,6,31,8
18936,11,6,0,0,6,0,0,6,0,0,5,5,0,0,0,5,0
18938,5641,3661,278,1769,1313,301,1154,2157,173,177,1980,266,812,652,250,1449,531
18940,9797,7534,954,4701,1551,328,3713,2931,512,378,2263,486,927,529,321,1919,344
18942,1425,1083,76,614,366,27,424,585,29,45,342,96,106,98,42,247,95
18944,7631,5805,999,3142,1330,334,2613,2435,355,402,1826,356,631,527,312,1513,313
18947,2075,1646,230,1017,303,96,854,672,74,46,429,98,111,156,64,288,141
18951,11514,8372,1591,4429,1805,547,3436,3708,707,521,3142,576,1040,854,672,2507,635
18954,3139,2899,189,1841,758,111,1429,1267,74,129,240,9,91,85,55,213,27
18955,426,313,69,135,84,25,102,160,29,22,113,54,16,32,11,96,17
18960,4234,3093,543,1714,645,191,1308,1303,280,202,1141,219,328,265,329,994,147
18962,169,121,15,68,31,7,54,57,4,6,48,10,28,6,4,34,14
18964,4842,3520,667,1514,1037,302,1213,1834,225,248,1322,273,377,323,349,1116,206
18966,14300,11106,1044,6017,3339,706,4634,5144,605,723,3194,505,772,986,931,2810,384
18969,5468,4122,840,2155,920,207,1723,1738,422,239,1346,264,357,408,317,1129,217
18970,54,38,4,24,9,1,16,12,4,6,16,6,6,2,2,8,8
18972,1463,1049,126,549,311,63,330,597,45,77,414,60,148,118,88,328,86
18974,13428,10431,1634,4856,3215,726,3782,4665,816,1168,2997,604,885,1002,506,2571,426
18976,5451,4277,625,2492,986,174,1956,1828,259,234,1174,270,505,283,116,964,210
18977,1383,1138,82,650,378,28,475,580,37,46,245,13,120,72,40,174,71
18980,105,88,13,47,25,3,32,50,4,2,17,0,5,7,5,17,0
19001,6307,4625,611,2307,1282,425,1785,1897,330,613,1682,329,474,503,376,1402,280
19002,11500,8446,937,4541,2216,752,3499,3679,663,605,3054,508,847,941,758,2652,402
19003,5601,3147,500,1509,810,328,1067,1266,312,502,2454,980,703,433,338,1836,618
19004,3726,2642,264,1213,829,336,958,1339,178,167,1084,255,312,271,246,909,175
19006,7735,5804,457,2573,2153,621,2096,3110,193,405,1931,195,362,584,790,1760,171
19007,8499,5549,1135,2687,1316,411,1520,2150,1094,785,2950,637,858,936,519,2461,489
19008,7407,5696,479,2739,1867,611,2143,2839,219,495,1711,227,336,625,523,1499,212
19009,20,20,2,3,15,0,9,11,0,0,0,0,0,0,0,0,0
19010,8016,4756,552,2389,1360,455,1868,2248,321,319,3260,1160,711,570,819,2505,755
19012,2325,1829,199,943,516,171,690,804,168,167,496,46,187,88,175,442,54
19013,13610,8615,2391,3636,2072,516,1569,1977,3024,2045,4995,844,1661,1471,1019,4330,665
19014,7464,5646,931,2738,1714,263,2014,2587,484,561,1818,377,660,467,314,1519,299
19015,6527,4412,949,1992,1100,371,1403,1689,675,645,2115,432,727,601,355,1790,325
19018,9777,6060,1341,2715,1436,568,2183,2449,687,741,3717,885,1162,934,736,3195,522
19020,20734,13861,2577,7345,3311,628,5124,5872,1445,1420,6873,2142,2257,1554,920,5443,1430
19021,3799,2652,514,1409,573,156,982,1046,242,382,1147,281,347,371,148,960,187
19022,1570,990,245,456,194,95,300,336,219,135,580,82,253,158,87,529,51
19023,7456,5219,1218,2637,1075,289,1754,1415,1168,882,2237,280,827,663,467,1935,302
19025,1765,1538,123,880,433,102,690,729,56,63,227,31,67,86,43,211,16
19026,12863,8270,1456,4052,2015,747,3235,3373,692,970,4593,1197,1245,1001,1150,3975,618
19027,7688,5263,827,2590,1419,427,1795,2164,769,535,2425,611,793,579,442,2083,342
19029,1699,1114,219,520,243,132,293,489,185,147,585,69,204,205,107,496,89
19030,5098,3687,684,1825,944,234,1297,1652,330,408,1411,286,392,394,339,1265,146
19031,1760,1157,170,545,312,130,477,574,33,73,603,50,159,176,218,511,92
19032,2503,1853,325,895,481,152,643,716,247,247,650,80,202,247,121,561,89
19033,3179,2292,326,1057,686,223,817,995,196,284,887,162,156,243,326,804,83
19034,2060,1539,102,871,467,99,706,728,63,42,521,91,148,135,147,449,72
19035,1443,1057,53,481,387,136,445,557,32,23,386,6,53,109,218,346,40
19036,5505,3633,662,1717,879,375,1231,1533,417,452,1872,345,651,558,318,1613,259
19038,11895,8263,1135,4147,2169,812,3313,3579,557,814,3632,759,1136,949,788,3083,549
19040,8064,5658,775,2678,1604,601,2035,2675,401,547,2406,428,666,630,682,2105,301
19041,2527,1422,85,626,456,255,451,779,87,105,1105,248,174,239,444,962,143
19043,1127,824,203,330,200,91,300,327,60,137,303,68,64,89,82,261,42
19044,6525,4325,1040,2394,749,142,1960,1487,500,378,2200,709,883,472,136,1694,506
19046,8058,4941,444,2176,1630,691,1680,2574,254,433,3117,585,718,763,1051,2682,435
19047,10906,8309,1119,4881,1886,423,3592,3476,557,684,2597,500,1059,559,479,2193,404
19050,11664,7266,1305,3730,1634,597,2383,2532,1103,1248,4398,906,1634,994,864,3787,611
19053,9272,6966,1032,3489,1901,544,2473,3159,538,796,2306,468,833,596,409,1945,361
19054,6401,4795,705,2615,1109,366,1871,1973,475,476,1606,361,406,565,274,1342,264
19055,4885,3774,699,1863,908,304,1363,1571,387,453,1111,164,368,320,259,878,233
19056,5582,4100,644,2153,1073,230,1404,1649,579,468,1482,393,383,420,286,1239,243
19057,6173,4601,741,2272,1233,355,1657,1931,483,530,1572,301,510,406,355,1278,294
19061,9876,7191,1210,4041,1490,450,2888,2715,766,822,2685,468,765,885,567,2253,432
19063,14519,9154,995,4612,2583,964,3338,4416,588,812,5365,1247,1320,1181,1617,4674,691
19064,8636,6788,694,3222,2020,852,2485,3327,308,668,1848,199,354,665,630,1697,151
19066,2031,1526,109,852,418,147,695,686,70,75,505,96,135,190,84,399,106
19067,20290,14830,2399,8081,3595,755,6226,6228,1407,969,5460,1265,2229,1305,661,4428,1032
19070,2788,1863,289,910,448,216,665,818,156,224,925,198,281,248,198,809,116
19072,4132,2571,378,1247,703,243,1027,1224,167,153,1561,394,565,397,205,1367,194
19073,6369,4528,265,2163,1531,569,1529,2484,221,294,1841,176,484,459,722,1730,111
19074,2277,1527,257,781,361,128,628,549,137,213,750,148,286,221,95,646,104
19075,2775,2123,301,1050,547,225,782,1037,169,135,652,85,180,196,191,562,90
19076,2598,1627,349,837,324,117,612,604,248,163,971,251,283,286,151,818,153
19078,4594,2952,466,1404,812,270,1089,1301,246,316,1642,370,504,403,365,1454,188
19079,3365,2318,405,1148,552,213,540,715,597,466,1047,157,311,382,197,916,131
19081,3491,2470,250,1253,639,328,1046,1088,99,237,1021,214,154,341,312,903,118
19082,14825,9354,2182,4832,1667,673,3213,2779,1836,1526,5471,1489,1757,1276,949,4666,805
19083,13285,9951,1299,5061,2595,996,4213,4148,476,1114,3334,710,826,843,955,2934,400
19085,1902,1606,80,764,669,93,655,858,51,42,296,18,83,138,57,252,44
19086,4146,3190,341,1680,881,288,1246,1460,240,244,956,169,238,311,238,853,103
19087,12226,7760,979,3880,2327,574,3012,3719,411,618,4466,1052,1513,1180,721,3695,771
19090,7531,5191,933,2444,1378,436,1900,2189,440,662,2340,460,741,649,490,2026,314
19094,1786,1064,159,444,323,138,259,513,146,146,722,108,182,225,207,607,115
19095,2700,1746,120,684,574,368,457,1069,111,109,954,49,210,176,519,910,44
19096,5277,3694,349,1852,952,541,1557,1752,199,186,1583,159,342,487,595,1518,65
19102,2596,531,299,96,84,52,66,394,15,56,2065,1178,510,251,126,1804,261
19103,13297,2866,867,911,759,329,522,1973,127,244,10431,4869,2137,1668,1757,8979,1452
19104,17293,6276,2038,2715,1064,459,1016,1332,2224,1704,11017,6387,2318,1466,846,8301,2716
19106,5257,1607,377,549,573,108,239,1153,111,104,3650,1384,1409,670,187,3132,518
19107,6627,1269,543,447,222,57,300,732,73,164,5358,3115,1368,562,313,4484,874
19108,0,0,0,0,0,0,0,0,0,0,0,0,0,0,0,0,0
19111,24074,15077,2996,6883,3337,1861,5010,6206,1961,1900,8997,1584,2432,2308,2673,8084,913
19112,0,0,0,0,0,0,0,0,0,0,0,0,0,0,0,0,0
19113,48,31,11,14,6,0,14,12,0,5,17,5,0,12,0,7,10
19114,13407,8204,1579,3315,2419,891,2202,3940,964,1098,5203,969,1359,1721,1154,4503,700
19115,13758,8803,1087,3546,2854,1316,2531,4589,579,1104,4955,587,941,1556,1871,4473,482
19116,12588,8792,1544,4151,2450,647,2792,4092,891,1017,3796,823,1056,995,922,3222,574
19118,4320,2278,328,1052,686,212,690,1056,229,303,2042,582,652,447,361,1758,284
19119,12104,7236,1152,3424,1910,750,1771,2564,1621,1280,4868,1159,1725,1305,679,4143,725
19120,22447,16823,4515,9033,2416,859,5198,3385,5032,3208,5624,1142,2034,1488,960,4698,926
19121,12578,7714,1624,3686,1642,762,640,1030,3178,2866,4864,664,1421,1906,873,4226,638
19122,5791,3900,1010,1699,930,261,603,867,1337,1093,1891,230,671,683,307,1599,292
19123,4097,1968,560,902,382,124,356,406,656,550,2129,465,766,586,312,1799,330
19124,22341,15357,4623,6863,2753,1118,4245,3909,4445,2758,6984,1349,2218,1868,1549,6024,960
19125,8417,5537,1332,2586,1256,363,1387,1464,1501,1185,2880,620,886,840,534,2427,453
19126,5906,3843,670,1842,1072,259,926,1097,933,887,2063,390,744,632,297,1741,322
19127,2417,1010,233,411,268,98,285,333,142,250,1407,813,292,157,145,992,415
19128,15952,8765,1695,4270,1943,857,2673,3665,1072,1355,7187,2566,1807,1609,1205,5576,1611
19129,4119,2257,441,1018,541,257,480,671,434,672,1862,699,566,417,180,1395,467
19130,11717,4137,1152,1750,874,361,844,1794,604,895,7580,3448,2314,1175,643,5896,1684
19131,19002,10215,2023,4357,2920,915,1627,3005,2482,3101,8787,2264,2210,2481,1832,7604,1183
19132,15725,10010,2090,4314,2831,775,1203,1651,3452,3704,5715,671,1847,2037,1160,4943,772
19133,8624,6347,1769,2950,1370,258,985,1055,2491,1816,2277,302,763,922,290,1962,315
19134,19938,13764,4554,5924,2455,831,3546,3263,4317,2638,6174,986,1847,2102,1239,5358,816
19135,12220,7924,1742,3526,1820,836,2545,2862,1225,1292,4296,836,1268,1111,1081,3831,465
19136,13378,8564,1735,3840,2106,883,2642,3121,1395,1406,4814,667,1478,1518,1151,4306,508
19137,3187,2055,378,933,532,212,567,775,343,370,1132,119,345,340,328,983,149
19138,12276,8880,1383,4005,2899,593,1458,2447,2287,2688,3396,493,1091,1381,431,2994,402
19139,17495,10493,2549,4702,2293,949,1360,2032,3820,3281,7002,950,2313,2278,1461,6293,709
19140,18906,13309,3329,6440,2704,836,2326,2431,4899,3653,5597,657,1902,2002,1036,4731,866
19141,12161,7871,1736,3665,2038,432,1415,1949,2415,2092,4290,854,1326,1522,588,3731,559
19142,10008,7212,2024,3420,1401,367,1751,1509,2610,1342,2796,425,948,849,574,2512,284
19143,26364,16759,3278,7284,4863,1334,2301,4196,5134,5128,9605,1923,3379,3154,1149,8168,1437
19144,19515,10277,2847,4464,2285,681,1869,2614,3414,2380,9238,2856,3239,2150,993,7903,1335
19145,18079,11583,2243,5007,3270,1063,2435,3745,2576,2827,6496,930,1841,2241,1484,5696,800
19146,14821,7894,2078,3433,1669,714,1140,1742,2654,2358,6927,1849,2170,1837,1071,5621,1306
19147,16203,6746,1510,2894,1727,615,1602,2555,870,1719,9457,3295,3196,1911,1055,7390,2067
19148,19196,12534,2457,5362,3397,1318,3034,4600,2131,2769,6662,1020,1646,2330,1666,5838,824
19149,18978,12654,2896,5594,2644,1520,4574,4221,1802,2057,6324,1158,1732,1678,1756,5549,775
19150,9864,6882,905,3410,2292,275,1336,2455,1332,1759,2982,355,1191,1217,219,2664,318
19151,12050,7884,1787,3725,1514,858,1941,2138,2082,1723,4166,889,1361,1201,715,3478,688
19152,13300,8278,1246,3441,2334,1257,2325,3935,768,1250,5022,848,875,1485,1814,4480,542
19153,5144,3299,693,1502,858,246,712,1176,774,637,1845,381,659,545,260,1565,280
19154,12803,9612,1766,4312,3023,511,3232,4242,1022,1116,3191,751,876,1133,431,2680,511
19301,2752,1862,279,875,454,254,751,907,66,138,890,186,235,264,205,745,145
19310,957,745,165,396,138,46,309,302,107,27,212,55,56,59,42,170,42
19311,1582,1323,221,781,242,79,628,489,87,119,259,52,118,43,46,191,68
19312,4130,3136,284,1543,1073,236,1239,1614,105,178,994,107,304,364,219,849,145
19316,105,96,6,49,41,0,19,59,18,0,9,0,0,9,0,9,0
19317,3360,2680,178,1423,942,137,1040,1323,157,160,680,57,302,253,68,550,130
19319,23,23,6,8,0,9,14,9,0,0,0,0,0,0,0,0,0
19320,14775,10905,2016,5717,2446,726,3864,4391,1470,1180,3870,582,1298,1151,839,3267,603
19330,1536,1215,194,630,334,57,452,600,104,59,321,28,119,111,63,252,69
19333,3274,1853,260,1023,451,119,842,831,132,48,1421,452,423,360,186,1175,246
19335,14403,11243,1874,6943,1966,460,5471,4275,843,654,3160,802,1182,797,379,2572,588
19341,5971,3925,855,2017,889,164,1559,1828,240,298,2046,702,688,429,227,1663,383
19342,4724,3680,418,2030,1060,172,1534,1782,149,215,1044,116,351,447,130,901,143
19343,2350,1973,222,1300,427,24,1018,818,68,69,377,36,174,115,52,314,63
19344,3381,2524,508,1308,540,168,1104,981,193,246,857,117,232,233,275,693,164
19345,0,0,0,0,0,0,0,0,0,0,0,0,0,0,0,0,0
19348,6718,4716,683,2560,1079,394,2014,2122,229,351,2002,275,548,442,737,1756,246
19350,3053,2656,269,1666,639,82,1427,1009,137,83,397,39,186,114,58,304,93
19352,1924,1678,240,1120,285,33,1005,496,99,78,246,47,110,36,53,160,86
19355,8238,6088,616,3327,1814,331,2551,2703,421,413,2150,483,860,509,298,1768,382
19358,189,154,49,59,42,4,47,42,38,27,35,8,20,7,0,23,12
19362,1635,1321,333,688,273,27,559,535,138,89,314,62,131,100,21,264,50
19363,4725,3488,851,1636,767,234,1549,1401,332,206,1237,195,349,378,315,1047,190
19365,2295,1735,353,850,410,122,709,715,182,129,560,80,152,197,131,492,68
19367,57,42,7,23,12,0,14,23,3,2,15,6,0,0,9,9,6
19369,167,101,29,40,21,11,31,38,19,13,66,24,28,8,6,58,8
19372,544,401,86,224,66,25,167,157,43,34,143,55,57,24,7,122,21
19373,693,651,30,433,164,24,359,218,42,32,42,0,23,12,7,33,9
19374,293,231,62,110,38,21,87,114,11,19,62,0,9,53,0,54,8
19380,18093,12615,1972,6539,3341,763,5095,5703,895,922,5478,1814,1511,1253,900,4389,1089
19382,17861,11910,1750,6535,3044,581,4869,5443,889,709,5951,2524,1814,1166,447,4228,1723
19390,3539,2798,400,1623,578,197,1334,1107,206,151,741,131,231,225,154,593,148
19401,14842,8983,2153,3916,2153,761,2208,3212,1791,1772,5859,1473,1893,1570,923,4819,1040
19403,15784,10595,1680,5229,2938,748,4091,5058,652,794,5189,1307,1911,1174,797,4084,1105
19405,2141,1297,300,590,347,60,400,445,166,286,844,254,222,211,157,711,133
19406,9664,5629,1081,2409,1697,442,1825,2952,325,527,4035,1774,1122,709,430,3132,903
19421,33,33,3,22,8,0,14,16,3,0,0,0,0,0,0,0,0
19422,7003,5078,568,2696,1481,333,2110,2422,276,270,1925,296,638,505,486,1586,339
19425,2646,2086,229,1321,446,90,1063,868,71,84,560,130,244,119,67,428,132
19426,9529,7470,1472,4047,1701,250,3601,3017,374,478,2059,555,890,405,209,1620,439
19428,6970,4178,709,2097,1007,365,1320,1794,403,661,2792,1210,571,529,482,2156,636
19435,35,28,0,10,18,0,0,28,0,0,7,0,0,0,7,7,0
19436,291,89,0,17,27,45,17,72,0,0,202,0,12,0,190,202,0
19437,193,164,0,83,65,16,45,119,0,0,29,0,14,8,7,21,8
19438,7350,5851,1076,3272,1236,267,2832,2415,342,262,1499,326,592,389,192,1235,264
19440,6722,4843,770,2763,1072,238,2114,2061,333,335,1879,562,564,481,272,1581,298
19444,3783,2774,450,1383,754,187,1221,1226,137,190,1009,284,357,255,113,872,137
19446,19996,13787,2393,7228,3216,950,5565,6133,1012,1077,6209,1391,1916,1494,1408,5362,847
19453,720,451,67,231,109,44,131,196,54,70,269,61,132,61,15,226,43
19454,9589,6664,1206,3516,1557,385,2875,2941,441,407,2925,859,1012,629,425,2460,465
19457,66,51,19,32,0,0,37,14,0,0,15,0,9,6,0,6,9
19460,13013,8712,1450,4528,2223,511,3320,4015,713,664,4301,1142,1415,1036,708,3691,610
19462,5516,3942,429,1785,1304,424,1228,2153,204,357,1574,323,418,433,400,1372,202
19464,16656,11330,2638,5465,2353,874,4056,4584,1634,1056,5326,988,1660,1549,1129,4494,832
19465,5428,3948,476,2057,1171,244,1437,1944,265,302,1480,313,520,344,303,1201,279
19468,8173,5665,1443,2933,1006,283,2662,2264,362,377,2508,685,909,604,310,2062,446
19472,89,74,6,43,19,6,43,31,0,0,15,0,0,10,5,15,0
19473,4647,3473,829,1943,567,134,1670,1446,191,166,1174,322,403,251,198,907,267
19474,312,203,31,81,80,11,64,126,6,7,109,11,73,25,0,90,19
19475,3611,2570,496,1388,559,127,988,987,378,217,1041,224,300,265,252,864,177
19478,78,51,0,36,15,0,31,15,5,0,27,0,14,9,4,27,0
19492,128,85,17,21,43,4,27,48,0,10,43,13,6,20,4,36,7
19501,404,287,71,140,47,29,119,125,9,34,117,26,30,34,27,97,20
19503,397,293,65,124,75,29,101,133,28,31,104,8,25,32,39,94,10
19504,1963,1554,230,834,417,73,706,641,99,108,409,90,145,123,51,330,79
19505,934,713,101,379,195,38,243,383,37,50,221,35,75,83,28,166,55
19506,2336,1797,235,954,486,122,658,897,131,111,539,85,193,115,146,426,113
19507,1300,1030,211,483,277,59,405,495,60,70,270,34,142,56,38,203,67
19508,5715,4348,781,2153,1174,240,1657,2124,309,258,1367,182,520,355,310,1094,273
19510,1804,1452,308,777,344,23,688,610,60,94,352,68,163,77,44,235,117
19511,112,92,15,41,34,2,31,53,4,4,20,4,5,5,6,17,3
19512,6822,4959,822,2538,1271,328,1802,2392,358,407,1863,393,467,523,480,1552,311
19516,118,86,16,36,27,7,30,50,4,2,32,4,21,7,0,20,12
19518,4078,3165,729,1541,749,146,1308,1401,215,241,913,113,305,290,205,736,177
19519,48,26,0,16,10,0,5,17,0,4,22,7,0,15,0,18,4
19520,2238,1779,215,900,562,102,667,969,66,77,459,70,141,161,87,426,33
19522,5317,4059,677,2200,991,191,1659,1913,236,251,1258,245,402,336,275,1006,252
19523,55,24,0,9,15,0,9,15,0,0,31,0,10,14,7,31,0
19525,3487,2847,395,1744,612,96,1384,1074,220,169,640,127,165,204,144,522,118
19526,4211,2947,550,1460,732,205,1019,1465,255,208,1264,244,350,367,303,1058,206
19529,1100,895,103,574,170,48,396,419,35,45,205,51,63,50,41,154,51
19530,4530,2860,409,1426,832,193,1044,1413,168,235,1670,694,352,285,339,1035,635
19533,2260,1675,281,818,464,112,541,883,150,101,585,127,219,176,63,470,115
19534,774,604,86,345,144,29,184,292,76,52,170,38,46,58,28,126,44
19536,186,125,27,60,22,16,32,61,19,13,61,31,11,10,9,35,26
19539,1628,1282,158,725,348,51,512,613,60,97,346,79,65,130,72,259,87
19540,4252,3325,513,1842,872,98,1422,1441,249,213,927,136,314,281,196,746,181
19541,1219,1034,121,607,252,54,426,473,40,95,185,17,103,44,21,128,57
19543,1211,961,197,485,222,57,455,423,29,54,250,52,95,64,39,199,51
19544,70,50,8,29,8,5,21,25,4,0,20,0,10,0,10,20,0
19545,60,60,30,8,9,13,30,11,0,19,0,0,0,0,0,0,0
19547,1425,1043,147,506,297,93,400,536,55,52,382,72,128,115,67,322,60
19549,120,80,11,41,26,2,24,43,3,10,40,8,14,13,5,33,7
19550,141,109,21,55,29,4,49,45,4,11,32,15,5,9,3,16,16
19551,1901,1435,220,760,359,96,526,704,92,113,466,92,133,138,103,390,76
19554,86,58,18,23,14,3,18,25,6,9,28,7,7,2,12,23,5
19555,1480,1066,195,445,361,65,338,582,67,79,414,80,92,130,112,341,73
19559,139,85,11,37,29,8,22,48,5,10,54,8,16,9,21,50,4
19560,2863,1908,264,796,641,207,529,1076,153,150,955,88,274,319,274,783,172
19562,858,584,95,269,138,82,213,285,41,45,274,67,74,46,87,205,69
19565,2832,1984,389,1015,397,183,774,954,154,102,848,75,211,312,250,754,94
19567,1822,1294,251,624,339,80,520,622,106,46,528,112,163,131,122,416,112
19601,11682,7268,2369,3117,1300,482,1804,1861,2307,1296,4414,909,1479,1145,881,3697,717
19602,6721,3677,1256,1515,702,204,987,950,1118,622,3044,621,878,899,646,2559,485
19604,8326,5591,1661,2337,1176,417,1840,1923,1214,614,2735,532,928,670,605,2225,510
19605,6812,4798,699,2147,1541,411,1435,2581,418,364,2014,288,494,610,622,1682,332
19606,11660,8400,1442,4276,2102,580,3078,3987,765,570,3260,744,1004,809,703,2678,582
19607,9120,5502,880,2338,1607,677,1620,3126,464,292,3618,826,1047,837,908,2993,625
19608,6355,4994,655,2669,1314,356,1928,2375,391,300,1361,305,399,354,303,1120,241
19609,3978,2687,376,1148,831,332,768,1452,245,222,1291,327,361,349,254,1073,218
19610,5948,3871,350,1742,1260,519,1326,2132,156,257,2077,334,371,595,777,1823,254
19611,3879,2378,736,996,430,216,628,878,593,279,1501,371,502,391,237,1269,232
19701,11096,8471,2129,4970,1244,128,3883,3088,953,547,2625,978,1160,440,47,1949,676
19702,16233,11560,3725,6152,1479,204,4881,3572,2054,1053,4673,1890,1877,729,177,3400,1273
19703,6456,4016,1058,1919,783,256,1256,1369,886,505,2440,520,857,558,505,2086,354
19706,615,427,69,203,135,20,103,158,91,75,188,18,68,86,16,164,24
19707,5207,4306,481,2489,1046,290,2046,1945,131,184,901,54,312,304,231,788,113
19709,6527,5509,1251,3183,950,125,2593,2050,543,323,1018,172,431,274,141,824,194
19710,16,8,0,0,8,0,0,8,0,0,8,0,0,0,8,8,0
19711,18925,12117,2128,6430,3101,458,4811,5516,919,871,6808,3469,1586,1092,661,4239,2569
19713,12001,7923,1860,3912,1807,344,2718,3152,1070,983,4078,1520,1191,948,419,3200,878
19720,20608,14525,3554,6807,3355,809,4904,5389,2341,1891,6083,1475,2122,1593,893,4911,1172
19730,169,109,10,34,40,25,24,53,7,25,60,15,14,10,21,46,14
19731,45,23,0,7,16,0,7,16,0,0,22,0,10,0,12,12,10
19732,26,19,0,6,13,0,0,19,0,0,7,0,0,7,0,7,0
19733,28,6,4,0,0,2,4,2,0,0,22,9,6,7,0,13,9
19734,2018,1643,159,947,451,86,613,820,104,106,375,46,178,133,18,311,64
19736,22,22,0,9,13,0,9,13,0,0,0,0,0,0,0,0,0
19801,5895,3267,1114,1349,615,189,446,609,1336,876,2628,467,904,829,428,2206,422
19802,9941,6271,1461,3165,1385,260,1202,1703,1968,1398,3670,592,1342,1220,516,3062,608
19803,8471,6334,673,2915,1980,766,2157,3462,307,408,2137,152,558,630,797,1921,216
19804,7359,4902,898,2254,1273,477,1566,2072,578,686,2457,425,687,674,671,2045,412
19805,15412,9758,2495,4399,2061,803,2623,3203,2267,1665,5654,1044,1987,1457,1166,4661,993
19806,5490,1857,365,672,560,260,352,1040,180,285,3633,1385,980,560,708,3062,571
19807,3182,2164,236,885,806,237,662,1353,76,73,1018,143,202,218,455,952,66
19808,15962,10848,1731,5075,3172,870,3694,4913,1048,1193,5114,1110,1741,1570,693,4224,890
19809,6360,3960,836,1837,920,367,1228,1798,513,421,2400,586,814,610,390,1976,424
19810,10077,7271,834,3521,2366,550,2579,3640,444,608,2806,548,815,879,564,2351,455
19901,12257,8456,2569,3723,1770,394,2911,3127,1601,817,3801,1071,1076,1000,654,3054,747
19902,0,0,0,0,0,0,0,0,0,0,0,0,0,0,0,0,0
19904,9845,6668,1382,3154,1719,413,2142,2826,1103,597,3177,802,1119,807,449,2549,628
19930,1355,889,25,213,541,110,126,697,13,53,466,81,109,189,87,404,62
19931,90,61,9,31,15,6,18,39,1,3,29,2,10,5,12,27,2
19933,2619,1963,497,812,539,115,625,776,372,190,656,70,235,245,106,527,129
19934,3625,2700,513,1382,699,106,1019,1067,367,247,925,223,282,285,135,711,214
19938,2111,1667,302,816,481,68,596,753,177,141,444,95,147,127,75,363,81
19939,1917,1411,171,590,608,42,381,778,157,95,506,90,130,184,102,426,80
19940,1890,1372,295,653,341,83,558,553,175,86,518,111,138,165,104,436,82
19941,784,576,79,338,120,39,156,244,93,83,208,16,66,68,58,167,41
19942,27,20,5,8,7,0,4,8,3,5,7,0,4,3,0,3,4
19943,3587,2721,534,1460,661,66,1006,1155,350,210,866,164,348,222,132,648,218
19944,180,120,3,25,76,16,9,106,0,5,60,5,20,25,10,58,2
19945,2280,1632,199,783,554,96,423,814,233,162,648,83,182,274,109,590,58
19946,1327,859,151,413,243,52,269,425,99,66,468,90,124,164,90,373,95
19947,4821,3512,914,1607,773,218,1159,1509,577,267,1309,214,341,443,311,1055,254
19950,1851,1352,335,527,380,110,458,658,141,95,499,80,172,132,115,417,82
19951,398,308,42,117,135,14,83,197,21,7,90,0,21,44,25,85,5
19952,3084,2323,559,1046,598,120,767,988,378,190,761,90,255,276,140,615,146
19953,1516,1191,231,580,315,65,397,502,161,131,325,41,167,85,32,241,84
19954,548,417,77,216,97,27,150,178,49,40,131,27,44,17,43,115,16
19955,82,67,13,29,22,3,24,23,10,10,15,3,7,2,3,12,3
19956,5073,3783,927,1630,1015,211,1229,1705,478,371,1290,125,443,404,318,1043,247
19958,6447,4203,382,1541,1801,479,959,2591,323,330,2244,239,640,775,590,1824,420
19960,1772,1385,237,738,312,98,411,662,197,115,387,58,131,138,60,323,64
19962,1992,1606,407,871,264,64,647,558,265,136,386,78,144,140,24,316,70
19963,6039,4221,760,2009,1134,318,1402,1903,646,270,1818,256,483,631,448,1563,255
19964,363,283,26,168,81,8,138,106,34,5,80,16,22,35,7,71,9
19966,7602,5369,805,1947,2168,449,1220,3179,571,399,2233,232,535,960,506,1878,355
19967,200,128,26,53,36,13,31,81,12,4,72,1,27,37,7,57,15
19968,2644,1805,276,845,569,115,581,887,177,160,839,107,283,299,150,630,209
19970,2065,1460,68,449,777,166,259,1029,74,98,605,54,141,256,154,506,99
19971,4779,2716,303,981,1170,262,539,1687,307,183,2063,244,723,645,451,1591,472
19973,8031,5849,1120,2841,1413,475,1669,2627,1050,503,2182,273,673,724,512,1846,336
19975,2701,1972,217,602,917,236,370,1252,171,179,729,71,189,295,174,582,147
19977,4466,3195,657,1561,816,161,1047,1389,522,237,1271,251,325,440,255,1032,239
19979,222,181,20,116,36,9,63,86,15,17,41,10,7,22,2,30,11
19980,24,18,0,16,2,0,12,4,0,2,6,3,3,0,0,3,3
20001,12088,6084,1543,2771,1296,474,948,1131,2021,1984,6004,1363,2067,1717,857,4916,1088
20002,21258,10308,2235,4235,2771,1067,1245,2848,2850,3365,10950,3207,3949,2392,1402,8710,2240
20003,10171,4082,954,1828,1031,269,659,1602,930,891,6089,2093,2340,1182,474,4572,1517
20004,559,118,19,66,33,0,6,74,29,9,441,163,187,81,10,421,20
20005,6265,1384,609,522,191,62,384,367,220,413,4881,2094,1676,729,382,4052,829
20006,657,34,34,0,0,0,6,14,0,14,623,532,60,8,23,514,109
20007,12684,4295,911,1870,1184,330,1262,2503,237,293,8389,4228,2251,1350,560,6227,2162
20008,16097,4687,1031,2028,1300,328,1283,2665,256,483,11410,4829,3775,1742,1064,9651,1759
20009,25025,6946,2621,2894,1203,228,1552,2366,1683,1345,18079,8640,6288,2259,892,13865,4214
20010,10891,5737,1672,2692,1103,270,1374,1538,1328,1497,5154,2030,1805,857,462,3959,1195
20011,22918,13553,2019,5641,4147,1746,2503,4253,2456,4341,9365,1403,3463,2849,1650,7988,1377
20012,5485,3235,381,1399,1072,383,588,1347,532,768,2250,324,946,607,373,1862,388
20015,6014,3530,386,1891,1029,224,1521,1527,213,269,2484,528,732,549,675,2002,482
20016,14048,6355,954,3002,1817,582,2171,3306,340,538,7693,2512,2139,1753,1289,6269,1424
20017,7081,3869,648,1644,1150,427,704,1341,763,1061,3212,658,1210,836,508,2649,563
20018,6910,3873,554,1499,1176,644,622,1158,788,1305,3037,344,691,1136,866,2702,335
20019,21321,13113,3122,5598,3111,1282,1320,2865,4972,3956,8208,1191,2870,2996,1151,7239,969
20020,19372,12230,3694,5163,2778,595,1420,2272,5215,3323,7142,1440,2865,2120,717,6168,974
20024,7003,2285,578,977,550,180,176,700,719,690,4718,1184,1756,1367,411,4216,502
20032,11567,7513,2411,3377,1571,154,897,1214,3560,1842,4054,1040,1592,1225,197,3502,552
20036,2981,374,110,192,58,14,43,282,29,20,2607,1300,958,286,63,2215,392
20037,6815,1006,280,312,340,74,95,708,22,181,5809,3002,1248,988,571,4847,962
20105,545,392,50,226,86,30,115,230,20,27,153,17,60,55,21,130,23
20106,1289,1129,160,609,346,14,458,510,62,99,160,11,58,51,40,148,12
20109,11055,7330,2780,3423,969,158,2818,2413,1404,695,3725,1217,1565,637,306,2833,892
20110,13014,9538,2330,5544,1498,166,4600,3099,1185,654,3476,1081,1419,748,228,2627,849
20111,7778,6229,1741,3293,1109,86,2737,2298,662,532,1549,337,728,359,125,1088,461
20112,5986,5327,737,3483,1044,63,2692,2156,208,271,659,89,313,217,40,475,184
20115,2145,1603,203,873,439,88,606,808,72,117,542,120,207,172,43,438,104
20117,1145,703,85,336,221,61,197,376,73,57,442,109,137,133,63,375,67
20118,92,47,4,33,6,4,27,16,1,3,45,11,14,10,10,35,10
20119,1231,1021,158,485,335,43,409,427,75,110,210,34,75,56,45,163,47
20120,11564,8957,1823,5878,1123,133,4879,2795,777,506,2607,1091,1039,266,211,1820,787
20121,9564,6421,2159,3742,465,55,3249,1835,865,472,3143,1475,1397,234,37,2100,1043
20124,4714,4075,363,2876,765,71,2204,1466,239,166,639,163,323,129,24,426,213
20129,48,38,0,29,9,0,21,17,0,0,10,0,0,0,10,5,5
20130,35,18,0,0,12,6,6,12,0,0,17,0,6,11,0,17,0
20132,3221,2488,334,1394,631,129,1128,1081,140,139,733,105,266,241,121,582,151
20135,1085,783,111,419,226,27,266,374,99,44,302,69,149,64,20,227,75
20136,2886,2466,832,1428,175,31,1508,758,122,78,420,190,173,48,9,293,127
20137,634,508,49,309,125,25,171,275,53,9,126,7,52,43,24,109,17
20138,41,41,4,22,7,8,11,26,4,0,0,0,0,0,0,0,0
20139,12,0,0,0,0,0,0,0,0,0,12,0,0,12,0,12,0
20140,21,21,5,6,10,0,5,10,6,0,0,0,0,0,0,0,0
20141,1078,927,139,529,221,38,454,420,28,25,151,18,67,47,19,124,27
20143,292,261,17,134,98,12,123,130,0,8,31,0,0,31,0,31,0
20144,385,318,5,209,84,20,90,180,19,29,67,0,47,0,20,47,20
20147,10300,7837,2308,4768,688,73,4495,2477,621,244,2463,944,982,385,152,1870,593
20148,1245,1067,370,646,51,0,678,328,54,7,178,66,91,10,11,109,69
20151,5394,4485,570,2960,920,35,2277,1537,321,350,909,222,453,163,71,613,296
20152,2452,1873,822,815,220,16,933,779,95,66,579,277,223,59,20,410,169
20155,2385,1937,391,945,544,57,661,989,187,100,448,119,204,108,17,335,113
20158,1096,860,81,495,243,41,356,417,51,36,236,34,76,78,48,211,25
20164,11754,8768,1886,5194,1615,73,4018,3148,853,749,2986,921,1294,533,238,2147,839
20165,9665,7438,1565,4667,1024,182,3820,2764,570,284,2227,694,1060,244,229,1702,525
20166,1487,1017,583,334,85,15,391,368,156,102,470,215,236,19,0,300,170
20169,1954,1590,171,962,431,26,637,833,54,66,364,39,203,100,22,243,121
20170,11900,9333,1862,6144,1246,81,4804,2921,958,650,2567,769,1116,599,83,1910,657
20171,11022,9296,1595,6245,1384,72,5230,3060,629,377,1726,743,705,178,100,1289,437
20175,6350,4570,957,2679,848,86,2134,1776,335,325,1780,493,585,496,206,1412,368
20176,6762,5061,1351,2807,796,107,2468,1780,509,304,1701,495,790,308,108,1250,451
20180,1572,1290,137,784,313,56,517,609,112,52,282,40,115,56,71,232,50
20181,2099,1728,190,982,494,62,763,831,49,85,371,26,178,144,23,283,88
20184,264,153,20,72,52,9,39,65,31,18,111,10,42,28,31,104,7
20186,4189,2709,527,1287,713,182,912,1267,330,200,1480,247,627,384,222,1225,255
20187,4418,3813,342,2269,1063,139,1680,1753,134,246,605,87,241,146,131,451,154
20190,6294,3348,981,1545,696,126,1055,1486,504,303,2946,990,922,689,345,2354,592
20191,11487,7726,1435,4141,1944,206,2977,3356,680,713,3761,875,1707,974,205,2880,881
20194,5456,3437,699,2144,556,38,1548,1401,309,179,2019,755,854,338,72,1634,385
20197,407,330,22,144,154,10,144,152,12,22,77,7,46,8,16,72,5
20198,875,565,64,273,207,21,194,289,36,46,310,32,130,74,74,261,49
20319,22,22,0,12,10,0,12,10,0,0,0,0,0,0,0,0,0
20332,219,214,115,94,5,0,121,68,25,0,5,0,5,0,0,5,0
20336,1139,1116,584,520,12,0,742,237,106,31,23,10,13,0,0,18,5
20375,0,0,0,0,0,0,0,0,0,0,0,0,0,0,0,0,0
20601,7650,6061,1434,3281,1168,178,2482,2179,880,520,1589,478,698,336,77,1143,446
20602,7529,5629,1626,2982,897,124,2107,1587,1291,644,1900,398,736,444,322,1541,359
20603,7001,5550,1178,3714,567,91,2693,1615,793,449,1451,421,602,304,124,1043,408
20606,173,127,23,42,53,9,43,71,0,13,46,12,8,19,7,39,7
20607,2420,2007,223,1286,449,49,851,808,206,142,413,51,203,117,42,333,80
20608,343,279,18,141,115,5,84,129,22,44,64,0,35,24,5,64,0
20609,488,386,63,193,98,32,122,182,40,42,102,9,26,43,24,89,13
20611,262,198,8,104,62,24,73,93,0,32,64,5,29,22,8,53,11
20612,90,51,8,8,26,9,0,42,0,9,39,15,0,24,0,39,0
20613,2917,2204,228,1178,591,207,773,937,132,362,713,42,221,334,116,565,148
20615,177,145,0,66,67,12,16,86,14,29,32,12,9,11,0,23,9
20616,1720,1221,304,597,277,43,453,435,188,145,499,91,170,153,85,389,110
20617,261,197,35,86,70,6,87,96,8,6,64,15,21,11,17,41,23
20618,221,143,22,61,41,19,45,72,19,7,78,0,27,29,22,71,7
20619,2514,1694,315,900,417,62,730,695,163,106,820,203,403,95,119,700,120
20620,628,422,72,250,66,34,142,173,51,56,206,45,74,87,0,168,38
20621,421,356,45,153,99,59,110,154,34,58,65,17,0,31,17,56,9
20622,999,860,124,462,213,61,383,320,69,88,139,35,66,33,5,102,37
20623,710,620,134,363,94,29,274,224,58,64,90,4,67,19,0,81,9
20624,287,232,83,107,42,0,83,51,77,21,55,4,7,30,14,55,0
20625,343,252,88,74,76,14,67,135,43,7,91,15,18,43,15,86,5
20626,195,138,11,29,62,36,6,92,11,29,57,9,12,36,0,44,13
20628,105,83,6,42,35,0,21,54,0,8,22,5,11,6,0,18,4
20629,163,117,19,58,27,13,54,63,0,0,46,0,0,26,20,46,0
20630,139,112,8,36,61,7,23,67,0,22,27,0,17,0,10,27,0
20632,195,146,21,86,34,5,54,67,20,5,49,0,17,27,5,41,8
20634,1940,1363,357,779,189,38,598,413,260,92,577,261,196,100,20,439,138
20636,2868,2188,329,1203,494,162,975,896,145,172,680,113,207,265,95,498,182
20637,1379,1167,81,718,325,43,403,648,71,45,212,7,81,108,16,170,42
20639,3703,3221,307,1949,893,72,1372,1412,269,168,482,71,161,144,106,411,71
20640,3082,2262,492,1087,480,203,699,876,400,287,820,88,292,317,123,687,133
20645,181,156,20,66,63,7,35,110,11,0,25,13,0,7,5,25,0
20646,5547,4384,676,2297,1257,154,1560,1952,568,304,1163,135,437,357,234,925,238
20650,3742,2854,453,1533,710,158,1061,1273,319,201,888,159,285,260,184,719,169
20653,7056,4746,1537,2313,717,179,1799,1675,973,299,2310,747,947,475,141,1792,518
20657,6142,4846,1269,2576,844,157,2259,1584,650,353,1296,200,573,346,177,987,309
20658,296,225,36,117,62,10,91,100,18,16,71,5,32,29,5,58,13
20659,7030,5777,1255,3178,1134,210,2673,2185,527,392,1253,256,505,396,96,933,320
20662,932,720,84,340,230,66,161,340,88,131,212,57,95,35,25,177,35
20664,968,711,94,364,214,39,200,293,120,98,257,44,80,74,59,206,51
20667,73,67,14,33,20,0,14,39,0,14,6,0,0,0,6,6,0
20670,822,510,312,198,0,0,458,21,20,11,312,287,25,0,0,293,19
20674,282,189,34,132,18,5,106,67,11,5,93,23,40,20,10,64,29
20675,609,482,41,187,239,15,141,273,40,28,127,15,55,43,14,108,19
20676,1150,932,176,450,249,57,416,397,53,66,218,30,86,79,23,171,47
20677,701,548,79,257,195,17,155,311,37,45,153,12,34,83,24,129,24
20678,3132,2389,424,1401,463,101,1000,903,247,239,743,77,259,241,166,585,158
20680,457,305,73,100,119,13,68,217,20,0,152,15,30,59,48,137,15
20684,440,299,42,138,100,19,103,142,38,16,141,39,47,27,28,113,28
20685,1840,1430,283,851,246,50,696,512,114,108,410,50,213,98,49,343,67
20687,146,70,8,33,16,13,0,47,7,16,76,5,26,32,13,65,11
20688,606,288,46,71,114,57,65,180,10,33,318,42,59,76,141,284,34
20689,318,276,37,147,74,18,114,101,28,33,42,0,23,14,5,37,5
20690,274,213,12,95,91,15,62,137,14,0,61,21,0,16,24,45,16
20692,189,106,43,31,32,0,47,39,8,12,83,0,43,28,12,83,0
20693,242,203,33,106,58,6,70,87,33,13,39,16,9,7,7,31,8
20695,1649,1396,291,707,361,37,559,574,173,90,253,95,65,93,0,198,55
20701,17,12,12,0,0,0,0,5,0,7,5,0,0,5,0,5,0
20705,8435,5718,1136,3003,1316,263,2091,2194,629,804,2717,947,1050,513,207,2034,683
20706,13021,9709,1937,4988,2371,413,2840,3305,1959,1605,3312,835,1352,854,271,2669,643
20707,10778,6299,1545,3384,1162,208,2188,2300,1019,792,4479,1561,1820,867,231,3527,952
20708,10283,6315,2166,3025,937,187,1974,2121,1543,677,3968,1598,1405,666,299,3158,810
20710,3234,1768,537,869,300,62,567,400,478,323,1466,395,516,367,188,1233,233
20711,2331,1665,327,788,461,89,550,692,226,197,666,57,231,273,105,543,123
20712,3691,2051,610,1007,355,79,568,421,569,493,1640,588,623,224,205,1325,315
20714,1602,1080,301,551,202,26,427,385,178,90,522,114,207,145,56,409,113
20715,8681,6879,804,3495,2234,346,2636,3207,511,525,1802,228,688,643,243,1326,476
20716,7517,5032,1210,2875,863,84,2142,1828,634,428,2485,758,1176,337,214,1954,531
20720,4817,3923,493,2692,672,66,1782,1433,472,236,894,159,533,168,34,729,165
20721,7539,5915,636,3972,1188,119,2671,2068,575,601,1624,330,758,296,240,1388,236
20722,1812,1228,205,687,244,92,405,311,225,287,584,50,254,178,102,505,79
20723,8694,6332,1639,3735,845,113,2914,2168,782,468,2362,874,990,395,103,1711,651
20724,5063,3332,937,1770,551,74,1308,1303,351,370,1731,605,785,280,61,1337,394
20732,2852,2199,439,1349,368,43,971,778,302,148,653,138,294,149,72,483,170
20733,1017,727,152,427,138,10,351,268,50,58,290,17,102,127,44,254,36
20735,10851,8653,1201,5086,2006,360,3199,3454,1007,993,2198,353,833,709,303,1812,386
20736,2145,1829,146,1135,475,73,817,778,115,119,316,20,148,112,36,242,74
20737,6337,4638,1355,2365,720,198,1729,1210,923,776,1699,433,793,360,113,1308,391
20740,8927,4457,739,2142,1145,431,1352,2025,413,667,4470,2411,938,664,457,2651,1819
20743,14883,10539,2271,4634,3136,498,2081,3023,2903,2532,4344,935,1891,1230,288,3642,702
20744,16824,13029,1676,7143,3808,402,4202,5386,1607,1834,3795,714,1705,1105,271,3181,614
20745,10424,7087,1869,3485,1584,149,1428,1802,2466,1391,3337,867,1522,806,142,2802,535
20746,11213,7347,2266,3541,1357,183,1593,1774,2547,1433,3866,888,1851,852,275,3153,713
20747,15183,10425,2767,5642,1776,240,2468,2466,3536,1955,4758,1456,1953,1101,248,4023,735
20748,15628,10327,2103,5029,2633,562,2307,3483,2422,2115,5301,1418,2122,1190,571,4386,915
20751,840,638,79,346,182,31,238,260,44,96,202,49,66,67,20,150,52
20754,2121,1858,154,1078,527,99,719,883,123,133,263,16,80,142,25,216,47
20755,2448,2391,1412,962,17,0,1665,365,328,33,57,15,42,0,0,57,0
20758,294,221,15,79,109,18,54,151,11,5,73,8,29,5,31,52,21
20759,551,479,27,273,147,32,222,227,17,13,72,0,42,23,7,44,28
20762,1918,1875,1088,787,0,0,1243,402,218,12,43,12,31,0,0,43,0
20763,872,619,181,343,62,33,228,131,201,59,253,73,106,50,24,199,54
20764,1498,1144,194,661,262,27,444,470,116,114,354,31,189,46,88,290,64
20765,148,128,6,66,33,23,29,86,0,13,20,0,7,13,0,20,0
20769,1648,1407,121,913,324,49,680,579,78,70,241,31,128,68,14,159,82
20770,9243,4903,1340,2708,716,139,1477,1495,1107,824,4340,1627,1710,696,307,3226,1114
20772,12396,9253,1836,4969,2215,233,3379,3534,1383,957,3143,903,1438,660,142,2514,629
20774,12214,8861,1384,5314,2025,138,2773,3028,1721,1339,3353,739,1622,821,171,2795,558
20776,1188,933,112,494,268,59,319,445,80,89,255,21,73,117,44,211,44
20777,956,821,62,478,251,30,411,345,7,58,135,18,46,51,20,107,28
20778,651,518,64,300,127,27,217,216,63,22,133,7,38,45,43,101,32
20779,456,345,39,240,50,16,173,149,8,15,111,12,50,33,16,98,13
20781,3858,2491,527,1438,447,79,887,719,535,350,1367,347,545,264,211,1097,270
20782,10676,6726,1691,3300,1399,336,2195,1970,1440,1121,3950,1062,1400,895,593,3167,783
20783,13844,9562,2928,4446,1788,400,3260,2816,1647,1839,4282,1539,1465,854,424,3040,1242
20784,9516,6699,1468,3621,1285,325,2119,1906,1579,1095,2817,676,1231,647,263,2298,519
20785,13059,10079,3154,4890,1788,247,2704,2381,3226,1768,2980,601,1320,862,197,2382,598
20794,3233,2355,542,1261,477,75,1032,812,279,232,878,210,368,217,83,690,188
20812,81,62,8,40,12,2,34,24,0,4,19,0,9,8,2,16,3
20814,12085,5903,940,2858,1493,612,2244,2776,422,461,6182,2064,1942,1141,1035,5084,1098
20815,12559,7353,712,3434,2266,941,2764,3668,451,470,5206,1110,1431,1166,1499,4495,711
20816,6063,4319,329,2187,1277,526,1832,2028,218,241,1744,191,484,559,510,1496,248
20817,13252,10177,740,5164,3223,1050,4117,4869,573,618,3075,366,772,1198,739,2646,429
20818,755,530,28,386,116,0,294,220,16,0,225,41,27,113,44,189,36
20832,8137,6786,868,4329,1465,124,3368,2288,600,530,1351,313,630,355,53,1107,244
20833,1994,1756,169,1059,491,37,931,702,77,46,238,12,137,45,44,203,35
20837,1992,1681,234,1144,264,39,862,573,177,69,311,48,138,74,51,251,60
20838,73,64,0,34,28,2,20,32,7,5,9,0,4,0,5,6,3
20839,38,33,2,13,18,0,10,20,1,2,5,0,3,2,0,5,0
20841,661,500,51,281,147,21,260,207,21,12,161,3,47,89,22,129,32
20842,721,542,33,293,170,46,176,306,23,37,179,10,69,64,36,130,49
20850,12033,8526,1326,4833,1968,399,3562,3361,902,701,3507,939,1233,932,403,2810,697
20851,4707,3269,686,1637,729,217,1221,1246,346,456,1438,344,625,296,173,1032,406
20852,15694,8768,1682,4080,2209,797,3046,4261,654,807,6926,1805,2260,1559,1302,5922,1004
20853,9579,7593,671,3686,2727,509,2710,3725,455,703,1986,186,700,786,314,1663,323
20854,15126,13537,627,7110,5126,674,5953,6461,607,516,1589,118,455,757,259,1313,276
20855,5436,4526,514,2676,1219,117,2102,1791,278,355,910,140,405,312,53,609,301
20860,423,255,30,78,80,67,40,128,61,26,168,0,49,48,71,152,16
20861,567,474,50,274,95,55,244,196,12,22,93,0,39,48,6,86,7
20862,112,108,0,63,39,6,26,73,9,0,4,0,4,0,0,0,4
20866,4090,2940,661,1736,486,57,1276,961,447,256,1150,345,540,200,65,861,289
20868,68,60,0,43,17,0,30,30,0,0,8,0,0,8,0,8,0
20871,972,821,90,480,222,29,339,401,28,53,151,5,64,54,28,118,33
20872,4011,3270,621,1944,594,111,1446,1133,542,149,741,100,343,188,110,599,142
20874,18689,12866,4018,7446,1284,118,5931,4061,2007,867,5823,2269,2633,834,87,4368,1455
20876,7674,5744,1603,3408,661,72,2848,1744,756,396,1930,770,800,303,57,1392,538
20877,10701,7055,1868,3782,1095,310,2770,2365,1170,750,3646,946,1199,629,872,3000,646
20878,19227,14659,2505,9085,2853,216,7333,5066,1301,959,4568,1337,2104,897,230,3481,1087
20879,7333,5424,1081,3509,798,36,2565,1549,682,628,1909,568,1023,283,35,1413,496
20880,183,141,11,79,41,10,71,63,4,3,42,2,25,10,5,30,12
20882,3868,3427,272,2205,856,94,1661,1303,206,257,441,60,204,123,54,312,129
20886,12573,8502,2027,4629,1639,207,3282,3194,1234,792,4071,1061,1693,1000,317,3219,852
20895,7243,4921,605,2402,1381,533,1798,2386,285,452,2322,257,796,717,552,1881,441
20896,236,178,15,70,71,22,66,82,6,24,58,3,17,9,29,44,14
20901,12440,8393,1774,4203,1775,641,3315,3255,919,904,4047,808,1662,904,673,3089,958
20902,15162,10565,2188,5100,2389,888,3863,4170,1183,1349,4597,816,1693,1169,919,3699,898
20903,7149,5368,1269,2784,1019,296,2018,1547,1020,783,1781,520,551,430,280,1286,495
20904,18129,12790,2591,6575,3040,584,4474,4814,1821,1681,5339,1907,1991,1093,348,4111,1228
20905,5814,5046,330,2877,1597,242,2228,2178,259,381,768,60,349,295,64,621,147
20906,23711,15232,2542,7491,3529,1670,5048,6299,2028,1857,8479,1245,2077,2189,2968,7114,1365
20910,16238,7885,1898,4262,1244,481,2755,3149,911,1070,8353,3105,2630,1400,1218,6655,1698
20912,9625,5652,1255,3373,855,169,2119,1612,1019,902,3973,1078,1687,801,407,3036,937
21001,7606,5269,1066,2566,1268,369,1518,2200,910,641,2337,345,774,758,460,2001,336
21005,807,733,383,350,0,0,551,100,82,0,74,23,51,0,0,67,7
21009,8672,6487,1698,3671,939,179,3209,2284,533,461,2185,753,780,369,283,1733,452
21010,249,243,111,132,0,0,165,55,18,5,6,0,6,0,0,6,0
21012,7514,5814,840,3299,1513,162,2591,2305,532,386,1700,368,715,452,165,1340,360
21013,1284,1153,74,618,360,101,500,580,26,47,131,18,35,46,32,117,14
21014,12281,8991,1388,5056,2162,385,4038,3655,803,495,3290,658,990,801,841,2833,457
21015,8395,6762,1087,3876,1479,320,3181,2648,515,418,1633,458,546,449,180,1340,293
21017,2351,1567,573,821,142,31,680,513,222,152,784,291,375,109,9,540,244
21028,984,828,31,425,316,56,268,463,14,83,156,25,35,66,30,135,21
21029,2323,2128,250,1461,379,38,1234,688,101,105,195,21,76,91,7,143,52
21030,10513,5772,1090,3068,1298,316,2220,2438,623,491,4741,2096,1358,732,555,3614,1127
21031,0,0,0,0,0,0,0,0,0,0,0,0,0,0,0,0,0
21032,2867,2181,249,1213,646,73,810,1156,91,124,686,176,303,188,19,529,157
21034,1307,989,141,431,334,83,286,455,100,148,318,40,86,80,112,285,33
21035,2490,2213,200,1172,745,96,857,1091,138,127,277,35,101,112,29,217,60
21036,691,613,57,384,147,25,302,242,30,39,78,23,0,39,16,78,0
21037,6210,4502,746,2195,1281,280,1675,2126,338,363,1708,366,722,426,194,1290,418
21040,7951,5983,1740,2952,1165,126,2051,1956,1403,573,1968,359,904,594,111,1573,395
21042,12009,10212,692,6132,2924,464,4906,4334,531,441,1797,203,801,486,307,1534,263
21043,11990,8278,1810,4875,1294,299,4156,2920,790,412,3712,1444,1408,529,331,2956,756
21044,16007,10533,2249,5630,2321,333,4136,4262,1337,798,5474,1529,2091,1220,634,4490,984
21045,14301,10048,2181,5637,2104,126,3943,3751,1485,869,4253,1258,1672,965,358,3318,935
21046,5913,4020,930,2486,548,56,1787,1585,469,179,1893,678,799,360,56,1442,451
21047,3904,3398,249,1850,1107,192,1352,1732,144,170,506,45,149,220,92,436,70
21048,3636,3053,365,1799,720,169,1225,1493,177,158,583,63,208,171,141,452,131
21050,5266,4260,627,2413,1070,150,1927,1884,243,206,1006,185,270,346,205,881,125
21051,25,25,0,18,7,0,18,7,0,0,0,0,0,0,0,0,0
21052,134,111,26,67,12,6,39,27,26,19,23,0,23,0,0,23,0
21053,960,794,96,451,218,29,360,338,56,40,166,7,62,35,62,146,20
21054,2304,1902,182,1147,540,33,849,839,101,113,402,51,167,127,57,300,102
21056,152,117,0,56,51,10,39,78,0,0,35,0,6,22,7,35,0
21057,1471,1084,61,502,392,129,370,627,13,74,387,43,71,114,159,314,73
21060,10567,6998,1424,3186,1964,424,2199,2877,941,981,3569,964,1134,950,521,2825,744
21061,19901,13163,3377,6027,3043,716,4271,4918,2301,1673,6738,2002,2435,1504,797,5314,1424
21071,143,126,10,58,52,6,60,50,8,8,17,5,6,0,6,12,5
21074,4641,3622,702,1962,833,125,1621,1482,348,171,1019,179,306,331,203,833,186
21075,7276,5121,1607,2757,574,183,2126,1729,811,455,2155,724,764,416,251,1585,570
21076,2600,2106,255,1242,513,96,851,933,171,151,494,108,214,144,28,383,111
21077,134,118,15,54,36,13,37,45,9,27,16,0,4,12,0,16,0
21078,6302,4210,811,2134,998,267,1542,1739,467,462,2092,400,779,635,278,1767,325
21082,377,291,16,129,122,24,105,165,21,0,86,0,20,33,33,79,7
21084,2484,2118,184,1215,608,111,849,1066,108,95,366,44,98,156,68,309,57
21085,5609,4246,597,2230,1205,214,1471,2101,361,313,1363,317,481,409,156,1101,262
21087,1876,1556,86,815,532,123,594,834,59,69,320,36,40,136,108,292,28
21090,3678,2729,316,1291,829,293,956,1322,174,277,949,166,303,261,219,800,149
21093,14474,9755,989,4555,3166,1045,3354,5115,578,708,4719,798,1372,1514,1035,4104,615
21102,3245,2602,360,1576,546,120,1191,1126,171,114,643,66,239,207,131,541,102
21104,1310,1170,162,760,221,27,612,476,50,32,140,14,25,74,27,132,8
21105,32,32,16,0,16,0,0,24,8,0,0,0,0,0,0,0,0
21108,6006,4806,603,2833,1266,104,1958,2005,549,294,1200,260,476,381,83,841,359
21111,1808,1395,118,770,421,86,550,651,77,117,413,74,171,92,76,277,136
21113,8022,5795,1872,2994,811,118,2509,2014,787,485,2227,901,796,361,169,1663,564
21114,9167,6753,1559,3852,1141,201,3110,2463,774,406,2414,758,993,571,92,1889,525
21117,16956,10877,3217,5612,1718,330,4241,4213,1512,911,6079,2668,2134,973,304,4628,1451
21120,2320,1956,131,1220,518,87,870,890,105,91,364,54,97,136,77,282,82
21122,20296,15882,2818,8588,3810,666,6486,6544,1476,1376,4414,959,1808,1111,536,3339,1075
21128,2639,1982,296,972,584,130,759,985,63,175,657,256,247,90,64,486,171
21130,49,44,16,11,9,8,16,28,0,0,5,0,0,5,0,5,0
21131,2695,2346,68,1287,814,177,983,1171,106,86,349,35,134,150,30,259,90
21132,868,721,84,405,213,19,330,291,38,62,147,45,44,22,36,119,28
21133,10480,7532,1450,4008,1684,390,2514,2660,1335,1023,2948,671,1155,716,406,2493,455
21136,11125,8273,1478,4509,1996,290,3504,3323,899,547,2852,768,1098,578,408,2327,525
21140,1275,1021,106,577,325,13,364,541,45,71,254,23,145,42,44,195,59
21144,9654,7851,1727,4409,1543,172,2994,3042,1163,652,1803,411,844,350,198,1348,455
21146,8677,7100,628,3935,2101,436,2977,3245,414,464,1577,136,649,451,341,1222,355
21152,2061,1291,178,682,359,72,474,656,105,56,770,182,318,204,66,579,191
21154,1927,1563,209,864,403,87,652,654,94,163,364,26,136,153,49,283,81
21155,971,711,79,332,260,40,208,456,15,32,260,19,94,103,44,230,30
21156,155,146,0,80,58,8,42,104,0,0,9,0,9,0,0,9,0
21157,12622,9292,1573,4939,2257,523,3551,4095,1034,612,3330,536,1013,1048,733,2865,465
21158,6394,4979,926,2742,1078,233,2130,2177,423,249,1415,323,460,314,318,1120,295
21160,818,702,120,346,208,28,287,330,50,35,116,0,71,12,33,80,36
21161,1795,1504,186,870,376,72,695,680,96,33,291,34,80,147,30,246,45
21162,1091,853,114,364,287,88,243,465,40,105,238,34,86,56,62,217,21
21163,1051,803,68,486,217,32,331,396,39,37,248,22,94,90,42,200,48
21201,8150,2046,802,818,301,125,178,602,797,469,6104,2040,1579,1582,903,5253,851
21202,7724,3044,938,1412,570,124,217,571,1358,898,4680,1755,1547,1071,307,3808,872
21204,7095,3602,325,1601,1024,652,1183,1835,244,340,3493,1132,675,734,952,2578,915
21205,6321,4461,1109,2117,1032,203,559,916,1616,1370,1860,209,511,766,374,1551,309
21206,19898,12740,3051,6217,2597,875,3647,4276,2776,2041,7158,1871,2676,1578,1033,6017,1141
21207,18285,12427,2421,5828,3423,755,2916,4092,2953,2466,5858,1235,2254,1613,756,4994,864
21208,13663,8589,1005,3606,2807,1171,2221,4525,857,986,5074,774,1492,1421,1387,4392,682
21209,10553,6016,1193,2818,1353,652,2276,2848,471,421,4537,1456,1320,906,855,3780,757
21210,5652,2461,325,1198,723,215,883,1298,115,165,3191,1257,780,691,463,2625,566
21211,7806,3734,883,1512,988,351,733,1631,658,712,4072,1184,1249,882,757,3226,846
21212,13403,8272,1648,3894,2192,538,2423,3086,1312,1451,5131,1042,1812,1478,799,4300,831
21213,13500,9364,1765,4415,2385,799,1351,2185,2817,3011,4136,378,1597,1267,894,3488,648
21214,8334,5234,1122,2621,1078,413,1789,1826,865,754,3100,660,1187,668,585,2357,743
21215,25144,16230,2646,6977,5209,1398,2596,5182,3968,4484,8914,1074,2690,3186,1964,7939,975
21216,13812,9053,1785,3842,2405,1021,1061,2365,2738,2889,4759,395,1645,1569,1150,4173,586
21217,16820,8943,2459,3954,1911,619,1047,1802,3361,2733,7877,1665,2571,2430,1211,6541,1336
21218,21035,10774,2327,4724,3074,649,1831,3212,2678,3053,10261,3741,3255,2338,927,8076,2185
21219,3527,2566,267,1286,792,221,801,1231,225,309,961,90,319,269,283,841,120
21220,14118,9931,2202,4686,2450,593,3176,4016,1716,1023,4187,992,1509,1076,610,3270,917
21221,17368,11387,2810,5297,2495,785,3158,4468,2417,1344,5981,1275,1946,1556,1204,5030,951
21222,21957,15212,2870,6620,4242,1480,4193,6347,2402,2270,6745,799,1989,2412,1545,5789,956
21223,10977,6915,1726,3063,1652,474,1056,1532,2164,2163,4062,392,1618,1330,722,3217,845
21224,19718,11335,2565,4925,2777,1068,2350,4066,2620,2299,8383,1934,2616,2070,1763,6604,1779
21225,11878,8145,2148,3387,1901,709,1822,2472,2318,1533,3733,636,1343,1085,669,2981,752
21226,2700,1648,561,678,309,100,567,514,257,310,1052,210,493,215,134,779,273
21227,12975,8883,2063,4187,1957,676,2577,3458,1735,1113,4092,1055,1194,1145,698,3312,780
21228,18741,11856,1659,5924,2919,1354,4063,5453,978,1362,6885,1301,1762,1551,2271,5916,969
21229,19435,12361,2920,5490,3026,925,2748,3724,3112,2777,7074,1503,2561,2025,985,5904,1170
21230,14002,7584,1968,3417,1780,419,1633,2924,1597,1430,6418,2050,1978,1380,1010,4790,1628
21231,7605,3285,1059,1437,588,201,496,1028,1085,676,4320,1476,1438,960,446,3367,953
21234,29418,18510,3451,8772,4330,1957,5528,7963,2829,2190,10908,2780,3252,2425,2451,9054,1854
21236,15243,10198,1757,5490,2267,684,3801,4171,1146,1080,5045,1474,1542,1245,784,3972,1073
21237,10281,6730,1401,3109,1627,593,2113,2958,875,784,3551,1084,1119,850,498,2824,727
21239,11925,7390,1417,3707,1788,478,1768,2405,1708,1509,4535,1152,1573,1046,764,3756,779
21244,12450,8192,2409,4070,1412,301,2476,2353,2031,1332,4258,1390,1667,879,322,3335,923
21286,8375,4824,425,2201,1505,693,1527,2511,350,436,3551,726,804,786,1235,2964,587
21401,20367,13336,2163,6229,3810,1134,4093,6239,1582,1422,7031,1463,2313,1931,1324,5747,1284
21402,480,432,171,212,49,0,303,90,26,13,48,31,6,6,5,30,18
21403,12736,7665,1360,3626,2120,559,2182,3586,987,910,5071,1324,1966,1315,466,3832,1239
21405,230,195,17,100,55,23,64,113,12,6,35,0,20,9,6,24,11
21502,17483,11090,2070,4782,3224,1014,3366,5354,1341,1029,6393,1006,1446,2145,1796,5598,795
21520,761,554,94,273,136,51,209,245,69,31,207,28,43,65,71,187,20
21521,561,421,57,190,143,31,141,201,42,37,140,5,23,55,57,130,10
21522,11,11,0,0,11,0,0,5,0,6,0,0,0,0,0,0,0
21523,111,84,0,55,23,6,32,45,7,0,27,0,3,4,20,27,0
21524,290,200,42,59,79,20,49,133,6,12,90,9,27,33,21,82,8
21528,52,33,9,0,16,8,9,16,0,8,19,0,9,0,10,19,0
21529,264,201,36,91,60,14,84,101,7,9,63,0,10,30,23,55,8
21530,551,454,102,197,129,26,175,236,37,6,97,5,45,22,25,89,8
21531,951,668,140,264,217,47,213,321,79,55,283,28,88,108,59,233,50
21532,5420,3226,600,1353,1042,231,1004,1606,315,301,2194,850,352,458,534,1598,596
21536,1465,1082,245,489,292,56,356,514,168,44,383,47,118,109,109,346,37
21538,340,249,43,93,80,33,89,120,12,28,91,12,18,43,18,91,0
21539,1143,807,161,330,232,84,286,338,63,120,336,45,48,138,105,303,33
21540,37,17,4,4,3,6,8,9,0,0,20,0,0,8,12,20,0
21541,489,316,34,151,117,14,94,195,8,19,173,35,48,54,36,146,27
21542,177,130,22,47,54,7,33,76,12,9,47,3,3,25,16,41,6
21543,51,51,0,20,15,16,5,36,0,10,0,0,0,0,0,0,0
21545,882,671,114,319,178,60,266,247,69,89,211,15,76,75,45,179,32
21550,5587,4052,842,1809,1115,286,1465,1889,413,285,1535,238,474,548,275,1354,181
21555,738,564,97,262,179,26,202,302,47,13,174,27,43,53,51,139,35
21557,785,636,102,256,201,77,203,340,34,59,149,23,29,56,41,136,13
21560,6,0,0,0,0,0,0,0,0,0,6,0,0,6,0,6,0
21561,1005,760,139,335,253,33,246,430,38,46,245,32,96,74,43,210,35
21562,1370,962,168,399,310,85,292,504,69,97,408,24,85,131,168,404,4
21601,8166,5150,884,2218,1503,545,1526,2539,589,496,3016,420,927,881,788,2522,494
21607,208,172,17,102,37,16,59,88,16,9,36,3,4,9,20,33,3
21610,201,133,13,70,41,9,43,65,16,9,68,10,15,27,16,66,2
21612,330,261,22,101,108,30,68,164,16,13,69,27,0,28,14,69,0
21613,6972,4379,849,1848,1307,375,992,1953,895,539,2593,394,749,751,699,2252,341
21617,2395,1755,269,924,456,106,657,827,176,95,640,98,215,203,124,521,119
21619,2211,1576,266,705,528,77,533,784,153,106,635,64,243,200,128,508,127
21620,4769,3104,517,1210,1016,361,746,1618,468,272,1665,320,512,479,354,1346,319
21622,180,161,54,32,63,12,52,82,16,11,19,0,9,5,5,19,0
21623,604,465,110,206,121,28,172,189,50,54,139,34,51,30,24,121,18
21624,72,53,5,23,6,19,20,16,8,9,19,0,0,5,14,19,0
21625,946,794,146,424,189,35,350,310,84,50,152,42,76,20,14,126,26
21626,75,47,5,27,15,0,13,29,5,0,28,0,14,0,14,19,9
21627,27,0,0,0,0,0,0,0,0,0,27,5,0,15,7,27,0
21628,216,121,39,51,23,8,19,62,36,4,95,36,10,33,16,74,21
21629,2971,2106,365,1061,530,150,672,923,316,195,865,134,299,250,182,739,126
21631,907,674,78,337,211,48,241,359,32,42,233,31,62,70,70,205,28
21632,2408,1786,384,811,470,121,441,791,367,187,622,82,196,184,160,518,104
21634,251,148,25,52,64,7,39,100,9,0,103,0,31,44,28,103,0
21635,702,508,96,228,148,36,150,281,47,30,194,12,45,71,66,174,20
21636,443,398,87,171,129,11,142,153,32,71,45,0,18,24,3,45,0
21638,1551,1163,108,543,437,75,254,669,146,94,388,28,127,166,67,305,83
21639,1462,1049,234,523,217,75,409,368,161,111,413,77,142,93,101,333,80
21640,482,347,49,200,73,25,116,122,50,59,135,12,49,36,38,115,20
21641,83,58,3,47,6,2,22,26,7,3,25,11,5,6,3,20,5
21643,1966,1442,255,721,355,111,462,579,194,207,524,70,193,177,84,439,85
21644,41,34,5,22,7,0,20,9,0,5,7,0,7,0,0,0,7
21645,388,298,41,135,94,28,88,161,24,25,90,8,15,30,37,71,19
21647,242,168,7,80,63,18,41,102,17,8,74,0,18,38,18,62,12
21648,165,132,11,48,59,14,36,84,6,6,33,0,6,27,0,17,16
21649,504,376,99,181,74,22,136,138,59,43,128,35,38,39,16,94,34
21650,91,72,9,25,33,5,37,27,8,0,19,0,10,4,5,13,6
21651,776,583,96,304,156,27,196,259,69,59,193,35,75,52,31,156,37
21653,59,55,0,26,18,11,7,32,0,16,4,4,0,0,0,4,0
21654,673,471,10,138,252,71,79,345,22,25,202,10,73,72,47,186,16
21655,1834,1404,227,612,470,95,473,692,107,132,430,75,135,120,100,310,120
21657,246,180,65,58,48,9,89,65,15,11,66,3,33,18,12,50,16
21658,1432,1130,94,551,407,78,336,624,113,57,302,38,120,113,31,241,61
21659,597,389,91,172,102,24,137,185,14,53,208,6,90,81,31,181,27
21660,1255,932,234,460,195,43,311,359,150,112,323,29,105,99,90,242,81
21661,1278,845,112,323,327,83,197,466,114,68,433,22,114,172,125,378,55
21662,288,205,8,101,77,19,72,98,6,29,83,0,21,28,34,83,0
21663,1637,1055,85,361,478,131,220,674,79,82,582,42,145,187,208,527,55
21664,193,136,31,52,45,8,46,55,18,17,57,10,16,20,11,44,13
21665,84,64,8,12,23,21,7,57,0,0,20,0,0,5,15,20,0
21666,4124,3258,598,1862,678,120,1414,1507,261,76,866,88,409,260,109,671,195
21667,105,77,0,54,15,8,26,31,5,15,28,0,14,9,5,25,3
21668,717,550,120,227,166,37,179,277,63,31,167,16,39,58,54,158,9
21669,83,55,0,24,31,0,11,38,6,0,28,6,0,0,22,28,0
21671,346,245,28,88,93,36,71,140,34,0,101,17,25,36,23,77,24
21672,115,75,17,27,24,7,23,30,14,8,40,0,5,14,21,40,0
21673,1245,946,222,404,262,58,332,420,100,94,299,42,89,96,72,246,53
21675,97,93,24,23,31,15,13,72,0,8,4,0,4,0,0,4,0
21676,101,75,10,25,17,23,10,53,0,12,26,5,7,0,14,26,0
21677,175,139,27,32,60,20,42,86,7,4,36,9,8,13,6,20,16
21678,894,700,100,349,215,36,210,345,79,66,194,30,60,59,45,173,21
21679,116,82,0,49,33,0,18,58,0,6,34,0,0,27,7,21,13
21701,13139,8018,1694,4056,1717,551,2887,3395,987,749,5121,1438,1803,1265,615,4074,1047
21702,11537,8038,1857,4150,1676,355,3060,3312,1108,558,3499,1038,1215,692,554,2709,790
21703,9619,6908,2012,3764,957,175,3350,2401,831,326,2711,771,1069,490,381,2096,615
21704,1390,1187,146,592,360,89,397,563,117,110,203,21,83,66,33,165,38
21710,1120,862,92,449,248,73,347,422,23,70,258,0,102,68,88,212,46
21711,428,298,29,148,98,23,121,139,12,26,130,24,39,53,14,89,41
21713,3172,2386,375,1220,619,172,879,1143,158,206,786,80,267,259,180,651,135
21716,1876,1303,285,676,286,56,512,504,207,80,573,111,190,141,131,444,129
21717,22,13,0,13,0,0,6,7,0,0,9,0,0,0,9,9,0
21718,68,51,12,22,13,4,23,21,3,4,17,1,6,7,3,17,0
21719,590,407,75,237,67,28,134,178,65,30,183,68,21,68,26,156,27
21722,1892,1548,308,780,373,87,609,766,110,63,344,60,113,105,66,257,87
21723,128,104,35,55,14,0,47,51,0,6,24,5,5,0,14,19,5
21727,1478,1098,228,541,265,64,395,461,146,96,380,67,109,122,82,324,56
21733,312,228,28,142,58,0,114,97,17,0,84,8,45,22,9,76,8
21734,397,226,43,117,50,16,63,110,34,19,171,31,69,43,28,139,32
21737,267,267,21,189,57,0,130,113,15,9,0,0,0,0,0,0,0
21738,860,778,59,484,220,15,377,355,14,32,82,12,48,15,7,68,14
21740,21519,13685,3503,6008,3280,894,4224,5844,2397,1220,7834,1829,2416,2136,1453,6536,1298
21742,10195,7215,1436,3257,1941,581,2574,3561,672,408,2980,546,760,960,714,2516,464
21750,1577,1133,242,509,311,71,318,571,127,117,444,52,88,195,109,382,62
21754,1923,1738,178,1147,369,44,842,670,140,86,185,13,46,108,18,139,46
21755,1932,1561,207,874,378,102,686,663,68,144,371,33,196,87,55,311,60
21756,844,693,98,370,186,39,286,301,36,70,151,18,66,36,31,120,31
21757,1050,869,112,472,252,33,276,458,57,78,181,32,52,62,35,130,51
21758,1453,1113,200,549,268,96,391,537,63,122,340,75,105,93,67,247,93
21762,65,54,11,31,6,6,18,24,0,12,11,11,0,0,0,11,0
21766,290,179,25,70,66,18,32,114,17,16,111,0,25,48,38,93,18
21767,587,376,78,158,93,47,66,240,54,16,211,70,43,62,36,176,35
21769,3342,2736,323,1672,616,125,1260,1211,153,112,606,106,218,187,95,497,109
21770,1677,1424,97,977,304,46,716,577,47,84,253,41,118,76,18,197,56
21771,8238,7075,1018,4349,1464,244,3360,2924,489,302,1163,166,490,368,139,894,269
21773,1559,1308,178,731,334,65,593,575,88,52,251,28,128,44,51,191,60
21774,2892,2413,592,1463,330,28,1357,791,178,87,479,74,233,135,37,373,106
21776,1826,1495,250,900,280,65,668,654,113,60,331,83,69,111,68,273,58
21777,384,330,92,187,39,12,152,148,18,12,54,20,17,17,0,46,8
21778,404,326,49,168,85,24,65,189,41,31,78,0,23,45,10,67,11
21779,265,225,21,133,67,4,78,141,0,6,40,8,0,24,8,32,8
21780,534,443,86,210,121,26,167,221,27,28,91,7,41,29,14,84,7
21782,1561,1171,216,619,299,37,462,536,100,73,390,43,179,130,38,300,90
21783,2979,2267,329,1209,599,130,934,1050,163,120,712,98,228,245,141,581,131
21784,11631,9516,1612,5483,2032,389,4529,3840,648,499,2115,296,719,629,471,1738,377
21787,3191,2492,566,1281,531,114,1027,1050,262,153,699,93,246,185,175,567,132
21788,4188,3153,598,1579,859,117,1142,1484,350,177,1035,202,260,349,224,809,226
21790,30,13,0,0,13,0,0,0,0,13,17,0,6,0,11,0,17
21791,1899,1568,258,762,432,116,642,709,116,101,331,58,102,94,77,257,74
21793,3169,2684,452,1519,624,89,1193,1053,292,146,485,118,169,85,113,402,83
21794,523,474,42,312,106,14,265,166,9,34,49,0,27,22,0,43,6
21795,3260,2274,271,1126,727,150,758,1200,187,129,986,127,207,267,385,879,107
21797,2431,2045,170,1225,538,112,891,849,128,177,386,77,130,89,90,282,104
21798,605,497,78,277,109,33,225,206,36,30,108,21,21,34,32,80,28
21801,9563,6540,1407,3168,1587,378,2068,2533,1263,676,3023,705,1016,742,560,2359,664
21804,12547,8050,1352,4139,2015,544,2346,3539,1305,860,4497,1423,1205,1008,861,3402,1095
21810,18,18,0,0,10,8,4,6,0,8,0,0,0,0,0,0,0
21811,8210,5980,766,2300,2328,586,1371,3481,631,497,2230,334,612,795,489,1845,385
21813,897,720,94,328,258,40,263,397,38,22,177,15,66,47,49,152,25
21814,197,124,8,58,36,22,40,48,27,9,73,0,30,25,18,73,0
21817,2346,1576,315,680,434,147,382,704,295,195,770,62,203,283,222,717,53
21821,488,352,45,111,152,44,47,201,55,49,136,11,49,64,12,105,31
21822,775,565,113,258,175,19,144,256,97,68,210,7,72,91,40,140,70
21824,144,89,16,23,35,15,16,73,0,0,55,0,13,14,28,55,0
21826,1496,951,265,407,243,36,265,382,212,92,545,115,168,160,102,426,119
21829,170,102,23,22,37,20,29,34,5,34,68,12,30,12,14,42,26
21830,1131,862,201,444,186,31,315,393,103,51,269,38,100,86,45,217,52
21835,199,143,40,46,49,8,21,80,25,17,56,0,28,22,6,40,16
21837,959,671,132,330,184,25,250,284,81,56,288,54,82,81,71,219,69
21838,728,512,57,253,162,40,191,230,21,70,216,15,79,84,38,197,19
21840,187,146,7,53,58,28,18,111,8,9,41,0,8,26,7,33,8
21841,349,276,47,118,87,24,88,128,14,46,73,0,25,37,11,66,7
21842,5020,2704,344,953,1142,265,560,1643,281,220,2316,583,672,703,358,1761,555
21849,1066,823,135,461,208,19,331,337,88,67,243,54,67,84,38,202,41
21850,1095,782,213,375,174,20,258,337,122,65,313,85,105,81,42,224,89
21851,2923,1969,285,1063,467,154,597,734,369,269,954,104,254,300,296,857,97
21853,3113,1907,351,829,568,159,522,699,361,325,1206,373,352,328,153,997,209
21856,443,338,30,152,123,33,67,215,20,36,105,16,22,59,8,88,17
21861,246,178,26,91,55,6,67,74,17,20,68,13,6,21,28,60,8
21862,24,8,0,8,0,0,8,0,0,0,16,5,5,0,6,16,0
21863,1864,1386,248,632,399,107,379,682,180,145,478,66,123,165,124,427,51
21864,229,188,32,61,76,19,72,74,17,25,41,5,18,13,5,41,0
21865,106,46,0,30,16,0,13,20,13,0,60,14,21,19,6,51,9
21866,34,8,0,8,0,0,8,0,0,0,26,0,14,5,7,19,7
21867,57,38,8,16,14,0,19,11,0,8,19,0,6,0,13,19,0
21869,452,321,42,113,112,54,72,166,29,54,131,15,26,58,32,123,8
21871,773,556,51,240,204,61,131,279,60,86,217,27,58,100,32,189,28
21872,245,194,36,112,34,12,84,85,14,11,51,11,8,14,18,51,0
21874,880,649,121,380,130,18,238,268,97,46,231,38,68,70,55,185,46
21875,1980,1498,321,761,338,78,529,615,227,127,482,121,153,141,67,392,90
21901,4492,3340,659,1764,760,157,1267,1387,427,259,1152,309,285,371,187,901,251
21902,0,0,0,0,0,0,0,0,0,0,0,0,0,0,0,0,0
21903,2046,1428,303,792,272,61,522,645,168,93,618,128,164,213,113,507,111
21904,2436,1813,391,1002,375,45,722,692,285,114,623,93,224,219,87,441,182
21911,3129,2439,423,1225,618,173,955,987,284,213,690,132,256,180,122,573,117
21912,425,338,44,185,98,11,139,137,34,28,87,11,20,20,36,77,10
21913,206,119,29,39,40,11,40,43,16,20,87,0,29,40,18,70,17
21914,304,202,45,94,51,12,63,97,30,12,102,11,31,50,10,74,28
21915,1212,870,131,382,303,54,287,482,58,43,342,53,125,81,83,285,57
21917,657,558,129,289,118,22,248,253,40,17,99,7,46,22,24,80,19
21918,1427,1144,245,643,224,32,470,461,133,80,283,52,120,81,30,233,50
21919,1005,741,83,354,243,61,213,396,100,32,264,16,119,95,34,225,39
21920,44,30,0,13,13,4,13,17,0,0,14,0,0,7,7,14,0
21921,13815,10284,2490,5245,2140,409,3960,4191,1395,738,3531,965,1189,783,594,2735,796
21930,59,44,0,23,21,0,17,27,0,0,15,0,0,7,8,15,0
22003,19067,13889,2020,7313,3794,762,5248,6063,1165,1413,5178,1124,2006,1425,623,4003,1175
22015,14573,11845,1231,7729,2691,194,5497,4571,906,871,2728,576,1152,699,301,2108,620
22026,7295,5775,1480,3498,749,48,2691,1782,991,311,1520,363,810,289,58,1099,421
22027,497,394,14,212,146,22,137,205,14,38,103,0,70,33,0,61,42
22030,13142,9185,1737,4847,2188,413,3576,4239,575,795,3957,1398,1365,805,389,2808,1149
22031,10063,6562,1281,3570,1399,312,2616,2732,500,714,3501,1158,1258,707,378,2566,935
22032,9607,8153,595,4790,2532,236,3705,3537,419,492,1454,323,500,448,183,1050,404
22033,13503,8351,2165,4633,1401,152,3471,3671,608,601,5152,2528,1782,664,178,3640,1512
22039,5647,5395,204,3464,1638,89,2672,2447,155,121,252,14,88,136,14,187,65
22041,10320,6167,1781,2808,1102,476,2233,2226,838,870,4153,858,1625,1014,656,3496,657
22042,11220,7389,1724,3648,1640,377,2679,3119,678,913,3831,986,1585,732,528,2851,980
22043,9052,5735,1339,2788,1300,308,2112,2606,401,616,3317,1129,1326,664,198,2333,984
22044,5206,3043,722,1456,652,213,1067,1246,375,355,2163,598,850,489,226,1722,441
22046,5831,3660,563,1973,847,277,1530,1485,348,297,2171,380,932,487,372,1714,457
22060,2408,2008,1065,804,25,114,1353,324,282,49,400,105,79,6,210,372,28
22066,5471,4969,198,3081,1562,128,2528,2150,140,151,502,67,162,189,84,389,113
22079,6198,4566,1110,2664,718,74,2018,1573,656,319,1632,453,835,291,53,1237,395
22101,10513,8190,414,4340,2620,816,3638,3717,327,508,2323,195,576,805,747,1987,336
22102,8457,4711,898,2303,1187,323,1772,2221,232,486,3746,1241,1420,819,266,3010,736
22124,5300,3951,469,2236,1123,123,1649,1963,171,168,1349,428,466,398,57,1018,331
22125,53,19,0,7,12,0,7,12,0,0,34,7,0,17,10,34,0
22134,1679,1463,898,535,25,5,1053,285,114,11,216,61,108,35,12,184,32
22150,7430,5489,962,2945,1182,400,2202,2442,350,495,1941,510,584,447,400,1517,424
22151,5720,4296,540,2305,1204,247,1695,2067,291,243,1424,311,394,513,206,1035,389
22152,10166,7683,917,4533,2015,218,3308,3030,652,693,2483,507,1182,643,151,1912,571
22153,10865,9048,1213,5930,1858,47,4450,3234,823,541,1817,414,843,491,69,1323,494
22172,2391,1560,523,702,253,82,548,539,300,173,831,292,371,127,41,649,182
22180,8157,6033,953,2975,1689,416,2427,2798,292,516,2124,540,710,578,296,1545,579
22181,5000,4085,424,2365,1175,121,1839,1822,215,209,915,240,306,306,63,644,271
22182,7997,6486,630,3696,1971,189,2972,2939,240,335,1511,289,536,490,196,1130,381
22191,13440,10023,2977,5113,1721,212,4153,3050,1742,1078,3417,1051,1339,787,240,2656,761
22192,17876,13257,2722,8239,2077,219,5830,4879,1640,908,4619,1443,2115,759,302,3578,1041
22193,19567,16053,3444,9760,2716,133,7657,5223,2018,1155,3514,803,1774,756,181,2629,885
22201,13791,4499,1533,2055,719,192,1295,2290,304,610,9292,5113,2981,932,266,7112,2180
22202,9669,3093,781,1275,769,268,567,2117,81,328,6576,2715,2135,1270,456,5101,1475
22203,8792,3590,1278,1537,555,220,1122,1740,266,462,5202,1964,1480,911,847,3928,1274
22204,19504,10467,3057,5318,1626,466,3704,3496,1524,1743,9037,3422,3400,1501,714,6774,2263
22205,6388,4062,627,2172,938,325,1628,1844,280,310,2326,757,845,286,438,1696,630
22206,9059,3842,1235,1956,510,141,1222,1522,598,500,5217,2032,2302,716,167,3974,1243
22207,11413,7606,881,3856,2037,832,3121,3681,307,497,3807,1035,1228,820,724,2746,1061
22209,6920,1968,816,750,336,66,438,1002,172,356,4952,2844,1523,481,104,3801,1151
22211,177,166,97,65,4,0,100,39,27,0,11,11,0,0,0,9,2
22213,1088,690,114,367,162,47,197,378,63,52,398,102,144,84,68,278,120
22301,4733,2477,565,1267,463,182,849,1114,194,320,2256,845,912,357,142,1646,610
22302,7274,3469,887,1628,710,244,1155,1670,279,365,3805,1463,1585,506,251,3086,719
22303,6832,3206,868,1473,687,178,994,1481,328,403,3626,1248,1496,635,247,2954,672
22304,19813,8869,2843,4178,1428,420,2783,3739,1226,1121,10944,4261,3875,1984,824,8613,2331
22305,6116,3414,1126,1693,510,85,1067,1187,693,467,2702,1053,1158,380,111,2077,625
22306,10835,7077,1703,3735,1380,259,2568,2340,1217,952,3758,1091,1640,692,335,3024,734
22307,4528,2547,288,1149,796,314,752,1309,231,255,1981,392,796,411,382,1656,325
22308,4667,3679,277,1795,1210,397,1407,1900,92,280,988,82,307,314,285,857,131
22309,10868,7787,1497,4056,1812,422,2619,2997,1278,893,3081,691,1447,726,217,2449,632
22310,10239,6899,1319,3612,1635,333,2546,3283,493,577,3340,976,1562,651,151,2544,796
22311,8044,3469,1247,1594,476,152,1085,1320,490,574,4575,1794,1801,489,491,3719,856
22312,10339,6772,1582,3681,1266,243,2557,2387,877,951,3567,977,1633,662,295,2651,916
22314,13637,5413,1504,2188,1417,304,962,3170,680,601,8224,2950,3209,1555,510,6732,1492
22315,9022,5813,1409,3449,865,90,2438,2346,548,481,3209,912,1694,542,61,2444,765
22401,8086,3942,1015,1706,975,246,1022,1622,744,554,4144,1558,1106,754,726,3175,969
22405,8129,6465,1084,3483,1529,369,2675,2652,742,396,1664,326,517,515,306,1331,333
22406,4106,3057,671,1722,604,60,1287,1313,311,146,1049,345,428,182,94,736,313
22407,14198,11049,2333,6422,1853,441,5062,4129,1137,721,3149,752,986,960,451,2458,691
22408,6676,5128,1334,2528,1040,226,2303,2043,504,278,1548,344,612,482,110,1236,312
22427,1174,826,193,356,206,71,253,338,114,121,348,41,80,113,114,294,54
22432,152,121,11,53,41,16,26,95,0,0,31,12,0,6,13,31,0
22433,26,20,0,13,7,0,0,20,0,0,6,0,0,6,0,6,0
22435,905,612,77,230,245,60,205,325,48,34,293,0,76,116,101,260,33
22436,222,168,25,74,54,15,49,59,22,38,54,0,17,20,17,32,22
22437,276,170,22,71,54,23,40,96,14,20,106,24,15,51,16,89,17
22438,219,171,24,80,61,6,66,77,10,18,48,8,6,13,21,45,3
22443,3093,2034,326,843,654,211,565,1047,242,180,1059,112,305,377,265,886,173
22448,208,208,120,88,0,0,157,34,15,2,0,0,0,0,0,0,0
22454,764,574,92,274,175,33,208,252,56,58,190,8,52,41,89,176,14
22460,751,527,68,186,214,59,146,274,46,61,224,25,61,86,52,182,42
22469,821,568,119,253,154,42,182,225,96,65,253,32,80,124,17,217,36
22473,2232,1507,156,535,663,153,346,925,141,95,725,62,213,199,251,646,79
22476,163,117,10,59,27,21,12,62,30,13,46,7,27,0,12,31,15
22480,336,231,12,84,102,33,61,133,14,23,105,3,22,43,37,102,3
22482,1222,803,69,344,306,84,203,426,106,68,419,45,89,136,149,400,19
22485,5884,4342,825,2316,1010,191,1657,1794,482,409,1542,344,528,443,227,1248,294
22488,697,470,47,173,201,49,65,255,36,114,227,16,63,106,42,179,48
22503,1984,1353,190,479,512,172,260,844,132,117,631,23,172,246,190,572,59
22504,123,106,12,38,47,9,13,65,10,18,17,0,7,0,10,17,0
22507,19,6,0,0,0,6,0,6,0,0,13,0,0,0,13,13,0
22508,3041,2342,284,859,991,208,582,1394,238,128,699,41,227,302,129,591,108
22509,20,20,0,10,10,0,8,12,0,0,0,0,0,0,0,0,0
22511,576,426,34,143,179,70,112,263,0,51,150,21,25,53,51,135,15
22514,772,565,113,213,173,66,185,253,70,57,207,31,68,76,32,179,28
22520,2067,1478,182,532,582,182,365,727,188,198,589,46,174,221,148,521,68
22529,45,24,0,18,6,0,18,6,0,0,21,0,0,6,15,12,9
22534,687,532,104,332,83,13,218,253,45,16,155,35,47,66,7,120,35
22535,200,138,26,57,34,21,45,63,14,16,62,6,21,19,16,57,5
22538,94,76,3,40,33,0,26,26,11,13,18,0,0,10,8,18,0
22539,1050,723,55,162,369,137,128,511,41,43,327,23,58,141,105,271,56
22542,666,454,67,244,143,0,138,219,48,49,212,22,88,52,50,181,31
22546,3642,2888,522,1510,707,149,943,1295,381,269,754,90,322,190,152,612,142
22548,10,10,0,0,10,0,0,10,0,0,0,0,0,0,0,0,0
22553,8480,7026,1200,3977,1631,218,2963,2929,652,482,1454,275,557,383,239,1156,298
22554,17934,14999,3141,9511,2170,177,7939,4999,1390,671,2935,770,1338,654,173,2116,819
22560,2249,1485,297,663,410,115,498,684,167,136,764,143,198,252,171,656,108
22567,769,571,116,238,196,21,239,291,12,29,198,21,48,112,17,140,58
22572,2303,1587,213,758,469,147,441,750,214,182,716,95,181,294,146,672,44
22576,746,566,55,217,232,62,101,377,69,19,180,0,24,104,52,180,0
22578,1251,895,51,347,354,143,221,546,52,76,356,55,71,119,111,326,30
22579,8,8,0,0,8,0,0,8,0,0,0,0,0,0,0,0,0
22580,1777,1363,253,609,378,123,457,609,151,146,414,53,146,123,92,332,82
22601,10336,5931,1269,2712,1496,454,1796,2484,891,760,4405,1352,1487,885,681,3500,905
22602,7859,6061,1368,2925,1489,279,2437,2768,579,277,1798,339,733,484,242,1361,437
22603,4429,3182,543,1613,818,208,1060,1568,294,260,1247,170,409,416,252,1047,200
22610,692,504,72,229,152,51,129,253,64,58,188,30,68,53,37,136,52
22611,2950,2135,313,995,654,173,665,1008,240,222,815,76,248,249,242,688,127
22620,976,684,81,360,203,40,222,345,50,67,292,35,142,74,41,253,39
22624,829,634,97,349,156,32,233,290,55,56,195,7,69,77,42,162,33
22625,1037,823,124,413,231,55,299,425,45,54,214,33,81,69,31,146,68
22626,7,0,0,0,0,0,0,0,0,0,7,0,0,7,0,7,0
22627,232,193,34,81,70,8,50,103,25,15,39,13,0,13,13,26,13
22630,9917,6931,1354,3460,1745,372,2315,3029,993,594,2986,497,973,917,599,2480,506
22637,654,523,78,279,138,28,179,229,67,48,131,17,39,28,47,123,8
22639,232,168,26,66,57,19,61,98,0,9,64,15,0,37,12,49,15
22640,223,133,5,77,51,0,60,60,0,13,90,0,28,50,12,78,12
22641,59,45,0,13,23,9,6,27,7,5,14,0,14,0,0,14,0
22642,1298,908,252,455,176,25,415,347,73,73,390,88,217,62,23,278,112
22643,43,35,11,7,17,0,11,17,0,7,8,0,8,0,0,8,0
22644,662,531,82,274,155,20,199,230,55,47,131,17,66,41,7,114,17
22645,1167,844,117,448,214,65,248,423,93,80,323,46,108,86,83,276,47
22646,37,18,0,13,5,0,7,11,0,0,19,0,19,0,0,19,0
22650,417,285,78,70,132,5,47,187,12,39,132,6,46,74,6,126,6
22652,390,300,26,164,61,49,116,163,16,5,90,5,27,45,13,90,0
22654,186,124,7,82,28,7,25,78,21,0,62,0,28,34,0,47,15
22655,4886,3722,882,1983,715,142,1699,1460,369,194,1164,261,411,351,141,925,239
22656,759,611,117,293,177,24,215,245,75,76,148,28,45,46,29,104,44
22657,3385,2370,462,1172,521,215,796,1091,274,209,1015,125,286,446,158,865,150
22660,630,495,71,222,157,45,142,236,44,73,135,29,32,41,33,116,19
22663,614,449,118,170,161,0,175,190,34,50,165,25,69,40,31,153,12
22664,3006,1977,413,716,659,189,526,1092,272,87,1029,152,295,263,319,842,187
22701,8221,5893,1259,2823,1397,414,2005,2478,867,543,2328,558,732,657,381,1823,505
22709,297,239,37,102,81,19,109,115,0,15,58,0,40,18,0,51,7
22711,85,58,10,18,30,0,16,42,0,0,27,6,6,15,0,21,6
22712,2254,1776,356,1050,322,48,897,534,206,139,478,119,188,121,50,362,116
22713,263,190,30,81,52,27,79,86,4,21,73,6,35,17,15,53,20
22714,259,223,56,89,73,5,103,69,21,30,36,4,9,17,6,25,11
22715,514,421,83,201,88,49,176,173,40,32,93,16,13,35,29,93,0
22716,346,262,36,115,87,24,61,158,12,31,84,25,32,13,14,64,20
22718,265,218,27,109,59,23,63,110,22,23,47,9,21,12,5,41,6
22719,91,74,5,40,20,9,23,51,0,0,17,0,7,10,0,7,10
22720,307,235,33,98,97,7,56,143,11,25,72,20,28,24,0,36,36
22722,23,16,5,11,0,0,16,0,0,0,7,0,0,7,0,7,0
22723,38,31,0,20,0,11,11,20,0,0,7,0,7,0,0,7,0
22724,613,481,66,238,163,14,162,258,22,39,132,33,41,48,10,132,0
22726,252,151,25,69,42,15,45,47,28,31,101,15,32,38,16,90,11
22727,1753,1236,228,528,364,116,371,612,117,136,517,68,169,194,86,447,70
22728,1000,765,125,404,195,41,306,351,26,82,235,50,105,74,6,175,60
22729,44,35,10,17,8,0,17,10,0,8,9,0,0,9,0,9,0
22730,81,81,6,28,23,24,26,47,0,8,0,0,0,0,0,0,0
22731,135,103,19,60,14,10,52,38,13,0,32,0,15,17,0,15,17
22732,110,72,0,49,17,6,29,43,0,0,38,0,22,16,0,29,9
22733,359,294,70,94,106,24,77,154,35,28,65,0,33,16,16,55,10
22734,882,714,226,346,107,35,299,240,125,50,168,45,81,35,7,131,37
22735,736,605,118,318,145,24,194,310,51,50,131,7,33,54,37,112,19
22736,88,72,14,49,9,0,52,20,0,0,16,6,4,6,0,16,0
22737,997,796,83,483,203,27,258,379,64,95,201,62,35,76,28,132,69
22738,396,303,45,111,137,10,67,190,30,16,93,0,37,34,22,74,19
22740,584,340,84,162,80,14,149,151,36,4,244,19,100,78,47,213,31
22741,74,56,7,40,9,0,15,34,7,0,18,0,0,7,11,18,0
22742,625,525,79,330,116,0,216,232,39,38,100,27,28,16,29,87,13
22743,161,124,21,37,58,8,26,67,0,31,37,9,16,0,12,28,9
22746,120,103,11,42,44,6,30,64,0,9,17,0,10,0,7,7,10
22747,440,318,28,155,108,27,109,135,32,42,122,18,57,28,19,114,8
22749,184,125,5,50,44,26,31,72,12,10,59,6,20,33,0,50,9
22801,10086,5386,1350,2435,1275,326,2017,2259,666,444,4700,2896,800,533,471,2354,2346
22802,8576,5358,1339,2386,1225,408,1890,2376,620,472,3218,1006,960,725,527,2455,763
22810,299,203,16,56,104,27,18,173,12,0,96,9,28,43,16,90,6
22811,187,143,5,73,55,10,27,92,7,17,44,0,10,25,9,44,0
22812,2872,2145,333,1044,547,221,761,1024,198,162,727,146,183,142,256,633,94
22815,2633,1935,412,867,546,110,658,884,212,181,698,125,210,234,129,571,127
22820,118,97,14,50,19,14,20,54,11,12,21,0,6,6,9,21,0
22821,2016,1532,308,673,418,133,578,718,80,156,484,66,168,125,125,426,58
22824,2273,1637,301,746,466,124,510,794,156,177,636,56,223,208,149,574,62
22827,4307,3105,671,1352,902,180,995,1463,369,278,1202,206,388,358,250,995,207
22830,627,488,128,199,146,15,189,193,64,42,139,16,69,42,12,106,33
22831,248,195,42,83,51,19,73,89,9,24,53,16,31,6,0,47,6
22832,297,221,25,142,47,7,110,91,16,4,76,12,28,31,5,65,11
22834,509,440,55,222,130,33,162,243,11,24,69,13,31,25,0,56,13
22835,4645,3293,609,1476,935,273,1051,1511,386,345,1352,180,389,481,302,1174,178
22840,1365,989,182,508,263,36,378,509,62,40,376,41,126,127,82,307,69
22841,951,750,103,384,210,53,306,390,33,21,201,23,95,52,31,171,30
22842,1847,1327,206,622,426,73,450,701,81,95,520,52,160,178,130,439,81
22843,1017,780,150,344,248,38,263,438,51,28,237,35,100,72,30,197,40
22844,1656,1118,192,537,308,81,375,563,116,64,538,90,182,154,112,459,79
22845,15,15,0,6,9,0,0,15,0,0,0,0,0,0,0,0,0
22846,330,273,30,165,62,16,120,95,21,37,57,19,14,18,6,35,22
22847,371,317,53,102,121,41,64,146,41,66,54,8,16,5,25,54,0
22849,1837,1336,317,558,378,83,408,669,131,128,501,69,142,145,145,434,67
22850,312,246,41,138,59,8,91,123,24,8,66,8,21,31,6,51,15
22851,2191,1608,338,711,481,78,537,708,182,181,583,106,183,176,118,483,100
22853,1502,1098,201,523,284,90,308,543,145,102,404,74,103,124,103,351,53
22901,13387,8096,1722,3758,2033,583,2735,3579,1191,591,5291,1906,1459,1046,880,4307,984
22902,7975,4421,1097,2126,956,242,1329,1753,906,433,3554,1009,1324,769,452,2858,696
22903,13431,6060,1546,2620,1492,402,1681,2788,926,665,7371,4707,1335,805,524,4409,2962
22911,4288,3289,507,1954,671,157,1522,1281,402,84,999,220,407,293,79,821,178
22920,1353,1030,156,499,315,60,340,552,35,103,323,82,131,67,43,256,67
22922,789,524,87,242,162,33,148,236,94,46,265,15,93,92,65,215,50
22923,1360,986,244,496,228,18,428,354,136,68,374,59,176,101,38,285,89
22924,38,29,0,10,19,0,0,19,10,0,9,0,0,0,9,9,0
22931,121,78,0,47,31,0,26,37,9,6,43,14,0,21,8,43,0
22932,1851,1370,224,727,336,83,623,543,155,49,481,90,117,201,73,387,94
22935,313,234,23,139,64,8,67,130,20,17,79,28,35,16,0,68,11
22936,1642,1283,123,717,328,115,517,553,102,111,359,81,117,93,68,298,61
22937,446,331,69,113,115,34,94,150,55,32,115,25,41,39,10,95,20
22938,475,345,20,191,88,46,109,163,36,37,130,9,55,53,13,113,17
22939,1295,973,155,499,258,61,298,483,159,33,322,53,100,108,61,294,28
22940,381,244,11,153,73,7,112,126,6,0,137,14,55,24,44,115,22
22942,2906,2120,406,966,594,154,598,973,210,339,786,131,259,249,147,655,131
22943,213,153,29,78,32,14,68,63,16,6,60,14,40,0,6,41,19
22946,54,41,6,28,7,0,16,13,0,12,13,0,13,0,0,7,6
22947,1507,1066,73,623,328,42,390,506,66,104,441,88,102,231,20,335,106
22948,102,76,0,38,38,0,7,48,7,14,26,0,17,0,9,26,0
22949,555,361,82,156,112,11,149,118,53,41,194,17,96,51,30,160,34
22952,766,535,115,269,118,33,170,270,43,52,231,19,101,85,26,164,67
22954,36,28,6,10,5,7,0,0,16,12,8,0,0,8,0,8,0
22957,14,14,0,7,7,0,14,0,0,0,0,0,0,0,0,0,0
22958,749,519,35,175,277,32,105,347,50,17,230,23,102,52,53,204,26
22959,773,546,100,242,171,33,256,175,37,78,227,56,82,56,33,187,40
22960,3565,2554,489,1220,638,207,761,1067,438,288,1011,119,247,358,287,896,115
22963,4365,3455,632,1555,1080,188,1029,1847,366,213,910,144,326,313,127,775,135
22964,31,18,5,13,0,0,7,11,0,0,13,0,6,7,0,13,0
22967,757,507,53,235,164,55,115,223,59,110,250,37,63,56,94,190,60
22968,3097,2423,695,1133,468,127,1043,955,226,199,674,170,289,160,55,479,195
22969,448,357,89,167,68,33,116,177,53,11,91,0,32,45,14,84,7
22971,755,523,74,238,191,20,162,287,23,51,232,27,97,91,17,204,28
22972,173,90,5,47,24,14,19,50,13,8,83,0,24,50,9,77,6
22973,2027,1528,242,809,349,128,535,728,153,112,499,57,161,209,72,433,66
22974,1201,977,188,494,262,33,382,399,109,87,224,46,85,54,39,189,35
22976,141,118,14,70,31,3,45,40,23,10,23,0,11,7,5,23,0
22980,12504,8771,1870,3683,2564,654,2613,4149,1253,756,3733,562,1314,1137,720,3330,403
22989,93,55,20,25,10,0,41,14,0,0,38,23,15,0,0,31,7
23001,10,0,0,0,0,0,0,0,0,0,10,0,10,0,0,10,0
23002,3336,2587,474,1257,684,172,880,1164,280,263,749,55,258,246,190,631,118
23004,454,343,66,137,105,35,73,149,109,12,111,11,46,30,24,78,33
23005,5286,3740,576,2011,905,248,1342,1504,483,411,1546,297,465,492,292,1314,232
23009,1876,1492,435,651,363,43,625,615,114,138,384,57,200,63,64,290,94
23011,306,250,20,152,53,25,63,144,31,12,56,6,26,4,20,43,13
23015,1365,1125,246,564,237,78,466,475,85,99,240,32,63,98,47,229,11
23021,140,112,7,45,43,17,24,72,0,16,28,0,17,0,11,19,9
23022,256,190,38,62,75,15,27,98,26,39,66,10,7,37,12,52,14
23023,54,40,0,15,25,0,0,29,7,4,14,0,0,0,14,14,0
23024,2360,1825,338,891,523,73,635,913,175,102,535,124,195,159,57,435,100
23025,195,126,23,50,47,6,64,46,0,16,69,0,0,44,25,69,0
23027,463,380,51,189,112,28,138,153,26,63,83,14,22,37,10,81,2
23030,1840,1392,146,798,373,75,367,630,209,186,448,53,141,195,59,420,28
23032,156,125,45,45,17,18,53,57,11,4,31,0,4,21,6,31,0
23035,617,493,56,156,244,37,86,320,38,49,124,26,42,29,27,114,10
23038,693,471,57,214,129,71,154,194,51,72,222,43,59,105,15,204,18
23039,400,283,46,125,100,12,49,169,21,44,117,10,78,29,0,89,28
23040,1316,990,226,447,263,54,288,425,127,150,326,31,101,91,103,289,37
23043,793,530,15,223,224,68,124,355,36,15,263,8,55,95,105,233,30
23045,60,47,7,16,15,9,23,17,0,7,13,13,0,0,0,13,0
23047,659,492,47,246,171,28,193,230,13,56,167,9,52,75,31,125,42
23050,153,115,11,72,32,0,59,56,0,0,38,0,16,15,7,32,6
23055,417,314,53,146,96,19,106,122,41,45,103,9,31,31,32,98,5
23056,161,97,16,30,51,0,23,60,14,0,64,8,26,14,16,56,8
23059,5932,4438,948,2488,871,131,2047,1912,257,222,1494,552,521,295,126,1238,256
23060,10500,7306,1837,4218,1076,175,3276,2822,726,482,3194,1233,1248,504,209,2602,592
23061,7101,5480,952,2938,1314,276,2137,2481,523,339,1621,205,540,568,308,1417,204
23062,1099,713,182,297,191,43,183,446,75,9,386,126,110,112,38,288,98
23063,1589,1211,177,574,369,91,409,558,118,126,378,57,128,148,45,331,47
23064,82,45,0,12,21,12,6,33,6,0,37,5,18,14,0,32,5
23065,578,392,75,207,83,27,114,204,42,32,186,47,75,43,21,174,12
23066,231,147,22,60,54,11,28,101,10,8,84,6,0,17,61,61,23
23068,181,111,22,44,45,0,25,56,5,25,70,7,19,21,23,60,10
23069,1063,828,93,416,255,64,237,418,70,103,235,5,69,86,75,213,22
23070,128,78,0,21,41,16,10,53,0,15,50,0,13,9,28,50,0
23071,515,338,21,128,163,26,70,210,33,25,177,18,46,70,43,149,28
23072,4527,3400,502,1798,918,182,1224,1443,348,385,1127,218,341,339,229,875,252
23075,3752,2710,681,1306,541,182,721,871,711,407,1042,238,372,300,132,801,241
23076,246,162,13,41,78,30,27,135,0,0,84,5,30,30,19,68,16
23079,119,87,0,42,38,7,13,59,4,11,32,5,10,12,5,27,5
23083,680,444,69,237,119,19,163,170,40,71,236,38,115,36,47,185,51
23084,486,331,40,145,109,37,93,187,21,30,155,26,32,58,39,143,12
23085,167,135,13,46,68,8,41,56,0,38,32,0,10,6,16,32,0
23086,876,682,52,447,152,31,270,300,69,43,194,30,86,47,31,160,34
23089,1562,1180,144,567,384,85,366,601,110,103,382,71,129,102,80,299,83
23091,122,107,22,40,31,14,41,52,0,14,15,0,1,14,0,14,1
23092,229,156,25,96,29,6,49,47,20,40,73,0,31,34,8,60,13
23093,3878,2788,430,1486,707,165,825,1205,428,330,1090,112,346,382,250,913,177
23102,879,664,85,423,144,12,267,339,23,35,215,34,116,37,28,156,59
23103,1400,1158,104,616,376,62,466,591,42,59,242,33,102,81,26,223,19
23106,289,241,67,89,74,11,67,142,26,6,48,8,25,0,15,33,15
23108,65,43,33,5,5,0,33,5,0,5,22,10,7,0,5,22,0
23109,767,545,59,299,137,50,182,265,54,44,222,53,33,39,97,191,31
23110,243,166,18,73,46,29,36,98,19,13,77,13,34,18,12,72,5
23111,11615,8979,1803,4663,2003,510,3600,3889,1030,460,2636,649,854,689,444,2191,445
23112,13834,10926,2538,6367,1698,323,5515,3833,1096,482,2908,842,1091,592,383,2334,574
23113,10693,8953,947,5667,2071,268,4386,3622,560,385,1740,332,664,515,229,1474,266
23115,45,34,0,20,14,0,10,10,9,5,11,0,11,0,0,6,5
23116,7743,6708,821,4127,1479,281,3331,2701,350,326,1035,138,395,334,168,873,162
23117,2844,2125,243,1017,740,125,580,1166,177,202,719,78,235,234,172,601,118
23119,94,69,9,18,35,7,11,55,3,0,25,0,0,13,12,25,0
23120,948,768,22,464,240,42,294,383,32,59,180,19,66,65,30,153,27
23123,659,467,85,224,149,9,105,229,69,64,192,45,50,62,35,187,5
23124,1020,785,129,492,141,23,384,304,57,40,235,9,98,66,62,193,42
23125,40,22,0,0,15,7,0,22,0,0,18,7,0,0,11,18,0
23126,210,158,19,76,44,19,57,61,5,35,52,5,6,21,20,52,0
23128,325,273,39,144,83,7,115,126,25,7,52,0,21,9,22,52,0
23129,126,102,12,56,18,16,27,55,4,16,24,0,7,17,0,21,3
23130,51,51,0,26,8,17,26,16,0,9,0,0,0,0,0,0,0
23138,604,440,33,154,208,45,103,293,37,7,164,9,50,61,44,157,7
23139,6757,5506,1055,2880,1329,242,2170,2493,401,442,1251,212,483,418,138,986,265
23140,1321,961,131,431,331,68,282,428,87,164,360,34,132,104,90,288,72
23141,1815,1466,275,787,366,38,516,764,135,51,349,29,183,98,39,250,99
23146,1061,838,129,392,248,69,329,426,29,54,223,17,87,78,41,194,29
23148,631,445,84,228,108,25,110,191,65,79,186,19,64,66,37,128,58
23149,877,659,88,312,203,56,253,303,29,74,218,32,61,76,49,181,37
23150,4436,3244,603,1631,806,204,1016,1421,512,295,1192,230,446,336,180,953,239
23153,231,172,17,89,57,9,60,57,25,30,59,5,17,27,10,44,15
23156,625,482,64,239,131,48,119,246,51,66,143,17,56,36,34,125,18
23161,48,37,0,12,25,0,0,30,0,7,11,0,0,6,5,11,0
23163,89,64,0,11,41,12,0,30,0,34,25,0,0,16,9,18,7
23168,1632,1268,254,717,256,41,502,520,126,120,364,44,129,138,53,306,58
23169,528,338,55,111,145,27,59,189,56,34,190,11,61,63,55,148,42
23175,885,572,36,218,249,69,97,336,47,92,313,21,90,140,62,283,30
23176,294,215,20,84,92,19,51,110,35,19,79,20,23,22,14,62,17
23177,435,303,60,126,106,11,86,120,42,55,132,4,14,80,34,120,12
23178,17,10,0,0,0,10,0,10,0,0,7,0,7,0,0,7,0
23180,152,104,17,50,19,18,51,38,8,7,48,9,11,17,11,27,21
23181,1652,1215,186,527,373,129,401,567,112,135,437,59,139,123,116,403,34
23184,14,0,0,0,0,0,0,0,0,0,14,0,8,0,6,14,0
23185,15051,10161,1283,4462,3374,1042,3061,5448,936,716,4890,1294,1244,1217,1135,3898,992
23186,0,0,0,0,0,0,0,0,0,0,0,0,0,0,0,0,0
23188,9016,6810,1045,3251,2166,348,2238,3437,671,464,2206,612,620,766,208,1666,540
23192,2071,1707,276,927,461,43,714,797,104,92,364,38,142,132,52,297,67
23219,935,204,82,84,31,7,14,17,104,69,731,201,264,221,45,682,49
23220,13416,4736,1383,2015,1049,289,806,1617,1135,1178,8680,4465,1997,1361,857,5991,2689
23221,7401,2567,668,978,677,244,636,1354,203,374,4834,2313,1440,640,441,3637,1197
23222,10298,6871,1330,2931,2029,581,1033,1917,2027,1894,3427,440,1258,1154,575,2819,608
23223,17079,10733,2928,4811,2375,619,1951,2704,3512,2566,6346,1646,2127,1720,853,5385,961
23224,12275,7969,2488,3526,1576,379,1510,1815,2944,1700,4306,1100,1670,1044,492,3422,884
23225,18066,9403,2887,4218,1673,625,2227,3659,2126,1391,8663,2757,2988,1485,1433,7203,1460
23226,7013,3920,805,1649,982,484,1193,1993,341,393,3093,961,883,667,582,2464,629
23227,10581,5501,1345,2377,1316,463,1308,2388,1113,692,5080,1348,1611,887,1234,4225,855
23228,14527,7837,2183,3158,1808,688,2106,3317,1238,1176,6690,2039,2088,1574,989,5496,1194
23229,12886,8734,1127,4143,2597,867,3060,4269,755,650,4152,1163,1077,1082,830,3426,726
23230,3191,1642,453,669,326,194,458,642,232,310,1549,441,460,349,299,1255,294
23231,10378,7513,1621,3947,1516,429,2101,2811,1655,946,2865,531,1010,813,511,2381,484
23233,19749,13368,2171,7920,2679,598,6415,5167,1071,715,6381,1912,2047,1322,1100,5332,1049
23234,14492,10214,2810,4674,2263,467,3022,3692,2072,1428,4278,1055,1832,967,424,3392,886
23235,11903,8389,1158,4121,2411,699,2758,4144,868,619,3514,488,1329,1007,690,3055,459
23236,8709,6795,1011,3954,1657,173,2835,2894,512,554,1914,381,746,596,191,1511,403
23237,7364,5692,1252,3125,1151,164,2275,2242,705,470,1672,318,736,461,157,1356,316
23294,7642,3748,1227,1515,789,217,1163,1498,522,565,3894,2130,1196,403,165,3019,875
23298,0,0,0,0,0,0,0,0,0,0,0,0,0,0,0,0,0
23301,695,483,90,199,116,78,129,220,60,74,212,19,59,59,75,191,21
23302,40,40,0,25,15,0,0,28,12,0,0,0,0,0,0,0,0
23303,238,187,44,106,28,9,52,68,52,15,51,0,31,14,6,33,18
23304,60,49,6,43,0,0,11,31,7,0,11,0,0,0,11,11,0
23306,405,308,40,181,82,5,95,148,56,9,97,17,21,38,21,88,9
23307,425,253,52,96,62,43,67,83,54,49,172,10,73,66,23,156,16
23308,990,676,163,272,165,76,181,286,165,44,314,52,114,115,33,246,68
23310,2227,1432,186,645,449,152,377,603,190,262,795,44,248,280,223,701,94
23314,1662,1365,187,700,426,52,495,712,70,88,297,61,82,93,61,263,34
23315,495,372,41,165,118,48,109,202,45,16,123,13,32,45,33,113,10
23316,56,26,6,15,5,0,12,8,4,2,30,2,8,13,7,25,5
23320,17060,11951,3183,6257,2106,405,4646,4766,1550,989,5109,1499,1970,1192,448,4016,1093
23321,10621,8666,1588,4634,2052,392,3270,3523,1109,764,1955,333,755,528,339,1719,236
23322,16906,14689,2314,9214,2797,364,7491,5370,1083,745,2217,409,858,619,331,1705,512
23323,10440,8485,1840,4641,1717,287,3560,3189,1090,646,1955,345,770,603,237,1549,406
23324,8500,5765,1566,2373,1445,381,1287,1827,1669,982,2735,413,876,882,564,2311,424
23325,6308,4711,1073,2172,1189,277,1259,1955,889,608,1597,340,540,433,284,1249,348
23336,2061,1249,184,470,487,108,272,744,161,72,812,153,233,251,175,701,111
23337,293,226,0,169,47,10,147,79,0,0,67,32,35,0,0,59,8
23347,125,89,12,41,27,9,16,48,8,17,36,2,3,14,17,35,1
23350,1525,1062,150,443,373,96,235,514,166,147,463,51,89,185,138,419,44
23354,178,153,7,45,68,33,28,111,0,14,25,0,7,18,0,25,0
23356,618,413,43,186,154,30,99,238,76,0,205,0,28,162,15,177,28
23357,240,145,36,69,32,8,46,61,28,10,95,8,18,41,28,76,19
23358,67,22,0,0,22,0,0,22,0,0,45,10,4,17,14,28,17
23359,299,226,45,120,49,12,83,78,41,24,73,5,18,32,18,50,23
23389,87,46,5,11,22,8,11,27,0,8,41,0,16,12,13,31,10
23395,437,308,42,174,67,25,82,110,73,43,129,0,52,50,27,129,0
23401,99,61,9,28,13,11,13,38,3,7,38,3,3,14,18,32,6
23404,25,9,7,0,0,2,7,0,0,2,16,0,0,11,5,16,0
23405,374,282,30,102,129,21,60,150,44,28,92,0,34,34,24,79,13
23407,25,18,0,8,10,0,0,0,8,10,7,0,0,7,0,7,0
23409,47,37,0,20,13,4,9,28,0,0,10,0,7,3,0,10,0
23410,997,697,137,306,187,67,195,328,104,70,300,51,67,100,82,247,53
23413,409,261,57,105,78,21,76,95,42,48,148,14,42,49,43,127,21
23415,1334,900,194,367,282,57,234,345,143,178,434,146,69,174,45,369,65
23416,78,55,8,28,19,0,28,13,8,6,23,0,12,0,11,23,0
23417,1782,1131,149,478,381,123,339,583,107,102,651,57,163,287,144,605,46
23418,322,221,49,102,58,12,67,97,43,14,101,6,37,26,32,87,14
23420,1098,805,124,399,215,67,229,323,97,156,293,41,108,113,31,268,25
23421,1568,1107,230,534,282,61,298,451,206,152,461,87,87,153,134,383,78
23423,217,122,0,38,61,23,17,105,0,0,95,10,12,22,51,81,14
23426,78,42,4,21,17,0,0,42,0,0,36,9,0,27,0,36,0
23427,165,106,10,44,24,28,27,51,8,20,59,6,15,17,21,50,9
23430,5674,4433,638,2355,1209,231,1571,1876,522,464,1241,177,445,405,214,1081,160
23432,414,316,26,186,85,19,122,125,17,52,98,4,33,37,24,79,19
23433,470,376,16,172,142,46,106,236,13,21,94,18,20,35,21,82,12
23434,14925,10998,2538,5315,2538,607,3313,4060,2135,1490,3927,507,1436,1271,713,3396,531
23435,5162,4287,996,2225,880,186,1822,1648,502,315,875,156,419,186,114,677,198
23436,285,236,13,94,123,6,57,132,13,34,49,4,16,8,21,41,8
23437,1510,1181,174,605,343,59,420,556,104,101,329,31,120,93,85,267,62
23438,524,366,17,242,76,31,132,137,33,64,158,24,52,53,29,144,14
23440,259,213,25,124,47,17,70,109,13,21,46,7,2,25,12,46,0
23441,18,5,0,0,5,0,5,0,0,0,13,0,0,0,13,13,0
23442,459,345,82,171,65,27,144,127,27,47,114,21,16,56,21,111,3
23451,19241,10184,2693,4575,2203,713,2987,4772,1508,917,9057,3143,2846,1869,1199,6830,2227
23452,22304,16431,3857,8389,3652,533,6344,6505,2243,1339,5873,1975,1965,1328,605,4397,1476
23454,22585,16422,4466,8535,2844,577,7199,5706,2505,1012,6163,2139,2031,1263,730,4431,1732
23455,17548,11892,2663,5241,2951,1037,4043,5628,1270,951,5656,1763,1745,1185,963,4331,1325
23456,24121,19945,5203,11794,2669,279,9967,6571,2308,1099,4176,1577,1783,707,109,2808,1368
23457,1367,1051,132,577,285,57,394,529,30,98,316,34,101,116,65,242,74
23459,203,203,177,26,0,0,106,39,58,0,0,0,0,0,0,0,0
23461,44,44,21,23,0,0,27,8,9,0,0,0,0,0,0,0,0
23462,22433,15759,5443,7083,2742,491,5832,5232,3105,1590,6674,2083,2448,1476,667,4949,1725
23464,24284,19691,3866,11283,4087,455,8658,7065,2513,1455,4593,1137,1939,1137,380,3424,1169
23480,133,83,11,34,34,4,16,53,4,10,50,0,17,23,10,44,6
23487,2103,1565,333,776,396,60,498,670,270,127,538,67,211,175,85,458,80
23488,96,96,16,49,31,0,17,19,34,26,0,0,0,0,0,0,0
23502,7773,5413,1345,2415,1290,363,1537,2171,955,750,2360,599,751,579,431,1768,592
23503,13368,7648,2530,3420,1204,494,2469,2879,1602,698,5720,1816,2349,1027,528,4330,1390
23504,8009,5404,1890,2141,984,389,667,895,2439,1403,2605,355,788,880,582,2267,338
23505,12144,7158,3142,2610,970,436,2776,2365,1327,690,4986,1631,1459,956,940,3912,1074
23507,3570,1282,329,630,257,66,377,717,110,78,2288,1124,740,272,152,1765,523
23508,6510,3496,813,1664,758,261,1025,1243,638,590,3014,1517,768,420,309,1869,1145
23509,5053,3136,602,1478,814,242,896,1059,554,627,1917,256,633,637,391,1536,381
23510,1802,841,382,252,131,76,36,285,409,111,961,298,334,220,109,820,141
23513,11084,7375,2064,3421,1393,497,2092,2306,1839,1138,3709,975,1177,868,689,2897,812
23517,2087,792,151,444,155,42,167,323,155,147,1295,595,368,211,121,951,344
23518,12060,7895,2238,3348,1730,579,2395,3287,1391,822,4165,1153,1400,1084,528,3118,1047
23521,505,505,282,223,0,0,469,21,15,0,0,0,0,0,0,0,0
23523,2718,1828,540,724,405,159,251,299,726,552,890,58,263,343,226,773,117
23601,10344,6603,1843,2999,1362,399,2193,2629,1175,606,3741,835,1387,806,713,3116,625
23602,16058,11076,3192,5242,2226,416,3915,4080,2020,1061,4982,1543,1723,1150,566,3995,987
23603,1326,907,401,380,99,27,376,330,157,44,419,117,228,69,5,316,103
23604,964,948,685,263,0,0,711,112,119,6,16,16,0,0,0,16,0
23605,6102,3762,1152,1591,790,229,1062,1259,837,604,2340,760,855,437,288,1917,423
23606,11083,6748,1919,2764,1481,584,2166,2994,1031,557,4335,1436,1267,923,709,3511,824
23607,10110,6314,1837,2466,1511,500,988,1437,2344,1545,3796,619,1326,1237,614,3265,531
23608,15279,11309,3621,5617,1856,215,4586,3655,2123,945,3970,1323,1616,725,306,3093,877
23651,374,345,184,156,5,0,210,66,64,5,29,11,18,0,0,29,0
23661,5866,3881,595,1813,1070,403,884,1656,647,694,1985,216,674,616,479,1692,293
23662,4166,3384,414,1787,1066,117,1323,1605,283,173,782,95,261,241,185,658,124
23663,5637,4087,888,2174,828,197,1227,1307,1045,508,1550,373,626,431,120,1229,321
23664,4435,2844,463,1461,794,126,862,1333,398,251,1591,363,579,414,235,1251,340
23665,1800,1747,687,1053,7,0,1323,280,135,9,53,7,24,22,0,45,8
23666,19809,13095,3073,6386,2948,688,4369,5492,2049,1185,6714,2301,2072,1398,943,5544,1170
23669,15949,10727,2642,5005,2504,576,3068,4000,2309,1350,5222,1539,1799,1287,597,4120,1102
23690,890,619,154,311,144,10,137,140,231,111,271,38,115,71,47,241,30
23691,23,23,5,14,4,0,18,0,5,0,0,0,0,0,0,0,0
23692,6396,4973,553,2564,1559,297,1745,2490,437,301,1423,244,551,407,221,1193,230
23693,6338,5096,675,3421,857,143,2626,1931,410,129,1242,460,380,284,118,999,243
23696,1280,991,122,465,365,39,396,508,63,24,289,46,102,106,35,232,57
23701,10332,7340,1525,2808,2336,671,1572,3156,1214,1398,2992,424,844,958,766,2682,310
23702,4412,2982,815,1558,407,202,943,910,675,454,1430,272,479,421,258,1123,307
23703,9670,7010,1846,3187,1522,455,2412,2665,1173,760,2660,755,962,589,354,2106,554
23704,7483,4488,1100,1926,985,477,642,1393,1389,1064,2995,442,994,895,664,2531,464
23707,6240,3808,1029,1736,640,403,898,1222,979,709,2432,532,844,590,466,2062,370
23708,0,0,0,0,0,0,0,0,0,0,0,0,0,0,0,0,0
23801,1405,1231,709,522,0,0,855,173,191,12,174,159,15,0,0,161,13
23803,15218,10126,2276,4562,2492,796,2194,3473,2402,2057,5092,818,1705,1691,878,4286,806
23805,7301,4971,914,2328,1389,340,1476,2032,823,640,2330,619,665,613,433,1982,348
23821,654,475,52,242,133,48,150,197,40,88,179,14,57,58,50,155,24
23824,2760,1899,315,798,588,198,553,849,257,240,861,94,263,266,238,800,61
23827,537,396,78,161,121,36,82,194,58,62,141,21,41,38,41,134,7
23828,223,164,11,99,45,9,67,39,20,38,59,0,20,24,15,57,2
23829,479,333,25,134,153,21,84,168,32,49,146,23,40,46,37,127,19
23830,496,375,82,187,87,19,175,130,41,29,121,12,8,60,41,121,0
23831,9258,7068,1412,3849,1599,208,2903,2990,795,380,2190,525,906,538,221,1786,404
23832,8656,6985,1465,4270,1137,113,3341,2521,712,411,1671,394,872,343,62,1255,416
23833,764,550,101,278,142,29,249,201,49,51,214,17,99,74,24,192,22
23834,9777,6889,1281,3342,1731,535,2256,2970,1001,662,2888,608,846,896,538,2450,438
23836,3085,2444,488,1381,478,97,976,1114,271,83,641,87,285,196,73,530,111
23837,1525,1065,156,521,285,103,317,506,130,112,460,45,126,178,111,432,28
23838,3731,3245,272,2095,807,71,1395,1576,128,146,486,34,253,168,31,419,67
23839,364,292,40,120,107,25,99,135,22,36,72,0,21,11,40,61,11
23840,543,383,85,163,105,30,140,167,36,40,160,24,72,32,32,139,21
23841,1210,948,118,460,305,65,248,453,109,138,262,24,143,55,40,209,53
23842,1997,1522,268,786,415,53,599,607,137,179,475,75,162,147,91,395,80
23843,288,179,5,107,55,12,52,88,22,17,109,12,18,26,53,84,25
23844,341,216,78,65,46,27,64,26,69,57,125,0,22,72,31,112,13
23845,150,111,30,50,31,0,54,48,9,0,39,0,31,8,0,21,18
23846,333,241,19,103,106,13,78,121,12,30,92,0,16,56,20,92,0
23847,5112,3485,668,1543,1009,265,925,1424,619,517,1627,225,343,611,448,1424,203
23850,347,270,45,147,60,18,112,69,40,49,77,12,16,29,20,75,2
23851,5408,3743,741,1729,967,306,1050,1416,725,552,1665,274,457,545,389,1509,156
23856,568,381,55,185,127,14,98,112,63,108,187,25,72,62,28,160,27
23857,193,165,6,57,86,16,17,127,5,16,28,12,16,0,0,20,8
23860,10878,7587,1740,3563,1819,465,2068,3010,1588,921,3291,564,1059,982,686,2758,533
23866,751,565,53,286,167,59,164,308,49,44,186,13,30,84,59,175,11
23867,985,658,104,265,202,87,139,299,121,99,327,33,104,100,90,292,35
23868,1963,1325,247,577,406,95,269,551,305,200,638,35,142,279,182,585,53
23872,880,644,102,255,227,60,139,361,55,89,236,48,97,45,46,190,46
23874,369,279,20,170,74,15,88,139,15,37,90,4,25,29,32,73,17
23875,3236,2524,494,1288,614,128,880,1104,392,148,712,147,206,236,123,625,87
23876,203,157,9,58,65,25,35,70,26,26,46,7,16,17,6,46,0
23878,504,363,58,202,83,20,133,160,52,18,141,9,53,20,59,129,12
23879,244,161,13,77,53,18,54,77,5,25,83,21,27,28,7,83,0
23881,838,594,87,310,132,65,158,261,77,98,244,38,59,94,53,209,35
23882,1052,733,137,301,223,72,135,422,106,70,319,23,90,119,87,300,19
23883,897,669,52,427,141,49,209,279,97,84,228,20,82,102,24,194,34
23885,987,780,99,423,219,39,231,412,80,57,207,12,54,106,35,147,60
23887,255,221,12,78,115,16,37,171,7,6,34,0,17,10,7,34,0
23888,911,615,100,286,178,51,147,268,109,91,296,14,111,94,77,287,9
23889,235,204,29,89,59,27,64,66,18,56,31,0,13,18,0,29,2
23890,1600,1071,214,458,306,93,313,404,196,158,529,71,141,207,110,449,80
23893,275,131,19,74,28,10,32,37,40,22,144,20,42,51,31,125,19
23894,281,199,11,109,73,6,53,128,14,4,82,0,19,14,49,82,0
23897,235,179,39,72,41,27,64,66,23,26,56,0,13,0,43,56,0
23898,764,646,68,321,221,36,217,357,34,38,118,13,44,51,10,94,24
23899,126,86,7,45,25,9,28,51,1,6,40,10,18,5,7,37,3
23901,5067,3095,517,1361,858,359,1013,1294,386,402,1972,473,542,504,453,1602,370
23915,260,160,41,52,43,24,50,89,16,5,100,19,36,25,20,74,26
23917,1290,874,107,411,291,65,230,414,92,138,416,36,103,189,88,372,44
23919,816,598,109,152,285,52,145,387,39,27,218,28,95,74,21,209,9
23920,1442,952,123,508,275,46,328,427,105,92,490,66,118,193,113,444,46
23921,791,524,65,269,174,16,116,264,117,27,267,44,64,112,47,218,49
23922,963,634,120,242,200,72,136,344,73,81,329,32,83,135,79,284,45
23923,894,662,107,233,247,75,188,315,75,84,232,49,78,47,58,194,38
23924,2758,1838,316,791,547,184,490,814,252,282,920,113,237,300,270,797,123
23927,1918,1347,172,608,459,108,322,724,138,163,571,80,119,200,172,548,23
23930,2310,1639,250,808,451,130,527,660,266,186,671,85,183,203,200,600,71
23934,280,198,21,106,42,29,83,83,7,25,82,12,12,35,23,82,0
23936,2076,1456,270,634,460,92,426,634,222,174,620,121,202,195,102,555,65
23937,822,567,97,246,159,65,136,284,86,61,255,27,107,68,53,221,34
23938,169,92,17,35,34,6,20,40,17,15,77,0,11,38,28,77,0
23939,27,27,16,11,0,0,10,7,10,0,0,0,0,0,0,0,0
23942,466,348,72,153,96,27,107,172,14,55,118,10,43,33,32,118,0
23943,94,46,0,26,20,0,33,13,0,0,48,20,0,28,0,48,0
23944,1742,1226,213,561,358,94,360,542,151,173,516,51,129,189,147,450,66
23947,1817,1238,184,580,369,105,345,592,182,119,579,40,156,244,139,521,58
23950,1289,904,128,413,298,65,207,447,89,161,385,59,81,159,86,321,64
23952,73,48,9,18,21,0,13,22,3,10,25,0,5,20,0,17,8
23954,710,510,78,282,131,19,124,250,82,54,200,15,90,43,52,172,28
23958,1174,877,119,436,246,76,233,462,82,100,297,23,105,95,74,263,34
23959,516,373,53,158,123,39,131,170,32,40,143,0,32,37,74,125,18
23960,641,439,72,193,143,31,128,204,66,41,202,21,57,35,89,178,24
23962,55,27,3,19,0,5,22,0,0,5,28,0,8,15,5,28,0
23963,190,144,16,66,62,0,53,68,23,0,46,11,7,22,6,35,11
23964,593,404,49,212,90,53,108,177,36,83,189,15,44,79,51,189,0
23966,668,529,119,191,156,63,194,234,60,41,139,16,32,81,10,116,23
23967,497,358,73,116,129,40,118,189,21,30,139,8,53,46,32,109,30
23968,336,238,21,87,98,32,56,97,28,57,98,0,11,64,23,81,17
23970,3228,2263,325,1032,770,136,581,1051,316,315,965,118,258,336,253,849,116
23974,1705,1120,200,486,324,110,252,503,220,145,585,49,164,176,196,558,27
23976,84,53,25,11,11,6,25,19,0,9,31,6,0,6,19,31,0
24011,0,0,0,0,0,0,0,0,0,0,0,0,0,0,0,0,0
24012,12146,7380,1797,3131,1858,594,1998,3264,1158,960,4766,965,1499,1127,1175,4107,659
24013,3201,2015,534,911,427,143,459,646,509,401,1186,185,353,390,258,1001,185
24014,10257,6235,1238,2800,1722,475,1923,3107,629,576,4022,1101,1328,868,725,3470,552
24015,7459,3966,1018,1893,695,360,1237,1703,607,419,3493,998,1215,698,582,2992,501
24016,4081,1754,549,708,332,165,352,456,511,435,2327,666,959,483,219,1922,405
24017,9477,6260,1490,2769,1554,447,1216,2167,1645,1232,3217,441,1063,1073,640,2842,375
24018,12194,8507,1065,4276,2357,809,3039,4259,682,527,3687,708,1011,1155,813,3214,473
24019,9582,7129,1075,3661,1916,477,2703,3263,639,524,2453,414,911,801,327,2163,290
24020,0,0,0,0,0,0,0,0,0,0,0,0,0,0,0,0,0
24053,1163,843,191,299,310,43,246,502,47,48,320,41,98,115,66,293,27
24054,2533,1893,428,889,492,84,567,836,267,223,640,107,178,223,132,554,86
24055,5905,4322,888,1717,1445,272,1172,2193,504,453,1583,226,478,490,389,1397,186
24058,88,51,13,29,9,0,0,51,0,0,37,0,12,25,0,37,0
24059,308,248,8,175,65,0,89,137,16,6,60,0,14,26,20,53,7
24060,16962,7338,2119,3119,1637,463,2608,3433,705,592,9624,7074,1245,798,507,4606,5018
24064,1858,1485,192,828,402,63,581,778,87,39,373,31,130,137,75,335,38
24065,2261,1662,253,817,459,133,566,881,126,89,599,102,213,150,134,520,79
24066,1887,1396,284,601,401,110,459,691,94,152,491,79,156,174,82,436,55
24067,873,612,87,320,167,38,172,364,38,38,261,39,85,91,46,221,40
24069,840,605,125,297,146,37,229,252,34,90,235,15,105,83,32,199,36
24070,406,316,50,194,53,19,128,172,5,11,90,12,50,11,17,82,8
24072,390,256,51,103,92,10,125,97,0,34,134,27,74,12,21,123,11
24073,10292,7235,1857,3402,1684,292,2613,3269,843,510,3057,726,899,949,483,2533,524
24076,371,270,86,98,86,0,96,89,63,22,101,23,35,11,32,86,15
24077,230,147,44,87,16,0,68,53,8,18,83,13,33,37,0,69,14
24078,3381,2193,541,890,585,177,643,1010,319,221,1188,284,327,368,209,1009,179
24079,726,570,128,241,171,30,185,337,38,10,156,0,65,75,16,137,19
24082,112,83,34,29,9,11,41,27,9,6,29,11,10,8,0,29,0
24083,746,623,61,296,256,10,212,355,30,26,123,0,44,59,20,104,19
24084,4308,3091,713,1307,929,142,838,1636,356,261,1217,237,397,384,199,1027,190
24085,874,682,102,314,214,52,210,415,25,32,192,7,68,62,55,192,0
24086,73,55,11,22,15,7,12,36,0,7,18,6,0,5,7,12,6
24087,1428,1029,263,500,216,50,373,434,106,116,399,52,146,139,62,328,71
24088,1489,1086,246,519,259,62,352,538,82,114,403,81,145,122,55,319,84
24089,1085,712,97,296,241,78,209,376,46,81,373,8,116,134,115,366,7
24090,1538,1178,162,604,360,52,396,631,68,83,360,65,108,121,66,340,20
24091,2725,1940,358,746,615,221,587,1048,175,130,785,121,234,230,200,745,40
24092,1074,809,147,360,233,69,248,414,57,90,265,46,71,117,31,251,14
24093,90,60,16,19,19,6,27,24,4,5,30,0,16,4,10,28,2
24094,26,4,0,4,0,0,4,0,0,0,22,0,7,15,0,15,7
24095,1614,1256,328,654,256,18,507,605,96,48,358,61,151,122,24,280,78
24101,2027,1599,249,828,465,57,561,854,93,91,428,52,143,163,70,359,69
24102,717,524,143,197,142,42,194,227,74,29,193,34,56,77,26,174,19
24104,1427,1074,122,424,410,118,213,651,116,94,353,84,66,136,67,330,23
24105,153,113,7,48,34,24,31,67,0,15,40,16,16,0,8,25,15
24112,14447,9753,1878,4299,2820,756,2668,4349,1412,1324,4694,596,1510,1402,1186,4243,451
24120,887,626,60,272,207,87,152,377,30,67,261,54,67,81,59,225,36
24121,3682,2923,267,1262,1168,226,753,1874,133,163,759,103,227,285,144,621,138
24122,798,583,108,256,175,44,201,287,50,45,215,23,108,60,24,208,7
24124,1952,1362,240,578,425,119,376,719,116,151,590,56,127,239,168,548,42
24127,1692,1234,244,557,345,88,462,536,122,114,458,52,175,112,119,406,52
24128,811,574,81,310,129,54,222,283,13,56,237,50,78,69,40,205,32
24131,66,41,0,27,8,6,21,14,0,6,25,0,6,12,7,25,0
24132,204,132,51,54,27,0,51,61,20,0,72,0,0,41,31,72,0
24133,1060,831,134,473,206,18,260,457,106,8,229,56,62,55,56,216,13
24134,2272,1647,356,624,481,186,509,770,170,198,625,76,167,207,175,560,65
24136,1310,924,161,426,272,65,294,470,63,97,386,76,113,122,75,333,53
24137,1006,760,129,348,256,27,182,455,68,55,246,49,58,102,37,211,35
24138,551,460,118,204,125,13,163,181,64,52,91,17,47,12,15,73,18
24139,167,116,5,57,54,0,25,68,0,23,51,7,6,19,19,35,16
24141,8342,4301,887,1814,1234,366,1250,2238,461,352,4041,2338,690,504,509,2613,1428
24142,7,7,7,0,0,0,7,0,0,0,0,0,0,0,0,0,0
24147,434,317,67,116,110,24,92,173,25,27,117,28,36,19,34,103,14
24148,3491,2562,413,1239,745,165,781,1303,202,276,929,92,315,353,169,849,80
24149,1079,819,123,430,208,58,255,431,63,70,260,47,83,91,39,231,29
24150,166,105,26,51,16,12,48,32,25,0,61,14,0,41,6,61,0
24151,7229,5015,1011,2291,1395,318,1623,2207,709,476,2214,378,697,629,510,1885,329
24153,14101,9717,1507,4612,2904,694,3164,4714,952,887,4384,820,1270,1275,1019,3766,618
24161,156,103,21,38,44,0,35,45,0,23,53,20,16,17,0,47,6
24162,961,697,94,368,193,42,192,377,75,53,264,71,81,90,22,190,74
24165,703,537,92,226,187,32,151,313,27,46,166,25,49,69,23,159,7
24167,101,60,32,4,24,0,32,24,0,4,41,10,12,19,0,41,0
24168,182,132,34,38,60,0,30,61,13,28,50,12,5,13,20,38,12
24171,3862,2652,587,1074,792,199,760,1425,286,181,1210,172,305,422,311,1141,69
24174,979,733,193,314,146,80,204,414,56,59,246,60,84,68,34,197,49
24175,3056,2459,298,1218,794,149,816,1383,115,145,597,72,200,211,114,529,68
24176,456,363,7,177,159,20,104,238,0,21,93,14,25,32,22,93,0
24179,7196,5225,826,2629,1515,255,1546,2596,602,481,1971,337,554,550,530,1706,265
24184,1280,967,206,453,267,41,341,452,106,68,313,65,52,142,54,262,51
24185,403,271,43,104,98,26,84,124,36,27,132,28,46,35,23,111,21
24201,7384,4653,939,1871,1431,412,1286,2273,604,490,2731,242,774,842,873,2514,217
24202,4978,3718,621,1714,1114,269,1128,1983,323,284,1260,232,397,410,221,1137,123
24210,6420,4153,855,1721,1237,340,1287,2151,285,430,2267,509,676,636,446,2008,259
24211,3585,2766,408,1404,766,188,950,1514,144,158,819,143,327,255,94,692,127
24215,47,23,16,7,0,0,8,0,7,8,24,0,0,16,8,24,0
24216,1322,912,196,404,242,70,269,432,108,103,410,39,104,139,128,397,13
24217,219,174,32,92,41,9,53,86,12,23,45,5,7,15,18,45,0
24218,53,38,14,6,18,0,23,9,0,6,15,0,5,10,0,15,0
24219,4505,3239,728,1448,856,207,1037,1585,373,244,1266,138,413,443,272,1168,98
24220,291,242,82,97,52,11,102,106,23,11,49,0,19,21,9,44,5
24221,502,342,69,192,68,13,92,167,50,33,160,4,35,37,84,152,8
24224,2748,2064,352,992,569,151,671,969,195,229,684,95,210,215,164,657,27
24225,846,622,135,261,162,64,179,321,71,51,224,10,89,103,22,201,23
24226,767,542,70,282,154,36,204,247,40,51,225,25,33,104,63,215,10
24228,3136,2255,436,1043,605,171,686,1050,244,275,881,102,237,340,202,814,67
24230,3653,2736,522,1330,711,173,837,1299,348,252,917,160,261,293,203,830,87
24236,1377,929,158,347,341,83,281,438,84,126,448,39,106,154,149,418,30
24237,470,331,40,112,165,14,58,197,17,59,139,6,44,75,14,121,18
24239,106,66,28,18,15,5,39,22,0,5,40,12,9,7,12,28,12
24243,884,629,149,298,135,47,170,326,73,60,255,28,67,112,48,242,13
24244,2035,1591,385,638,483,85,583,733,131,144,444,53,104,145,142,419,25
24245,540,338,88,150,72,28,117,144,39,38,202,20,67,62,53,183,19
24248,1107,789,158,357,230,44,317,321,46,105,318,36,65,141,76,294,24
24250,607,442,68,190,156,28,117,298,19,8,165,23,42,33,67,151,14
24251,3780,2728,445,1145,893,245,791,1452,175,310,1052,107,237,427,281,991,61
24256,1096,790,151,432,166,41,301,332,90,67,306,34,84,130,58,278,28
24258,664,501,152,201,116,32,204,240,35,22,163,22,48,85,8,158,5
24260,2479,1918,424,875,538,81,683,932,128,175,561,45,199,179,138,531,30
24263,2363,1685,350,728,445,162,519,791,179,196,678,75,173,276,154,629,49
24265,295,235,65,110,55,5,94,86,37,18,60,8,0,39,13,56,4
24266,3558,2554,541,1222,644,147,863,1282,212,197,1004,124,276,324,280,927,77
24269,63,42,11,12,19,0,0,37,5,0,21,0,10,5,6,21,0
24270,216,153,20,87,31,15,59,76,0,18,63,0,22,29,12,51,12
24271,1083,778,117,325,258,78,278,404,37,59,305,18,81,118,88,286,19
24272,219,186,34,109,34,9,87,79,5,15,33,0,14,13,6,33,0
24273,2741,1831,441,867,406,117,466,880,303,182,910,183,189,372,166,837,73
24277,2460,1648,343,739,444,122,473,775,200,200,812,80,186,301,245,748,64
24279,1883,1466,273,702,392,99,442,724,139,161,417,42,124,140,111,379,38
24280,283,236,38,122,76,0,65,148,23,0,47,8,0,30,9,47,0
24281,987,686,155,280,186,65,224,327,71,64,301,20,61,141,79,266,35
24282,423,305,75,117,71,42,106,114,36,49,118,15,34,44,25,110,8
24283,897,637,148,266,162,61,207,297,67,66,260,30,57,102,71,256,4
24285,29,22,0,0,5,17,5,9,0,8,7,0,0,7,0,7,0
24290,937,624,118,255,200,51,167,337,71,49,313,48,62,108,95,302,11
24292,282,188,4,111,73,0,41,108,15,24,94,8,18,33,35,94,0
24293,4100,2916,692,1423,644,157,1075,1327,290,224,1184,238,327,403,216,1081,103
24301,6451,4354,959,1842,1213,340,1245,2121,495,493,2097,245,581,643,628,1849,248
24311,867,604,78,359,147,20,250,263,32,59,263,34,93,76,60,240,23
24312,991,747,155,316,192,84,183,440,84,40,244,27,81,98,38,228,16
24313,286,229,40,113,76,0,56,127,18,28,57,8,25,17,7,42,15
24314,570,462,103,218,119,22,195,234,28,5,108,8,52,27,21,108,0
24315,1314,959,127,465,303,64,300,532,40,87,355,49,105,115,86,325,30
24316,14,14,0,14,0,0,8,6,0,0,0,0,0,0,0,0,0
24317,1645,1193,259,534,308,92,441,515,113,124,452,55,172,149,76,421,31
24318,296,209,42,100,52,15,74,103,13,19,87,13,14,36,24,73,14
24319,2859,2104,452,971,569,112,738,982,195,189,755,115,218,242,180,692,63
24322,110,86,0,25,54,7,17,54,0,15,24,0,7,17,0,24,0
24323,400,290,64,140,62,24,86,155,27,22,110,13,33,42,22,110,0
24324,1011,717,140,362,191,24,242,390,51,34,294,59,49,165,21,260,34
24325,373,289,70,98,87,34,95,124,36,34,84,17,15,25,27,77,7
24326,539,428,64,157,147,60,98,256,25,49,111,16,26,45,24,92,19
24327,10,10,0,0,10,0,10,0,0,0,0,0,0,0,0,0,0
24328,559,433,76,201,94,62,151,253,8,21,126,7,31,48,40,126,0
24330,1564,1085,246,449,303,87,335,581,79,90,479,44,100,184,151,455,24
24333,7547,5128,1092,2162,1575,299,1567,2694,466,401,2419,338,683,920,478,2190,229
24340,2203,1582,280,733,469,100,481,785,147,169,621,59,195,218,149,575,46
24343,3850,2735,539,1099,869,228,782,1543,217,193,1115,132,274,429,280,1020,95
24347,747,563,125,194,211,33,190,260,47,66,184,13,59,51,61,177,7
24348,1853,1238,252,546,334,106,400,597,111,130,615,94,164,222,135,562,53
24350,538,420,71,199,115,35,141,231,8,40,118,15,47,8,48,93,25
24351,225,160,39,61,60,0,72,65,9,14,65,0,0,56,9,65,0
24352,370,285,44,144,76,21,90,147,21,27,85,8,21,47,9,70,15
24354,6510,4524,926,1933,1342,323,1359,2169,554,442,1986,337,512,639,498,1778,208
24360,2128,1701,441,737,461,62,547,863,178,113,427,47,134,145,101,383,44
24361,2079,1437,378,619,377,63,575,634,124,104,642,163,201,170,108,549,93
24363,651,492,67,208,156,61,140,300,29,23,159,0,32,41,86,139,20
24366,525,389,94,122,130,43,108,206,39,36,136,8,36,57,35,127,9
24368,1705,1210,254,481,416,59,418,587,138,67,495,124,160,100,111,426,69
24370,2847,2107,405,893,655,154,626,1083,171,227,740,86,128,320,206,681,59
24374,307,250,52,129,45,24,112,85,21,32,57,13,7,19,18,57,0
24375,619,429,95,159,146,29,141,213,54,21,190,0,51,83,56,180,10
24377,168,114,23,38,39,14,61,39,0,14,54,0,28,5,21,54,0
24378,599,397,60,142,165,30,70,262,32,33,202,7,67,71,57,173,29
24380,1020,761,138,335,207,81,273,388,51,49,259,29,106,76,48,235,24
24381,1453,1063,189,509,245,120,301,557,95,110,390,47,112,104,127,354,36
24382,5944,3925,768,1723,1103,331,1080,1924,434,487,2019,348,623,589,459,1823,196
24401,13702,8798,1657,3898,2443,800,2646,4268,1110,774,4904,888,1518,1480,1018,4236,668
24412,42,33,0,13,20,0,0,26,0,7,9,0,0,9,0,9,0
24413,102,85,7,21,53,4,9,61,11,4,17,0,5,5,7,17,0
24415,8,0,0,0,0,0,0,0,0,0,8,0,0,0,8,8,0
24416,3524,2434,490,1103,641,200,729,1212,279,214,1090,149,308,392,241,928,162
24421,1475,1172,163,591,360,58,387,646,39,100,303,81,100,71,51,265,38
24422,2950,1882,356,817,558,151,532,832,296,222,1068,79,289,379,321,965,103
24426,6410,4564,905,1957,1292,410,1360,2416,416,372,1846,236,485,623,502,1694,152
24430,703,470,91,189,127,63,137,250,39,44,233,41,56,98,38,210,23
24431,992,738,149,364,214,11,263,364,75,36,254,13,82,126,33,211,43
24432,127,94,36,46,12,0,43,34,17,0,33,0,11,6,16,33,0
24433,53,49,0,18,31,0,4,36,0,9,4,0,0,0,4,4,0
24435,633,490,66,246,165,13,152,310,6,22,143,0,52,55,36,132,11
24437,311,255,36,96,95,28,65,134,37,19,56,21,6,22,7,56,0
24439,549,391,88,171,112,20,103,206,49,33,158,8,48,60,42,136,22
24440,807,626,117,302,160,47,197,297,66,66,181,29,97,46,9,145,36
24441,2066,1604,401,761,338,104,564,757,146,137,462,71,116,174,101,395,67
24442,61,45,5,13,14,13,5,33,3,4,16,0,4,9,3,16,0
24445,1102,793,112,324,289,68,265,450,40,38,309,62,62,107,78,289,20
24448,156,89,13,38,24,14,26,54,0,9,67,9,8,28,22,59,8
24450,5613,3538,474,1603,1104,357,1125,1735,333,345,2075,698,408,599,370,1677,398
24457,115,86,24,16,37,9,16,51,8,11,29,0,8,14,7,21,8
24458,237,152,16,65,45,26,55,62,5,30,85,10,29,25,21,64,21
24459,282,237,37,99,84,17,60,126,33,18,45,5,10,17,13,34,11
24460,644,512,75,270,130,37,196,228,40,48,132,23,53,46,10,132,0
24463,7,0,0,0,0,0,0,0,0,0,7,0,0,0,7,0,7
24464,37,20,0,15,0,5,6,3,0,11,17,0,12,0,5,17,0
24465,660,413,39,216,119,39,121,234,23,35,247,34,42,92,79,232,15
24467,784,632,94,317,175,46,251,314,34,33,152,11,62,52,27,130,22
24471,549,423,62,236,94,31,165,182,20,56,126,28,87,0,11,100,26
24472,945,664,175,285,170,34,213,292,127,32,281,18,90,104,69,238,43
24473,381,286,35,124,97,30,78,159,21,28,95,10,25,35,25,87,8
24474,65,50,0,24,26,0,6,30,8,6,15,9,6,0,0,6,9
24475,113,85,15,46,13,11,27,48,5,5,28,5,5,10,8,17,11
24477,3206,2589,412,1363,700,114,941,1252,209,187,617,74,242,141,160,503,114
24479,518,394,76,171,131,16,150,190,47,7,124,0,18,55,51,117,7
24482,1820,1241,287,577,349,28,399,617,133,92,579,126,226,199,28,495,84
24483,237,161,34,63,48,16,39,84,16,22,76,19,28,11,18,76,0
24484,371,240,40,127,53,20,73,139,7,21,131,17,57,22,35,97,34
24485,141,95,5,55,29,6,31,58,0,6,46,4,27,15,0,28,18
24486,823,633,98,304,189,42,256,298,15,64,190,43,86,15,46,172,18
24487,102,71,10,13,35,13,15,43,0,13,31,8,9,14,0,31,0
24501,10566,6123,1776,2574,1354,419,1427,2110,1687,899,4443,1124,1375,1217,727,3768,675
24502,12417,8431,1781,3549,2412,689,2476,4038,1118,799,3986,1198,1095,942,751,3378,608
24503,7157,4924,753,2209,1377,585,1708,2322,477,417,2233,527,529,581,596,2031,202
24504,3640,2240,404,1057,596,183,453,709,542,536,1400,192,583,450,175,1151,249
24517,2274,1543,292,701,406,144,420,687,216,220,731,107,158,291,175,673,58
24520,921,663,84,302,229,48,185,324,75,79,258,43,94,57,64,243,15
24521,3905,2829,483,1357,867,122,913,1355,357,204,1076,182,289,399,206,991,85
24522,3396,2559,475,1107,840,137,757,1223,375,204,837,137,201,302,197,751,86
24523,7221,5070,812,2436,1449,373,1536,2486,645,403,2151,296,676,687,492,1887,264
24526,797,526,89,186,187,64,138,319,39,30,271,65,61,84,61,213,58
24527,1121,899,153,447,250,49,347,396,88,68,222,25,77,78,42,192,30
24528,1322,954,159,452,257,86,314,415,130,95,368,27,105,135,101,343,25
24529,767,562,72,226,214,50,139,316,44,63,205,0,58,71,76,161,44
24530,411,318,37,148,94,39,90,147,28,53,93,15,46,9,23,77,16
24531,3540,2455,394,1103,759,199,680,1188,267,320,1085,130,288,364,303,1033,52
24533,48,36,19,7,10,0,26,10,0,0,12,0,12,0,0,0,12
24534,865,645,104,246,208,87,137,302,109,97,220,32,48,77,63,213,7
24536,84,52,13,30,9,0,19,21,12,0,32,8,12,12,0,24,8
24538,1363,1005,173,463,323,46,347,416,110,132,358,25,117,177,39,279,79
24539,61,47,3,12,32,0,0,23,3,21,14,0,0,0,14,14,0
24540,13844,9429,1829,4202,2626,772,2387,4086,1573,1383,4415,639,1187,1518,1071,4027,388
24541,13160,8464,1624,3841,2292,707,2144,3468,1559,1293,4696,727,1391,1379,1199,4281,415
24549,1662,1335,294,681,302,58,535,567,151,82,327,70,85,93,79,316,11
24550,2886,2219,464,1140,489,126,724,960,337,198,667,115,266,212,74,559,108
24551,6249,4792,744,2701,1218,129,2025,2297,292,178,1457,412,476,376,193,1303,154
24553,656,493,77,223,124,69,178,216,42,57,163,0,53,90,20,145,18
24554,1704,1299,207,583,372,137,391,684,87,137,405,105,129,127,44,347,58
24555,781,561,114,196,222,29,155,265,97,44,220,27,47,80,66,203,17
24556,1066,905,148,511,213,33,349,468,73,15,161,22,36,75,28,133,28
24557,3360,2338,389,1039,719,191,691,1134,241,272,1022,121,236,369,296,955,67
24558,2668,1931,302,890,648,91,554,947,175,255,737,84,244,236,173,693,44
24562,112,86,10,53,9,14,27,54,0,5,26,8,18,0,0,26,0
24563,2319,1697,330,741,510,116,547,859,142,149,622,84,197,195,146,551,71
24565,522,372,47,191,93,41,79,158,60,75,150,14,41,56,39,141,9
24566,539,375,63,195,100,17,89,227,29,30,164,18,34,70,42,142,22
24569,363,278,34,117,100,27,91,128,26,33,85,5,19,32,29,80,5
24571,734,550,110,243,175,22,242,243,28,37,184,17,65,47,55,184,0
24572,6439,4705,1019,2084,1277,325,1414,2166,594,531,1734,314,485,641,294,1515,219
24574,1280,1013,149,502,305,57,363,482,108,60,267,13,93,96,65,255,12
24577,2216,1620,294,733,438,155,543,664,148,265,596,51,155,175,215,523,73
24578,461,344,83,111,120,30,98,185,19,42,117,34,30,21,32,117,0
24579,653,431,58,154,189,30,140,188,33,70,222,6,86,79,51,195,27
24580,303,199,32,136,20,11,92,59,24,24,104,26,0,54,24,92,12
24581,18,7,0,0,0,7,0,7,0,0,11,0,0,11,0,11,0
24586,2148,1632,235,819,441,137,521,738,228,145,516,92,153,165,106,419,97
24588,3289,2342,543,1126,548,125,950,963,295,134,947,150,410,268,119,787,160
24589,967,700,150,308,202,40,252,311,65,72,267,54,100,65,48,248,19
24590,2693,1891,330,958,487,116,656,824,146,265,802,185,287,222,108,590,212
24592,5746,3825,742,1762,1003,318,985,1542,734,564,1921,180,481,779,481,1780,141
24593,766,594,107,303,142,42,182,304,43,65,172,35,13,70,54,151,21
24594,702,490,117,197,155,21,185,187,25,93,212,34,62,93,23,196,16
24595,41,3,0,3,0,0,3,0,0,0,38,23,7,8,0,34,4
24597,448,354,44,143,133,34,85,184,51,34,94,8,57,19,10,94,0
24598,811,603,111,219,185,88,231,269,30,73,208,0,83,84,41,186,22
24599,247,192,41,65,68,18,37,110,11,34,55,0,25,30,0,55,0
24601,82,67,12,26,23,6,25,21,0,21,15,0,7,8,0,15,0
24602,304,189,44,108,31,6,84,79,16,10,115,17,36,17,45,115,0
24603,647,489,76,250,154,9,186,226,37,40,158,4,69,60,25,145,13
24604,120,88,0,51,21,16,31,27,0,30,32,0,8,24,0,32,0
24605,4274,3003,365,1386,984,268,788,1671,222,322,1271,152,281,408,430,1181,90
24606,196,150,21,57,42,30,33,52,13,52,46,13,28,5,0,46,0
24607,189,141,30,63,48,0,54,70,0,17,48,6,4,27,11,45,3
24609,3238,2543,452,1207,758,126,776,1342,236,189,695,97,234,225,139,631,64
24612,135,86,21,25,21,19,20,53,5,8,49,8,6,28,7,41,8
24613,478,379,110,154,112,3,159,166,27,27,99,27,35,27,10,62,37
24614,3832,2862,489,1389,851,133,995,1400,214,253,970,102,316,367,185,924,46
24620,1223,965,246,447,221,51,261,417,141,146,258,44,95,100,19,229,29
24622,493,380,71,173,122,14,132,161,15,72,113,7,8,53,45,113,0
24624,37,29,0,13,16,0,0,22,0,7,8,0,0,8,0,8,0
24628,160,126,22,46,51,7,38,56,6,26,34,0,4,16,14,34,0
24630,2527,1855,412,757,540,146,549,950,184,172,672,71,212,205,184,607,65
24631,749,562,66,351,139,6,200,254,36,72,187,48,34,76,29,159,28
24634,173,134,22,48,50,14,51,69,0,14,39,12,0,14,13,39,0
24635,278,181,28,80,51,22,48,80,30,23,97,4,36,24,33,87,10
24637,996,834,145,464,198,27,353,394,38,49,162,22,60,32,48,131,31
24639,1394,1042,240,459,277,66,358,514,51,119,352,41,110,129,72,290,62
24641,3096,2111,378,1044,571,118,601,976,239,295,985,129,241,356,259,917,68
24646,346,265,10,166,70,19,63,149,21,32,81,19,8,48,6,81,0
24649,961,756,172,350,182,52,267,350,25,114,205,21,68,65,51,205,0
24651,2210,1581,388,720,414,59,552,718,150,161,629,53,202,184,190,603,26
24656,1665,1281,234,596,408,43,327,697,145,112,384,7,143,126,108,353,31
24657,192,112,11,67,27,7,36,62,8,6,80,0,34,39,7,76,4
24701,9151,5966,1259,2483,1635,589,1677,2761,752,776,3185,415,875,1080,815,2834,351
24712,719,496,96,173,174,53,144,275,31,46,223,63,63,53,44,206,17
24714,51,37,7,16,14,0,16,14,7,0,14,0,0,0,14,14,0
24715,318,199,32,79,66,22,51,84,13,51,119,14,30,46,29,111,8
24716,252,210,30,83,97,0,58,134,8,10,42,0,22,13,7,42,0
24719,115,82,14,40,10,18,36,28,8,10,33,8,7,6,12,33,0
24724,82,48,9,19,18,2,18,24,0,6,34,4,5,18,7,34,0
24726,162,121,22,59,31,9,22,66,13,20,41,0,16,12,13,41,0
24731,57,46,18,6,15,7,9,22,9,6,11,0,11,0,0,11,0
24733,593,432,121,183,98,30,151,200,36,45,161,21,43,40,57,134,27
24736,418,336,59,154,111,12,115,133,64,24,82,3,22,43,14,73,9
24737,315,251,55,27,127,42,63,116,22,50,64,0,18,40,6,44,20
24739,35,28,7,8,8,5,9,8,0,11,7,0,2,5,0,7,0
24740,12978,8808,1802,3777,2478,751,2679,4269,889,971,4170,670,1176,1373,951,3704,466
24747,1259,957,204,471,209,73,316,476,101,64,302,45,77,109,71,287,15
24801,2221,1451,204,669,427,151,338,627,233,253,770,64,210,291,205,727,43
24808,223,165,33,66,53,13,64,76,10,15,58,1,16,27,14,54,4
24811,202,163,27,87,49,0,42,78,32,11,39,0,10,7,22,33,6
24813,173,140,23,82,35,0,49,75,16,0,33,0,9,16,8,24,9
24815,318,233,18,131,70,14,38,107,74,14,85,9,19,36,21,85,0
24816,16,16,0,10,6,0,0,16,0,0,0,0,0,0,0,0,0
24817,357,262,52,136,57,17,98,113,28,23,95,3,35,36,21,91,4
24818,648,534,112,240,130,52,157,251,87,39,114,14,73,22,5,105,9
24821,111,99,34,33,32,0,33,36,17,13,12,0,6,6,0,12,0
24822,111,95,14,44,32,5,39,31,13,12,16,7,0,5,4,16,0
24823,449,363,98,119,126,20,115,181,36,31,86,7,33,46,0,76,10
24824,34,34,16,18,0,0,8,17,0,9,0,0,0,0,0,0,0
24825,191,145,25,49,55,16,34,71,18,22,46,8,0,18,20,43,3
24827,607,471,107,251,105,8,179,238,16,38,136,25,69,12,30,124,12
24828,409,322,73,155,84,10,90,150,32,50,87,7,28,37,15,82,5
24829,47,31,17,6,8,0,6,8,7,10,16,0,12,4,0,16,0
24830,106,70,3,22,29,16,0,51,9,10,36,4,9,15,8,32,4
24831,44,29,0,17,12,0,0,22,7,0,15,0,3,12,0,15,0
24836,250,167,26,71,42,28,44,69,32,22,83,3,14,43,23,74,9
24839,784,570,135,235,166,34,197,291,55,27,214,26,92,68,28,195,19
24842,67,60,13,26,21,0,12,29,13,6,7,0,4,3,0,7,0
24843,39,31,10,0,21,0,10,21,0,0,8,8,0,0,0,8,0
24844,1110,804,158,406,165,75,264,419,70,51,306,16,95,108,87,287,19
24845,49,27,0,27,0,0,12,0,15,0,22,11,0,11,0,11,11
24846,14,10,5,0,5,0,5,0,0,5,4,0,0,4,0,4,0
24848,106,74,15,28,14,17,27,26,10,11,32,11,2,17,2,32,0
24849,139,117,25,70,17,5,24,76,17,0,22,0,0,22,0,22,0
24850,521,353,75,192,74,12,125,164,59,5,168,0,103,55,10,168,0
24851,232,182,58,67,42,15,55,85,21,21,50,2,16,17,15,50,0
24852,160,107,34,32,20,21,15,31,42,19,53,5,15,15,18,45,8
24853,404,285,32,135,73,45,83,102,32,68,119,5,26,46,42,109,10
24854,377,287,45,182,43,17,107,137,29,14,90,5,30,22,33,84,6
24855,29,21,0,14,4,3,0,3,0,18,8,0,2,2,4,8,0
24856,34,34,9,25,0,0,16,18,0,0,0,0,0,0,0,0,0
24857,295,206,43,104,48,11,83,92,25,6,89,0,20,54,15,82,7
24860,116,94,14,44,31,5,38,43,7,6,22,0,0,0,22,22,0
24861,132,88,13,50,25,0,12,47,24,5,44,0,17,20,7,44,0
24862,302,237,60,98,62,17,70,113,38,16,65,12,17,33,3,42,23
24866,268,182,35,118,24,5,65,75,27,15,86,0,18,28,40,81,5
24867,144,70,21,19,29,1,32,33,5,0,74,12,11,20,31,74,0
24868,651,441,83,167,131,60,80,196,80,85,210,16,58,80,56,202,8
24869,80,56,7,35,7,7,19,29,8,0,24,0,19,5,0,24,0
24870,1672,1272,242,670,300,60,462,653,95,62,400,33,80,179,108,392,8
24871,298,217,23,100,61,33,49,112,18,38,81,0,32,26,23,74,7
24872,358,267,70,155,36,6,120,96,23,28,91,19,20,34,18,91,0
24873,267,218,64,85,63,6,75,116,21,6,49,0,12,15,22,49,0
24874,1710,1224,183,657,312,72,413,564,115,132,486,33,141,231,81,466,20
24879,197,157,33,88,26,10,90,45,15,7,40,2,15,21,2,35,5
24880,104,69,0,56,13,0,11,34,19,5,35,0,7,28,0,35,0
24881,347,236,53,105,53,25,83,66,20,67,111,24,47,21,19,106,5
24882,53,50,6,38,6,0,24,20,6,0,3,0,3,0,0,3,0
24884,119,91,29,26,24,12,25,49,6,11,28,0,17,11,0,28,0
24887,27,24,8,6,10,0,8,5,6,5,3,0,0,3,0,3,0
24888,57,32,3,9,10,10,6,20,3,3,25,0,5,8,12,25,0
24892,975,684,156,315,160,53,204,317,72,91,291,9,93,97,92,264,27
24894,50,41,10,23,5,3,18,19,0,4,9,2,2,0,5,7,2
24895,56,25,3,8,13,1,9,14,0,2,31,4,11,10,6,24,7
24897,29,18,4,4,5,5,4,5,4,5,11,0,0,5,6,11,0
24898,45,29,21,8,0,0,29,0,0,0,16,16,0,0,0,8,8
24901,3411,2222,328,1151,580,163,637,1138,248,199,1189,212,287,387,303,1079,110
24910,1768,1219,304,534,292,89,502,484,117,116,549,68,139,198,144,509,40
24915,235,155,18,56,76,5,51,87,0,17,80,8,28,16,28,72,8
24916,129,94,25,49,13,7,33,41,0,20,35,0,17,10,8,35,0
24918,579,487,114,149,152,72,126,273,32,56,92,0,28,26,38,92,0
24919,24,24,9,0,7,8,0,7,9,8,0,0,0,0,0,0,0
24920,150,107,15,43,49,0,14,86,7,0,43,0,0,8,35,29,14
24924,186,137,19,52,62,4,26,95,13,3,49,1,16,21,11,47,2
24925,328,247,53,88,98,8,61,141,19,26,81,0,30,23,28,81,0
24927,158,121,21,58,37,5,53,30,8,30,37,0,5,26,6,32,5
24931,671,523,67,241,165,50,142,243,75,63,148,32,39,41,36,125,23
24934,241,144,11,62,55,16,41,75,11,17,97,0,29,26,42,82,15
24935,233,136,24,66,30,16,59,61,0,16,97,18,29,21,29,79,18
24936,71,31,15,16,0,0,24,7,0,0,40,6,8,21,5,32,8
24938,637,501,66,220,152,63,137,278,38,48,136,9,30,51,46,127,9
24941,448,325,65,143,103,14,119,140,23,43,123,24,29,53,17,104,19
24943,18,18,0,18,0,0,0,9,9,0,0,0,0,0,0,0,0
24944,224,186,20,93,53,20,81,105,0,0,38,0,16,16,6,27,11
24945,141,73,9,49,7,8,41,15,8,9,68,0,36,9,23,62,6
24946,633,412,75,182,126,29,118,221,20,53,221,23,66,77,55,191,30
24950,14,14,8,6,0,0,0,0,14,0,0,0,0,0,0,0,0
24951,745,582,99,252,175,56,189,300,36,57,163,17,49,66,31,149,14
24954,1595,1017,200,431,306,80,296,539,102,80,578,67,190,185,136,507,71
24957,69,60,16,17,15,12,33,15,0,12,9,0,0,9,0,9,0
24962,37,15,0,0,8,7,0,15,0,0,22,0,0,22,0,22,0
24963,1473,995,244,403,263,85,315,480,114,86,478,61,108,158,151,422,56
24966,628,428,80,220,106,22,174,187,47,20,200,10,55,77,58,162,38
24970,1972,1331,270,582,394,85,408,639,169,115,641,81,232,191,137,569,72
24974,96,70,4,53,6,7,26,44,0,0,26,0,7,7,12,25,1
24976,430,341,52,186,83,20,135,135,39,32,89,6,30,47,6,70,19
24977,164,107,39,31,37,0,50,35,6,16,57,5,18,15,19,50,7
24981,263,200,34,90,63,13,59,97,24,20,63,0,9,54,0,63,0
24983,962,649,94,238,242,75,197,360,24,68,313,36,52,129,96,297,16
24984,88,42,0,23,19,0,6,25,4,7,46,8,20,6,12,38,8
24985,156,104,0,50,54,0,8,84,0,12,52,10,5,9,28,52,0
24986,2212,1436,243,583,504,106,397,731,167,141,776,91,257,276,152,709,67
24991,164,142,21,101,20,0,84,43,5,10,22,0,4,9,9,18,4
25002,33,21,3,7,7,4,3,11,0,7,12,0,4,0,8,12,0
25003,1255,975,207,469,270,29,276,506,77,116,280,64,85,53,78,266,14
25005,141,97,37,37,18,5,62,23,7,5,44,5,31,0,8,36,8
25007,107,100,15,55,25,5,42,38,9,11,7,7,0,0,0,7,0
25008,195,147,16,70,55,6,49,72,8,18,48,5,14,14,15,43,5
25009,617,478,109,230,108,31,181,184,57,56,139,36,17,49,37,113,26
25010,228,148,19,79,42,8,37,103,0,8,80,0,23,36,21,80,0
25011,263,201,34,89,70,8,76,88,15,22,62,10,14,19,19,61,1
25015,2173,1520,346,656,396,122,486,665,198,171,653,114,179,210,150,585,68
25019,312,256,51,93,89,23,76,146,13,21,56,5,24,23,4,56,0
25021,107,81,27,29,17,8,49,25,7,0,26,0,6,14,6,26,0
25022,40,24,16,0,8,0,16,8,0,0,16,10,0,0,6,16,0
25024,333,244,81,88,56,19,68,128,17,31,89,6,25,38,20,89,0
25025,113,94,22,39,23,10,22,47,15,10,19,0,0,19,0,10,9
25028,87,81,13,27,34,7,24,36,14,7,6,6,0,0,0,6,0
25030,135,96,9,41,46,0,22,47,14,13,39,7,13,19,0,39,0
25031,319,235,15,70,90,60,48,118,11,58,84,10,28,17,29,73,11
25033,817,600,106,317,158,19,232,264,36,68,217,26,41,63,87,206,11
25035,603,411,113,146,130,22,106,206,44,55,192,17,86,57,32,181,11
25036,210,140,42,58,29,11,43,49,23,25,70,9,14,22,25,57,13
25039,323,210,41,99,42,28,80,63,25,42,113,2,23,55,33,107,6
25040,296,208,35,68,76,29,46,119,18,25,88,18,19,26,25,74,14
25043,728,451,126,186,91,48,123,217,87,24,277,37,75,78,87,265,12
25044,103,82,20,20,36,6,28,49,5,0,21,0,6,5,10,21,0
25045,2412,1828,345,822,586,75,580,951,120,177,584,66,123,177,218,520,64
25047,120,108,15,49,29,15,38,40,0,30,12,0,0,12,0,12,0
25048,11,11,0,11,0,0,0,11,0,0,0,0,0,0,0,0,0
25049,130,100,39,46,4,11,56,26,5,13,30,0,4,16,10,30,0
25051,54,38,13,12,6,7,20,13,0,5,16,5,6,5,0,16,0
25053,1320,951,225,424,251,51,317,463,98,73,369,54,119,130,66,347,22
25054,243,154,21,70,63,0,23,79,15,37,89,15,25,19,30,66,23
25057,104,77,18,34,17,8,28,27,14,8,27,0,15,12,0,27,0
25059,241,184,25,102,57,0,73,97,8,6,57,0,28,29,0,49,8
25060,142,104,22,45,25,12,28,61,0,15,38,12,8,6,12,38,0
25063,488,331,86,112,102,31,124,162,32,13,157,4,49,54,50,157,0
25064,4663,2723,561,1120,757,285,645,1277,407,394,1940,401,552,529,458,1740,200
25067,724,528,113,227,159,29,161,235,39,93,196,24,57,62,53,173,23
25070,465,329,57,131,110,31,94,172,34,29,136,24,27,38,47,131,5
25071,4655,3470,710,1658,929,173,1144,1718,258,350,1185,170,359,383,273,1068,117
25075,278,179,36,84,51,8,67,61,28,23,99,7,29,28,35,91,8
25076,110,92,30,41,14,7,21,21,46,4,18,0,9,0,9,18,0
25081,248,172,40,71,53,8,59,85,22,6,76,0,31,34,11,76,0
25082,553,395,70,197,97,31,135,215,29,16,158,34,62,16,46,118,40
25083,257,165,42,68,38,17,23,58,50,34,92,0,18,58,16,83,9
25085,566,368,112,152,86,18,111,167,50,40,198,32,56,64,46,175,23
25086,447,327,72,149,79,27,90,147,37,53,120,7,28,62,23,106,14
25088,20,6,0,6,0,0,6,0,0,0,14,0,0,14,0,14,0
25090,96,75,29,23,12,11,29,27,0,19,21,0,0,19,2,21,0
25102,136,106,20,38,37,11,23,44,20,19,30,9,8,5,8,17,13
25103,176,129,14,74,23,18,33,69,16,11,47,10,12,23,2,37,10
25106,286,203,68,80,51,4,55,108,12,28,83,16,23,31,13,74,9
25107,340,257,58,104,85,10,43,139,17,58,83,8,26,40,9,72,11
25108,180,134,28,68,29,9,43,60,6,25,46,0,17,22,7,46,0
25109,255,198,29,92,67,10,52,90,16,40,57,0,15,16,26,57,0
25110,246,182,11,50,68,53,50,64,11,57,64,15,20,8,21,58,6
25111,157,128,22,76,23,7,47,68,13,0,29,0,11,10,8,29,0
25113,413,298,73,139,80,6,116,127,20,35,115,16,30,38,31,95,20
25114,133,93,20,38,25,10,40,39,0,14,40,7,8,18,7,40,0
25115,41,32,15,0,13,4,0,17,7,8,9,0,0,9,0,9,0
25118,171,119,16,45,43,15,34,56,22,7,52,8,0,16,28,44,8
25119,128,99,12,45,26,16,27,55,0,17,29,0,7,22,0,29,0
25121,454,323,33,159,99,32,90,149,44,40,131,10,46,48,27,110,21
25123,1378,1044,190,478,330,46,318,570,74,82,334,35,103,135,61,318,16
25124,451,336,85,157,78,16,125,163,15,33,115,20,21,68,6,115,0
25125,438,360,59,172,102,27,90,166,52,52,78,6,22,29,21,78,0
25126,145,81,20,31,30,0,20,46,5,10,64,0,16,28,20,56,8
25130,2284,1638,348,748,418,124,464,782,217,175,646,109,213,203,121,586,60
25132,243,194,36,106,42,10,55,129,10,0,49,9,5,35,0,44,5
25133,388,278,93,115,60,10,103,77,59,39,110,13,38,48,11,103,7
25134,216,179,27,91,42,19,57,63,23,36,37,0,5,24,8,37,0
25136,937,487,112,219,117,39,115,206,75,91,450,137,101,119,93,347,103
25139,182,127,29,68,22,8,31,72,24,0,55,39,9,0,7,31,24
25140,651,438,92,194,129,23,167,190,34,47,213,21,66,71,55,186,27
25141,138,118,23,72,15,8,57,43,10,8,20,0,0,20,0,16,4
25143,3610,2383,485,989,675,234,712,1133,219,319,1227,238,379,352,258,1055,172
25148,80,70,13,41,0,16,33,16,15,6,10,0,0,10,0,10,0
25149,104,85,17,34,24,10,31,49,5,0,19,0,0,6,13,19,0
25150,52,40,3,16,7,14,10,10,6,14,12,0,0,12,0,12,0
25152,163,150,45,54,43,8,54,66,19,11,13,0,13,0,0,13,0
25154,364,242,80,89,50,23,78,120,16,28,122,25,44,32,21,122,0
25159,1803,1309,269,686,316,38,499,597,101,112,494,64,157,191,82,382,112
25160,102,71,7,30,34,0,15,56,0,0,31,9,13,9,0,16,15
25161,412,330,47,164,104,15,99,154,22,55,82,0,20,14,48,78,4
25162,282,190,22,64,70,34,31,131,12,16,92,17,17,34,24,82,10
25164,328,236,48,107,77,4,95,124,17,0,92,22,13,12,45,92,0
25165,45,30,0,18,12,0,13,12,0,5,15,0,5,10,0,15,0
25168,1338,1050,246,482,285,37,387,520,100,43,288,42,87,103,56,252,36
25169,146,122,22,72,11,17,60,17,21,24,24,5,10,9,0,19,5
25173,337,230,38,116,54,22,97,83,24,26,107,16,46,29,16,79,28
25174,498,361,68,154,109,30,88,214,33,26,137,12,66,20,39,127,10
25177,10476,7240,1596,3108,1940,596,2109,3386,930,815,3236,415,915,1059,847,2866,370
25181,1129,834,182,371,221,60,262,391,84,97,295,40,125,74,56,252,43
25183,101,77,21,37,19,0,22,49,0,6,24,0,0,24,0,24,0
25186,438,255,64,96,71,24,54,106,52,43,183,35,42,52,54,170,13
25187,265,195,17,94,57,27,80,88,0,27,70,9,18,9,34,61,9
25193,246,163,20,92,41,10,39,86,24,14,83,4,11,30,38,79,4
25202,426,371,82,164,108,17,124,183,57,7,55,0,40,8,7,39,16
25204,165,118,5,37,39,37,19,51,0,48,47,5,16,12,14,47,0
25205,80,55,6,14,35,0,7,35,6,7,25,6,12,7,0,25,0
25206,268,216,9,142,51,14,60,109,16,31,52,8,12,19,13,32,20
25208,197,128,34,80,14,0,43,58,22,5,69,8,31,23,7,37,32
25209,564,383,90,144,115,34,110,170,42,61,181,24,50,56,51,158,23
25211,79,79,33,38,0,8,53,15,11,0,0,0,0,0,0,0,0
25213,1904,1441,259,716,381,85,498,723,135,85,463,120,153,134,56,405,58
25214,316,219,27,107,56,29,56,117,13,33,97,0,20,31,46,97,0
25231,27,20,0,20,0,0,0,20,0,0,7,0,0,0,7,7,0
25234,412,331,64,119,109,39,85,185,29,32,81,0,12,33,36,81,0
25235,376,284,47,144,72,21,109,118,35,22,92,0,31,38,23,92,0
25239,614,481,94,229,137,21,170,263,17,31,133,16,32,38,47,110,23
25241,533,418,90,199,101,28,161,202,23,32,115,16,40,43,16,115,0
25243,358,302,50,137,81,34,89,165,29,19,56,7,29,6,14,31,25
25244,290,238,35,148,55,0,97,125,8,8,52,6,13,29,4,44,8
25245,318,274,42,135,82,15,110,119,19,26,44,14,6,18,6,44,0
25247,192,115,32,46,32,5,39,42,24,10,77,11,27,26,13,71,6
25248,1118,826,174,380,203,69,323,368,38,97,292,32,91,106,63,253,39
25251,276,204,17,90,90,7,58,110,11,25,72,9,11,30,22,56,16
25252,370,266,49,148,63,6,129,100,13,24,104,0,49,31,24,70,34
25253,757,569,118,297,116,38,202,257,71,39,188,34,67,51,36,186,2
25259,267,205,45,127,20,13,63,76,37,29,62,0,12,26,24,62,0
25260,743,563,114,232,175,42,157,273,73,60,180,11,28,94,47,164,16
25261,88,67,13,42,5,7,34,26,0,7,21,0,9,12,0,11,10
25262,468,358,90,142,93,33,103,205,27,23,110,0,44,61,5,86,24
25264,169,116,32,65,14,5,48,43,17,8,53,7,23,15,8,53,0
25265,713,491,91,211,148,41,166,256,44,25,222,29,53,84,56,203,19
25266,300,193,41,89,55,8,73,104,6,10,107,0,44,22,41,98,9
25267,385,269,40,118,85,26,58,162,23,26,116,5,26,66,19,100,16
25268,385,256,31,107,85,33,67,160,5,24,129,27,19,62,21,116,13
25270,380,263,35,98,107,23,77,150,9,27,117,9,17,44,47,108,9
25271,3261,2316,519,954,674,169,775,1086,240,215,945,163,223,359,200,853,92
25275,915,740,134,317,237,52,237,364,63,76,175,39,50,59,27,142,33
25276,3258,2323,489,1084,624,126,782,1075,281,185,935,115,198,302,320,803,132
25279,131,105,16,43,39,7,41,48,9,7,26,0,9,12,5,26,0
25281,18,12,0,0,12,0,0,12,0,0,6,0,0,6,0,6,0
25283,139,122,6,67,34,15,34,68,5,15,17,3,7,7,0,14,3
25285,182,131,41,61,15,14,72,38,14,7,51,7,32,12,0,46,5
25286,647,508,87,246,143,32,166,263,23,56,139,15,43,46,35,131,8
25287,219,150,24,74,46,6,57,69,24,0,69,0,35,29,5,59,10
25301,1957,516,204,179,82,51,80,125,224,87,1441,219,507,410,305,1314,127
25302,7664,4475,960,1903,1205,407,1229,2002,663,581,3189,568,1043,857,721,2756,433
25303,3227,1980,362,920,496,202,573,900,266,241,1247,227,437,262,321,1071,176
25304,3943,2244,303,1053,599,289,531,1089,269,355,1699,375,478,414,432,1514,185
25306,3212,2186,354,1059,598,175,602,1004,293,287,1026,115,312,348,251,913,113
25309,5483,3476,576,1642,984,274,963,1655,458,400,2007,384,471,662,490,1787,220
25311,5245,2833,669,1200,682,282,747,1174,457,455,2412,607,871,516,418,2119,293
25312,6659,4521,998,1925,1314,284,1260,2055,582,624,2138,322,889,533,394,1839,299
25313,5616,4021,779,1948,1112,182,1487,1864,367,303,1595,450,558,382,205,1397,198
25314,6375,4385,549,2219,1231,386,1562,2059,379,385,1990,436,714,523,317,1765,225
25315,1548,956,174,398,280,104,258,475,92,131,592,89,199,177,127,491,101
25320,2236,1742,357,786,490,109,542,866,190,144,494,61,197,123,113,419,75
25401,17442,11607,2930,5348,2626,703,3737,4949,1825,1096,5835,1250,2007,1624,954,4828,1007
25411,4555,3188,624,1343,946,275,1001,1701,277,209,1367,185,482,475,225,1159,208
25413,1969,1536,347,761,348,80,506,703,214,113,433,40,176,145,72,368,65
25414,5290,3566,794,1769,774,229,1214,1641,459,252,1724,287,515,625,297,1380,344
25419,2761,2126,384,1187,484,71,793,995,210,128,635,87,259,216,73,500,135
25420,1331,997,223,542,207,25,429,415,94,59,334,97,199,19,19,245,89
25421,107,107,9,46,43,9,24,74,9,0,0,0,0,0,0,0,0
25422,609,384,73,162,105,44,115,197,26,46,225,14,84,105,22,198,27
25425,4273,3079,583,1592,789,115,1091,1413,311,264,1194,212,557,243,182,946,248
25427,3862,2915,691,1316,801,107,1089,1333,301,192,947,144,499,250,54,763,184
25428,2514,1874,456,942,410,66,764,769,205,136,640,99,247,229,65,488,152
25430,2358,1887,338,901,556,92,688,825,179,195,471,56,191,141,83,411,60
25431,38,18,6,12,0,0,0,12,6,0,20,0,6,14,0,14,6
25434,728,529,128,171,196,34,140,265,73,51,199,30,81,46,42,156,43
25437,200,151,26,74,37,14,55,64,17,15,49,0,19,21,9,43,6
25438,1289,834,185,455,157,37,194,324,218,98,455,138,148,104,65,349,106
25441,113,91,9,53,14,15,31,40,3,17,22,5,0,13,4,9,13
25442,694,518,103,292,111,12,228,219,34,37,176,11,27,80,58,138,38
25443,2036,1291,173,634,389,95,401,695,94,101,745,262,217,168,98,514,231
25444,246,206,25,132,49,0,74,108,24,0,40,20,20,0,0,40,0
25446,395,330,50,197,67,16,120,162,20,28,65,11,35,15,4,53,12
25501,457,337,80,153,72,32,148,112,54,23,120,16,13,62,29,108,12
25502,466,355,73,167,99,16,104,163,53,35,111,0,31,43,37,103,8
25503,313,266,28,139,66,33,68,181,9,8,47,0,8,39,0,47,0
25504,4328,3200,689,1474,833,204,1050,1636,334,180,1128,231,328,348,221,980,148
25505,49,35,0,4,31,0,8,23,4,0,14,0,0,14,0,14,0
25506,2046,1503,355,733,357,58,562,609,172,160,543,61,116,235,131,488,55
25507,650,377,87,125,120,45,74,203,67,33,273,48,41,95,89,267,6
25508,3831,2911,678,1375,674,184,968,1374,304,265,920,128,233,318,241,830,90
25510,2026,1593,350,766,400,77,557,798,102,136,433,56,100,152,125,388,45
25511,426,302,80,171,41,10,140,115,25,22,124,14,28,46,36,112,12
25512,675,505,86,199,199,21,166,256,44,39,170,25,31,84,30,165,5
25514,1469,1196,317,528,275,76,446,531,121,98,273,38,99,68,68,259,14
25515,860,639,117,339,183,0,256,295,59,29,221,59,80,59,23,219,2
25517,602,469,161,157,127,24,175,215,33,46,133,22,17,61,33,127,6
25520,549,409,96,151,131,31,167,175,12,55,140,5,52,47,36,131,9
25521,378,254,50,101,92,11,52,176,17,9,124,24,61,21,18,103,21
25523,1229,878,205,373,250,50,268,394,127,89,351,27,97,139,88,334,17
25524,1303,1115,233,551,291,40,408,482,87,138,188,18,64,70,36,170,18
25526,7501,5779,1199,2844,1464,272,2223,2762,549,245,1722,324,620,456,322,1494,228
25529,620,491,113,237,106,35,170,248,30,43,129,51,25,36,17,129,0
25530,2680,1869,382,750,567,170,631,890,141,207,811,91,220,318,182,767,44
25534,112,80,13,49,18,0,40,32,0,8,32,0,14,18,0,24,8
25535,1100,829,200,327,270,32,278,425,47,79,271,61,86,71,53,221,50
25537,933,711,126,267,282,36,171,422,71,47,222,42,64,74,42,195,27
25540,77,68,0,44,16,8,23,39,6,0,9,0,9,0,0,9,0
25541,3283,2424,571,1038,650,165,829,1187,262,146,859,138,286,270,165,748,111
25544,43,23,5,5,13,0,7,11,5,0,20,0,20,0,0,15,5
25545,1714,1422,282,690,401,49,538,674,134,76,292,37,90,138,27,256,36
25547,527,441,78,207,141,15,138,241,22,40,86,0,16,31,39,86,0
25550,3830,2631,601,1122,709,199,863,1215,327,226,1199,97,333,435,334,1094,105
25555,762,589,175,254,130,30,247,279,34,29,173,18,47,62,46,151,22
25557,803,581,151,256,140,34,212,246,65,58,222,12,80,78,52,206,16
25559,784,623,177,244,176,26,250,304,22,47,161,17,48,42,54,155,6
25560,2999,2330,412,1197,548,173,942,1065,175,148,669,69,216,263,121,612,57
25564,432,318,49,152,105,12,59,177,60,22,114,11,43,23,37,109,5
25565,297,226,57,61,95,13,87,100,24,15,71,18,17,29,7,71,0
25567,270,216,57,105,41,13,85,117,9,5,54,31,0,15,8,54,0
25570,2360,1730,387,762,484,97,623,776,162,169,630,57,188,197,188,580,50
25571,809,640,124,312,157,47,216,283,85,56,169,19,24,84,42,160,9
25573,477,348,57,157,102,32,122,179,47,0,129,28,40,37,24,108,21
25601,2863,1859,296,799,561,203,518,856,174,311,1004,169,240,350,245,975,29
25606,589,486,69,274,120,23,155,254,37,40,103,6,36,48,13,88,15
25607,424,312,67,169,59,17,98,145,36,33,112,7,39,45,21,98,14
25608,720,516,96,290,118,12,221,217,28,50,204,32,49,105,18,179,25
25611,310,244,70,125,49,0,83,84,41,36,66,9,6,51,0,66,0
25612,14,14,0,8,6,0,8,6,0,0,0,0,0,0,0,0,0
25617,440,364,84,154,126,0,115,181,29,39,76,11,29,19,17,62,14
25621,881,678,143,384,123,28,238,329,73,38,203,39,59,57,48,185,18
25624,62,55,18,22,15,0,22,23,10,0,7,0,0,7,0,7,0
25625,466,366,65,164,104,33,99,171,46,50,100,24,27,14,35,100,0
25628,294,196,57,83,51,5,67,97,21,11,98,10,26,36,26,87,11
25630,288,212,44,99,48,21,68,101,15,28,76,13,37,19,7,69,7
25632,219,161,0,83,65,13,33,89,0,39,58,10,26,17,5,48,10
25634,77,71,18,15,38,0,12,33,12,14,6,0,0,6,0,6,0
25635,572,441,95,200,126,20,148,201,53,39,131,12,34,32,53,109,22
25636,334,239,81,99,50,9,94,76,42,27,95,10,22,57,6,88,7
25637,474,287,29,130,87,41,52,151,36,48,187,55,45,68,19,158,29
25638,456,367,69,154,117,27,159,121,41,46,89,0,30,39,20,83,6
25639,285,224,29,122,57,16,74,83,26,41,61,0,18,27,16,61,0
25644,0,0,0,0,0,0,0,0,0,0,0,0,0,0,0,0,0
25646,404,263,66,106,60,31,106,110,20,27,141,10,22,53,56,127,14
25647,233,183,29,86,48,20,75,69,6,33,50,0,8,25,17,50,0
25649,303,254,64,124,59,7,85,122,32,15,49,0,24,11,14,49,0
25650,284,223,44,101,74,4,72,120,27,4,61,16,23,20,2,61,0
25651,93,71,19,26,19,7,32,39,0,0,22,6,16,0,0,10,12
25652,524,410,97,190,85,38,140,182,36,52,114,8,33,59,14,111,3
25653,125,98,11,39,19,29,17,61,4,16,27,0,20,7,0,27,0
25654,88,67,11,31,17,8,29,16,4,18,21,0,4,8,9,21,0
25661,2460,1577,307,629,462,179,447,733,166,231,883,89,265,270,259,843,40
25665,47,38,18,13,7,0,10,15,5,8,9,0,5,4,0,9,0
25666,74,70,26,29,11,4,41,17,6,6,4,0,0,0,4,4,0
25667,69,61,6,42,13,0,25,36,0,0,8,0,0,8,0,8,0
25669,616,439,77,209,133,20,157,192,42,48,177,16,65,71,25,152,25
25670,2783,2185,511,1093,459,122,835,882,228,240,598,74,208,173,143,543,55
25671,776,560,158,248,144,10,228,222,68,42,216,14,73,100,29,202,14
25672,106,62,5,44,13,0,19,14,8,21,44,0,19,20,5,44,0
25674,1195,902,237,396,216,53,321,340,114,127,293,25,120,80,68,271,22
25676,239,186,38,119,29,0,68,74,33,11,53,0,24,26,3,53,0
25678,578,384,74,180,111,19,126,158,40,60,194,21,54,99,20,183,11
25682,537,403,73,195,97,38,174,147,49,33,134,12,44,32,46,123,11
25685,47,36,13,18,5,0,13,23,0,0,11,0,0,5,6,11,0
25688,53,33,7,19,7,0,12,21,0,0,20,0,0,20,0,20,0
25691,262,186,29,89,57,11,61,62,19,44,76,6,15,36,19,76,0
25692,238,196,59,89,48,0,68,72,32,24,42,6,11,4,21,42,0
25696,70,61,17,21,23,0,27,23,11,0,9,0,0,9,0,9,0
25699,21,16,0,10,6,0,0,16,0,0,5,0,0,5,0,5,0
25701,11382,5814,1187,2501,1421,705,1547,2770,772,725,5568,1885,1386,1197,1100,4659,909
25702,3705,2257,487,875,701,194,589,985,279,404,1448,266,387,346,449,1276,172
25703,2302,921,274,395,219,33,146,311,213,251,1381,866,199,174,142,762,619
25704,7233,4952,983,2166,1385,418,1447,2345,592,568,2281,430,603,809,439,2043,238
25705,9289,6251,1268,2541,1866,576,1832,3146,761,512,3038,766,837,838,597,2627,411
25801,15130,9871,2115,4361,2522,873,2878,4570,1384,1039,5259,789,1351,1675,1444,4724,535
25812,848,561,110,225,153,73,187,241,50,83,287,29,48,102,108,265,22
25813,1431,984,128,499,329,28,337,511,69,67,447,60,160,164,63,360,87
25817,348,288,72,147,69,0,130,127,5,26,60,10,13,9,28,51,9
25818,55,26,9,0,11,6,0,17,9,0,29,14,10,0,5,29,0
25820,118,90,6,60,18,6,10,74,6,0,28,6,10,12,0,28,0
25823,1098,825,172,394,229,30,228,478,55,64,273,7,51,113,102,258,15
25825,602,496,94,243,114,45,209,226,18,43,106,14,27,12,53,91,15
25826,236,148,12,69,67,0,16,119,13,0,88,4,39,8,37,88,0
25827,1192,879,168,444,214,53,225,499,83,72,313,50,67,142,54,289,24
25831,515,374,92,164,113,5,113,171,37,53,141,15,27,56,43,129,12
25832,1496,1047,283,389,305,70,318,623,57,49,449,52,74,173,150,402,47
25836,205,162,25,60,54,23,49,75,17,21,43,0,21,19,3,43,0
25837,97,75,19,30,14,12,25,37,6,7,22,0,15,0,7,22,0
25839,151,128,24,69,28,7,33,73,15,7,23,9,5,9,0,23,0
25840,2645,1908,356,928,487,137,613,897,235,163,737,97,191,261,188,646,91
25841,181,148,42,53,47,6,30,100,10,8,33,0,10,13,10,33,0
25843,323,252,28,152,71,1,68,156,27,1,71,8,9,41,13,56,15
25844,648,506,104,214,188,0,177,271,23,35,142,7,36,44,55,135,7
25845,169,128,8,68,40,12,20,74,13,21,41,0,7,6,28,41,0
25846,93,67,10,33,12,12,0,31,26,10,26,0,19,7,0,21,5
25847,611,425,87,161,152,25,117,250,50,8,186,22,77,60,27,146,40
25848,120,99,8,56,35,0,29,42,4,24,21,9,6,6,0,21,0
25849,58,48,18,16,14,0,18,24,0,6,10,0,0,10,0,10,0
25853,90,61,0,19,27,15,0,47,0,14,29,0,5,11,13,29,0
25854,370,274,69,96,89,20,81,142,27,24,96,13,13,62,8,89,7
25855,18,10,0,10,0,0,0,10,0,0,8,0,0,8,0,8,0
25856,21,21,15,6,0,0,13,0,8,0,0,0,0,0,0,0,0
25857,225,180,57,75,34,14,75,77,18,10,45,3,11,27,4,45,0
25862,130,107,31,45,19,12,41,47,15,4,23,5,6,0,12,18,5
25864,234,141,35,66,25,15,65,35,18,23,93,0,32,38,23,71,22
25865,748,543,107,260,157,19,181,272,33,57,205,8,71,53,73,186,19
25866,28,12,0,12,0,0,12,0,0,0,16,0,0,0,16,16,0
25868,213,143,33,79,31,0,33,77,18,15,70,18,29,13,10,64,6
25870,28,16,0,16,0,0,9,7,0,0,12,0,0,6,6,12,0
25871,128,88,38,22,20,8,20,32,24,12,40,9,7,15,9,30,10
25875,252,212,32,88,73,19,39,106,23,44,40,0,27,13,0,40,0
25878,201,148,22,70,42,14,38,79,6,25,53,6,22,25,0,43,10
25879,145,82,33,35,6,8,30,20,32,0,63,0,31,22,10,63,0
25880,2984,2115,433,1015,530,137,716,929,241,229,869,170,279,226,194,784,85
25882,1141,766,163,347,180,76,271,356,66,73,375,34,52,154,135,358,17
25901,5294,3686,809,1603,985,289,1078,1626,510,472,1608,164,462,552,430,1439,169
25902,280,203,45,76,61,21,86,83,25,9,77,8,40,17,12,68,9
25904,206,133,11,71,28,23,35,75,15,8,73,10,26,12,25,62,11
25907,24,20,6,7,7,0,0,13,7,0,4,4,0,0,0,4,0
25908,84,59,4,43,5,7,13,35,4,7,25,0,6,13,6,25,0
25909,35,18,10,2,0,6,0,16,0,2,17,0,0,11,6,17,0
25913,65,52,17,14,21,0,13,19,5,15,13,0,13,0,0,13,0
25915,140,85,36,22,25,2,28,30,13,14,55,1,23,23,8,45,10
25916,29,18,10,8,0,0,8,6,4,0,11,0,5,6,0,11,0
25917,988,647,164,277,141,65,224,270,119,34,341,15,118,135,73,293,48
25918,1817,1381,225,717,350,89,429,655,184,113,436,78,102,138,118,398,38
25920,57,48,0,32,16,0,24,8,0,16,9,0,0,0,9,9,0
25921,845,593,137,251,140,65,164,277,80,72,252,33,66,80,73,223,29
25922,173,124,9,65,50,0,12,96,10,6,49,0,16,17,16,41,8
25928,279,198,60,72,48,18,55,112,13,18,81,17,40,24,0,81,0
25932,153,136,6,90,23,17,27,51,33,25,17,0,11,1,5,15,2
25936,34,16,0,16,0,0,0,0,8,8,18,0,12,0,6,13,5
25938,525,401,52,220,108,21,131,156,54,60,124,19,18,52,35,111,13
25942,72,53,5,19,24,5,12,36,0,5,19,4,14,1,0,10,9
25951,2894,1897,324,765,594,214,491,960,264,182,997,63,259,391,284,941,56
25958,308,262,61,112,84,5,57,136,38,31,46,14,15,17,0,46,0
25962,1838,1300,206,547,420,127,401,683,82,134,538,46,111,230,151,501,37
25966,76,55,8,10,37,0,4,51,0,0,21,0,13,8,0,16,5
25969,509,379,69,181,89,40,112,236,13,18,130,6,48,43,33,124,6
25971,189,144,11,74,46,13,42,82,9,11,45,0,26,19,0,45,0
25972,62,48,17,19,12,0,13,18,6,11,14,0,14,0,0,5,9
25976,1032,780,130,331,279,40,212,404,70,94,252,23,72,96,61,225,27
25977,22,10,0,5,5,0,0,5,5,0,12,7,5,0,0,12,0
25978,242,211,32,108,47,24,65,89,0,57,31,0,0,14,17,31,0
25979,303,234,35,101,94,4,52,129,31,22,69,16,12,21,20,69,0
25981,483,366,49,112,150,55,74,233,27,32,117,6,27,59,25,107,10
25984,786,511,126,174,161,50,159,241,57,54,275,20,63,112,80,251,24
25985,204,135,23,70,25,17,40,70,8,17,69,0,43,20,6,64,5
25986,23,17,0,11,6,0,6,6,5,0,6,0,0,6,0,6,0
25989,44,39,21,10,0,8,12,9,10,8,5,5,0,0,0,0,5
26003,19285,12017,1968,5631,3318,1100,3786,5564,1440,1227,7268,1065,2027,2208,1968,6460,808
26030,221,162,19,74,51,18,32,72,21,37,59,9,15,20,15,55,4
26031,885,581,136,233,154,58,146,275,105,55,304,52,70,97,85,262,42
26032,359,231,43,133,41,14,77,111,28,15,128,54,35,33,6,98,30
26033,1361,954,163,493,231,67,328,440,103,83,407,51,102,158,96,367,40
26034,2315,1490,275,663,466,86,481,699,133,177,825,85,194,303,243,739,86
26035,1002,733,115,390,163,65,245,397,57,34,269,71,69,112,17,217,52
26036,157,120,8,34,69,9,28,79,0,13,37,15,7,0,15,30,7
26037,2982,2110,308,1000,622,180,654,1002,176,278,872,87,250,303,232,802,70
26038,1431,1081,134,496,363,88,360,584,64,73,350,30,95,91,134,316,34
26039,349,302,56,151,87,8,102,103,30,67,47,9,17,11,10,43,4
26040,1040,677,94,319,192,72,162,325,95,95,363,34,109,104,116,347,16
26041,6716,4656,888,2049,1377,342,1347,2229,554,526,2060,271,683,602,504,1813,247
26047,2702,1998,358,982,525,133,566,1047,196,189,704,126,201,230,147,605,99
26050,840,620,202,205,162,51,203,273,71,73,220,47,67,82,24,181,39
26055,747,559,116,259,162,22,229,289,15,26,188,14,51,51,72,167,21
26056,71,38,0,29,0,9,14,8,7,9,33,0,10,23,0,33,0
26059,1306,941,196,431,261,53,327,446,94,74,365,52,148,102,63,328,37
26060,731,555,93,263,162,37,185,281,48,41,176,39,67,32,38,148,28
26062,9586,6529,983,2943,1901,702,1860,3226,541,902,3057,353,832,1030,842,2766,291
26070,3838,2744,454,1218,796,276,839,1420,244,241,1094,147,323,366,258,994,100
26074,188,96,12,40,37,7,21,46,7,22,92,68,8,13,3,32,60
26075,193,126,35,44,29,18,34,61,11,20,67,5,13,21,28,58,9
26101,16644,11027,2439,4919,2931,738,3097,4932,1743,1255,5617,1078,1714,1652,1173,4873,744
26104,4074,2297,460,828,720,289,534,1272,260,231,1777,290,403,578,506,1568,209
26105,5141,3431,489,1574,1028,340,1111,1796,277,247,1710,348,419,499,444,1551,159
26133,481,397,58,211,115,13,138,202,33,24,84,18,15,44,7,73,11
26134,470,348,82,174,80,12,90,166,72,20,122,15,23,44,40,107,15
26136,284,191,31,85,45,30,74,91,13,13,93,11,17,47,18,83,10
26137,289,241,24,117,75,25,45,132,20,44,48,8,13,20,7,38,10
26138,42,23,0,7,16,0,7,16,0,0,19,0,0,9,10,19,0
26141,129,80,5,37,38,0,8,43,10,19,49,16,13,5,15,49,0
26142,860,697,140,365,148,44,278,323,61,35,163,20,58,58,27,100,63
26143,1822,1375,295,648,354,78,547,584,141,103,447,49,83,161,154,383,64
26146,378,284,58,110,97,19,93,145,14,32,94,4,28,21,41,79,15
26147,994,700,103,313,223,61,235,348,42,75,294,47,79,93,75,259,35
26148,83,63,9,26,21,7,19,37,0,7,20,0,0,6,14,20,0
26149,1039,749,160,321,220,48,224,382,81,62,290,19,78,107,86,257,33
26150,2125,1699,318,855,488,38,649,787,152,111,426,85,123,136,82,357,69
26151,247,188,41,91,47,9,82,58,17,31,59,0,26,21,12,59,0
26152,27,14,0,14,0,0,0,8,6,0,13,0,0,13,0,13,0
26155,3676,2594,402,1195,789,208,901,1255,197,241,1082,115,292,398,277,956,126
26159,1308,934,201,374,291,68,262,482,134,56,374,16,61,174,123,344,30
26160,367,290,26,139,114,11,63,189,20,18,77,12,20,35,10,69,8
26161,186,141,28,69,24,20,49,66,0,26,45,4,22,12,7,45,0
26162,22,22,0,10,12,0,0,17,5,0,0,0,0,0,0,0,0
26164,3271,2378,425,1009,762,182,659,1289,290,140,893,102,204,400,187,832,61
26167,418,270,49,116,82,23,131,112,14,13,148,19,50,48,31,114,34
26169,332,260,53,112,87,8,85,145,30,0,72,3,16,36,17,63,9
26170,2334,1712,357,731,490,134,607,844,150,111,622,68,159,204,191,549,73
26175,1499,1121,179,510,354,78,344,612,87,78,378,25,108,139,106,336,42
26178,279,223,21,99,59,44,75,110,16,22,56,5,17,13,21,56,0
26180,939,726,95,368,199,64,260,384,23,59,213,32,55,92,34,174,39
26181,2507,2081,324,1032,642,83,788,1074,120,99,426,85,136,138,67,368,58
26184,760,629,127,296,185,21,263,292,45,29,131,11,45,37,38,115,16
26186,163,134,11,62,38,23,30,79,15,10,29,6,15,3,5,22,7
26187,2360,1727,294,854,453,126,589,844,159,135,633,95,141,228,169,579,54
26201,7425,5289,1066,2399,1406,418,1712,2562,598,417,2136,317,593,680,546,1901,235
26202,241,218,42,63,80,33,71,116,0,31,23,0,10,0,13,23,0
26203,106,72,11,45,0,16,16,26,22,8,34,8,10,16,0,26,8
26205,1577,1166,250,509,319,88,381,595,102,88,411,39,136,140,96,385,26
26206,1251,925,209,437,225,54,307,463,110,45,326,48,74,156,48,295,31
26208,389,271,90,110,56,15,92,115,39,25,118,3,44,42,29,109,9
26209,113,56,9,33,14,0,25,27,4,0,57,31,15,11,0,46,11
26210,59,25,12,6,7,0,12,13,0,0,34,7,0,18,9,27,7
26215,41,25,0,12,13,0,13,12,0,0,16,9,7,0,0,16,0
26217,183,137,8,80,37,12,48,53,20,16,46,0,17,29,0,43,3
26218,969,724,155,339,181,49,275,326,73,50,245,46,66,69,64,205,40
26222,213,170,17,102,33,18,72,98,0,0,43,6,15,11,11,43,0
26224,97,74,0,39,16,19,17,57,0,0,23,0,15,8,0,23,0
26228,27,21,0,14,7,0,10,7,4,0,6,0,0,0,6,6,0
26230,57,46,0,31,15,0,18,15,5,8,11,0,11,0,0,6,5
26234,522,389,64,160,133,32,118,185,40,46,133,14,27,67,25,122,11
26236,25,25,7,12,0,6,12,13,0,0,0,0,0,0,0,0,0
26237,117,88,19,44,7,18,39,49,0,0,29,0,17,12,0,29,0
26238,294,221,22,111,79,9,50,112,30,29,73,0,15,42,16,63,10
26241,5842,3778,678,1742,1066,292,1180,1856,409,333,2064,350,584,530,600,1827,237
26250,1749,1267,221,550,381,115,399,594,136,138,482,46,145,165,126,411,71
26253,1473,1130,267,572,227,64,387,474,187,82,343,42,114,134,53,274,69
26254,156,127,16,57,54,0,53,59,0,15,29,0,12,0,17,20,9
26257,301,225,64,79,61,21,95,106,4,20,76,4,36,13,23,59,17
26259,54,40,6,26,0,8,0,34,6,0,14,8,0,6,0,8,6
26260,504,301,45,148,74,34,84,130,31,56,203,35,41,73,54,176,27
26261,1457,997,141,429,314,113,219,573,110,95,460,42,103,197,118,436,24
26263,125,84,7,35,36,6,7,36,27,14,41,5,20,16,0,36,5
26264,233,148,42,60,27,19,66,67,10,5,85,11,15,39,20,79,6
26266,124,93,25,61,7,0,46,32,15,0,31,0,21,10,0,22,9
26267,60,52,14,7,26,5,13,26,8,5,8,0,0,8,0,8,0
26268,4,0,0,0,0,0,0,0,0,0,4,0,0,4,0,4,0
26269,399,318,66,132,91,29,123,170,7,18,81,18,10,29,24,81,0
26270,360,239,62,91,63,23,94,111,13,21,121,8,55,35,23,101,20
26271,104,88,13,45,27,3,39,40,8,1,16,0,2,14,0,16,0
26273,270,216,53,124,30,9,98,68,15,35,54,4,23,23,4,47,7
26275,290,215,70,84,49,12,83,83,22,27,75,13,11,32,19,67,8
26276,126,110,18,23,59,10,28,66,6,10,16,4,0,0,12,12,4
26278,138,117,30,43,44,0,44,58,8,7,21,1,8,10,2,20,1
26280,838,629,139,275,181,34,174,337,62,56,209,26,51,78,54,175,34
26282,44,26,0,19,7,0,7,19,0,0,18,7,6,0,5,12,6
26283,684,528,156,229,108,35,187,245,66,30,156,0,50,68,38,140,16
26285,128,75,17,13,39,6,10,37,7,21,53,0,18,23,12,47,6
26287,1373,982,164,450,304,64,364,466,73,79,391,51,94,134,112,336,55
26288,1662,1091,219,463,316,93,311,564,129,87,571,53,122,237,159,506,65
26289,30,30,0,0,16,14,8,8,0,14,0,0,0,0,0,0,0
26291,57,37,6,23,8,0,10,22,5,0,20,6,7,0,7,20,0
26292,342,205,37,83,67,18,44,128,13,20,137,6,34,51,46,124,13
26293,217,167,53,64,31,19,67,67,21,12,50,7,12,25,6,44,6
26294,330,197,32,95,45,25,69,100,19,9,133,15,21,60,37,99,34
26296,113,75,15,23,24,13,28,43,4,0,38,0,10,19,9,38,0
26298,43,38,21,17,0,0,34,0,4,0,5,0,0,5,0,5,0
26301,13369,8521,1787,3608,2236,890,2488,3817,1218,998,4848,770,1303,1523,1252,4306,542
26302,20,20,0,9,11,0,0,11,0,9,0,0,0,0,0,0,0
26320,381,277,30,119,102,26,96,155,12,14,104,10,21,66,7,95,9
26321,166,141,51,19,40,31,45,83,5,8,25,5,11,0,9,20,5
26323,205,163,37,73,36,17,34,73,27,29,42,4,7,13,18,33,9
26325,124,91,16,39,27,9,22,39,16,14,33,3,17,7,6,19,14
26327,31,16,6,0,10,0,6,10,0,0,15,0,0,7,8,15,0
26330,5061,3682,616,1820,961,285,1450,1741,280,211,1379,161,505,394,319,1240,139
26332,551,430,70,218,119,23,184,185,21,40,121,8,34,56,23,92,29
26334,78,42,0,37,0,5,15,27,0,0,36,16,6,0,14,36,0
26335,480,383,82,162,105,34,116,197,45,25,97,0,26,52,19,85,12
26337,530,384,74,162,134,14,128,194,27,35,146,30,44,33,39,127,19
26338,205,145,8,70,60,7,44,78,12,11,60,10,0,30,20,45,15
26339,86,51,6,22,14,9,7,38,6,0,35,6,12,17,0,35,0
26342,194,129,30,46,37,16,36,70,8,15,65,0,21,14,30,65,0
26343,163,141,31,60,29,21,62,58,16,5,22,0,0,11,11,22,0
26346,351,276,31,143,72,30,87,140,11,38,75,9,18,32,16,65,10
26347,782,600,103,240,207,50,188,281,40,91,182,32,37,79,34,163,19
26348,84,72,13,31,23,5,22,33,9,8,12,0,2,9,1,12,0
26349,86,75,20,35,16,4,45,20,0,10,11,0,0,4,7,11,0
26351,1297,796,178,328,222,68,240,376,104,76,501,193,75,101,132,382,119
26354,4259,2893,538,1293,809,253,877,1457,277,282,1366,151,320,480,415,1205,161
26361,92,79,8,31,36,4,31,27,8,13,13,0,9,4,0,4,9
26362,1359,907,176,432,260,39,289,455,88,75,452,56,106,152,138,391,61
26366,57,41,8,25,8,0,21,9,7,4,16,0,6,0,10,16,0
26369,229,167,53,49,52,13,58,81,23,5,62,0,33,19,10,62,0
26372,223,177,26,87,49,15,58,74,38,7,46,5,25,16,0,40,6
26374,518,443,93,220,99,31,157,236,32,18,75,22,8,12,33,58,17
26376,239,159,20,78,61,0,56,66,7,30,80,19,15,27,19,61,19
26377,249,215,53,99,58,5,74,117,12,12,34,5,7,22,0,34,0
26378,1448,1132,221,497,331,83,323,631,125,53,316,28,89,125,74,297,19
26384,155,133,47,60,25,1,41,52,35,5,22,8,1,9,4,21,1
26385,1456,1164,232,535,338,59,389,564,95,116,292,53,90,84,65,256,36
26386,860,650,114,341,157,38,255,291,47,57,210,17,65,90,38,191,19
26404,297,223,39,107,70,7,102,65,15,41,74,5,12,26,31,54,20
26405,471,365,36,168,127,34,67,258,22,18,106,6,44,28,28,84,22
26408,915,721,134,362,164,61,307,284,34,96,194,17,78,64,35,181,13
26410,391,259,53,118,74,14,86,109,40,24,132,23,38,35,36,121,11
26411,255,212,37,73,73,29,65,121,10,16,43,3,0,24,16,38,5
26412,334,215,49,73,52,41,70,125,5,15,119,5,17,73,24,114,5
26415,1107,767,173,362,199,33,273,372,72,50,340,35,99,111,95,303,37
26416,2761,1860,375,853,487,145,629,859,215,157,901,117,229,279,276,800,101
26419,437,357,47,166,126,18,112,177,36,32,80,16,18,22,24,71,9
26421,134,105,19,59,16,11,53,35,9,8,29,7,8,5,9,28,1
26422,312,216,21,111,66,18,61,73,41,41,96,8,16,21,51,86,10
26424,33,12,7,0,5,0,7,0,0,5,21,0,15,6,0,18,3
26425,538,408,77,195,128,8,149,177,36,46,130,15,28,46,41,118,12
26426,2131,1433,295,622,420,96,513,632,148,140,698,145,186,213,154,595,103
26430,233,154,20,84,50,0,56,63,19,16,79,9,25,29,16,48,31
26431,2489,1830,333,804,511,182,592,867,143,228,659,96,153,214,196,594,65
26435,35,30,5,25,0,0,15,0,0,15,5,0,5,0,0,5,0
26436,70,65,4,29,32,0,22,32,7,4,5,0,0,5,0,0,5
26437,242,178,38,84,34,22,66,73,18,21,64,3,20,24,17,54,10
26438,11,6,0,0,6,0,0,6,0,0,5,0,0,5,0,5,0
26440,442,316,58,108,133,17,95,156,22,43,126,16,35,49,26,115,11
26443,136,102,18,57,9,18,41,45,7,9,34,12,7,7,8,27,7
26444,1270,916,168,403,282,63,319,428,71,98,354,54,95,133,72,303,51
26447,316,215,87,104,24,0,102,54,33,26,101,0,26,58,17,79,22
26448,522,380,59,160,161,0,129,187,23,41,142,8,53,47,34,130,12
26451,293,231,48,107,50,26,79,108,34,10,62,12,17,22,11,57,5
26452,4402,2919,486,1386,791,256,844,1494,325,256,1483,200,460,410,413,1296,187
26456,1650,1204,186,550,371,97,423,494,132,155,446,45,133,150,118,387,59
26463,56,47,15,28,4,0,19,23,5,0,9,0,0,9,0,9,0
26501,8305,4875,1022,2172,1317,364,1597,2202,518,558,3430,1340,974,672,444,2591,839
26505,13623,5360,1528,2295,1104,433,1711,2416,533,700,8263,5576,1147,814,726,5252,3011
26508,8713,6267,1343,3164,1469,291,2431,2826,608,402,2446,585,799,735,327,2035,411
26519,596,433,127,174,124,8,154,216,42,21,163,34,39,52,38,128,35
26520,269,199,21,78,74,26,52,99,9,39,70,11,29,23,7,53,17
26521,169,106,12,46,45,3,34,52,9,11,63,16,9,14,24,50,13
26525,1620,1149,186,605,266,92,412,560,72,105,471,94,135,140,102,387,84
26529,575,487,132,250,57,48,178,225,67,17,88,23,0,32,33,78,10
26531,45,45,6,23,0,16,13,22,10,0,0,0,0,0,0,0,0
26534,296,178,63,53,58,4,42,80,33,23,118,30,18,44,26,99,19
26537,2350,1641,354,701,457,129,600,723,163,155,709,93,255,202,159,625,84
26541,302,226,33,135,47,11,66,88,33,39,76,0,26,10,40,61,15
26542,964,661,135,334,158,34,200,344,76,41,303,34,65,105,99,279,24
26543,45,24,0,10,14,0,4,14,6,0,21,0,9,5,7,16,5
26544,68,39,13,12,14,0,25,14,0,0,29,6,11,12,0,29,0
26547,741,598,144,270,130,54,203,269,74,52,143,44,56,32,11,128,15
26554,17340,11003,2096,4882,3000,1025,3287,5439,1107,1170,6337,1518,1444,1747,1628,5333,1004
26559,440,300,68,121,91,20,86,159,36,19,140,13,32,62,33,121,19
26562,307,196,24,84,63,25,56,83,21,36,111,7,14,62,28,98,13
26563,191,140,14,65,49,12,25,52,29,34,51,4,27,10,10,44,7
26568,233,157,37,72,33,15,51,73,18,15,76,5,23,22,26,64,12
26570,1197,912,191,343,312,66,281,470,64,97,285,24,81,120,60,251,34
26571,988,709,117,336,176,80,230,321,50,108,279,42,47,88,102,251,28
26572,55,48,21,0,27,0,29,19,0,0,7,0,0,0,7,7,0
26574,281,204,44,81,55,24,45,93,36,30,77,7,11,21,38,70,7
26575,364,207,14,103,76,14,63,101,21,22,157,20,20,72,45,145,12
26576,106,85,13,32,33,7,49,19,0,17,21,7,9,0,5,12,9
26581,293,205,55,87,62,1,53,91,42,19,88,2,7,57,22,78,10
26582,2045,1488,264,636,454,134,464,777,142,105,557,81,128,189,159,486,71
26585,231,200,24,114,52,10,56,117,8,19,31,0,12,4,15,28,3
26586,47,47,39,8,0,0,39,0,8,0,0,0,0,0,0,0,0
26587,152,115,19,51,37,8,27,56,16,16,37,9,6,11,11,33,4
26588,1066,790,124,388,207,71,235,379,87,89,276,28,68,86,94,249,27
26589,279,226,54,111,43,18,101,99,11,15,53,8,5,17,23,45,8
26590,75,66,10,32,24,0,19,36,0,11,9,0,9,0,0,9,0
26591,576,409,75,200,92,42,116,213,47,33,167,15,28,52,72,143,24
26601,1970,1396,285,614,394,103,410,741,148,97,574,84,146,223,121,497,77
26610,531,428,92,194,108,34,136,215,37,40,103,13,6,24,60,90,13
26611,127,87,22,24,41,0,20,50,10,7,40,0,7,0,33,40,0
26615,55,34,8,13,13,0,8,7,7,12,21,0,8,13,0,15,6
26617,66,54,0,17,24,13,0,39,10,5,12,0,7,5,0,12,0
26619,165,129,33,65,26,5,67,57,0,5,36,0,18,11,7,36,0
26621,413,276,35,161,59,21,103,128,15,30,137,22,45,44,26,125,12
26623,536,401,46,177,150,28,138,218,21,24,135,35,51,7,42,94,41
26624,1232,862,152,368,236,106,281,389,131,61,370,38,81,122,129,338,32
26627,148,139,25,56,58,0,44,72,11,12,9,0,0,0,9,9,0
26629,87,87,40,31,6,10,35,40,12,0,0,0,0,0,0,0,0
26631,40,22,0,9,13,0,0,22,0,0,18,0,0,5,13,13,5
26634,26,26,0,19,7,0,19,7,0,0,0,0,0,0,0,0,0
26636,134,107,7,72,17,11,34,41,26,6,27,18,0,9,0,9,18
26638,0,0,0,0,0,0,0,0,0,0,0,0,0,0,0,0,0
26639,211,119,28,43,37,11,25,66,19,9,92,9,14,30,39,92,0
26641,25,17,0,12,0,5,7,10,0,0,8,8,0,0,0,8,0
26651,3725,2537,523,1184,658,172,876,1206,238,217,1188,105,377,442,264,1062,126
26656,184,134,22,80,19,13,47,52,16,19,50,13,12,15,10,43,7
26660,60,39,0,39,0,0,20,14,5,0,21,6,0,0,15,21,0
26662,278,187,15,106,66,0,54,109,15,9,91,7,40,15,29,75,16
26667,32,32,7,13,0,12,7,25,0,0,0,0,0,0,0,0,0
26671,67,37,29,8,0,0,13,0,24,0,30,0,14,8,8,30,0
26674,158,118,4,65,49,0,31,65,7,15,40,0,29,0,11,40,0
26676,223,142,27,84,31,0,80,56,6,0,81,28,0,33,20,81,0
26678,455,368,73,207,65,23,129,199,23,17,87,17,19,33,18,68,19
26679,702,536,96,254,171,15,166,274,31,65,166,17,46,55,48,157,9
26680,178,153,13,67,43,30,28,92,15,18,25,5,6,10,4,25,0
26681,598,484,143,218,106,17,232,171,45,36,114,7,27,51,29,99,15
26684,42,36,15,8,6,7,9,21,6,0,6,0,0,0,6,6,0
26690,90,82,15,45,17,5,20,38,5,19,8,0,4,4,0,8,0
26691,144,111,27,42,37,5,12,72,22,5,33,8,8,9,8,25,8
26704,1782,1334,293,584,359,98,470,570,140,154,448,73,114,199,62,353,95
26705,442,321,46,159,88,28,107,168,34,12,121,8,32,57,24,115,6
26707,168,107,16,43,35,13,19,56,13,19,61,9,18,20,14,49,12
26710,682,496,112,216,136,32,189,247,26,34,186,27,59,67,33,168,18
26711,946,663,111,322,187,43,258,314,59,32,283,22,121,108,32,240,43
26714,54,54,8,31,15,0,36,18,0,0,0,0,0,0,0,0,0
26716,308,226,33,81,91,21,86,134,0,6,82,10,12,29,31,72,10
26717,417,350,77,163,84,26,116,174,40,20,67,0,17,30,20,64,3
26719,979,687,141,268,231,47,276,322,53,36,292,45,47,130,70,260,32
26720,89,54,12,7,29,6,13,35,1,5,35,15,12,0,8,27,8
26722,256,170,17,105,44,4,54,78,18,20,86,5,24,31,26,66,20
26726,5051,3563,705,1539,1102,217,1183,1678,376,326,1488,182,328,587,391,1324,164
26731,93,81,24,30,27,0,28,28,16,9,12,0,12,0,0,12,0
26739,346,278,25,151,88,14,52,170,27,29,68,4,0,56,8,57,11
26743,734,541,63,296,168,14,176,307,36,22,193,13,77,77,26,176,17
26750,460,293,64,123,90,16,68,124,62,39,167,39,48,54,26,143,24
26753,2454,1823,314,911,481,117,594,905,171,153,631,129,152,200,150,536,95
26755,74,55,12,23,10,10,20,35,0,0,19,0,0,9,10,19,0
26757,2366,1582,275,790,430,87,497,731,232,122,784,111,193,281,199,723,61
26761,312,237,74,85,62,16,78,111,27,21,75,23,16,36,0,57,18
26763,449,296,67,108,94,27,74,164,40,18,153,15,17,96,25,138,15
26764,1552,1170,237,519,324,90,401,593,106,70,382,41,108,160,73,336,46
26767,332,202,39,93,61,9,77,99,8,18,130,13,37,39,41,105,25
26801,510,368,64,180,104,20,160,169,21,18,142,11,7,78,46,142,0
26802,618,427,116,150,114,47,137,218,37,35,191,38,60,66,27,142,49
26804,285,204,55,83,42,24,82,66,21,35,81,0,14,49,18,81,0
26807,1297,880,158,397,259,66,301,423,42,114,417,57,110,148,102,378,39
26808,300,232,57,85,49,41,52,124,15,41,68,20,21,8,19,56,12
26810,173,96,10,32,54,0,19,60,8,9,77,0,26,41,10,66,11
26812,692,445,61,233,112,39,142,233,55,15,247,16,80,112,39,214,33
26814,215,167,0,80,69,18,50,88,5,24,48,0,0,15,33,48,0
26815,275,201,47,60,80,14,62,97,17,25,74,14,18,42,0,55,19
26817,108,89,11,55,16,7,22,58,2,7,19,0,8,7,4,9,10
26818,206,171,33,95,43,0,72,73,7,19,35,5,22,8,0,30,5
26823,39,39,9,11,10,9,15,24,0,0,0,0,0,0,0,0,0
26833,882,678,178,284,190,26,284,337,27,30,204,59,53,53,39,172,32
26836,2527,1756,441,750,480,85,537,853,207,159,771,108,227,238,198,650,121
26838,7,7,0,4,3,0,0,7,0,0,0,0,0,0,0,0,0
26845,330,219,51,63,86,19,76,96,33,14,111,14,30,61,6,103,8
26847,2437,1678,353,729,454,142,530,837,205,106,759,141,165,251,202,676,83
26851,761,500,98,228,128,46,147,274,44,35,261,32,108,85,36,208,53
26852,328,208,40,102,39,27,59,108,24,17,120,0,28,43,49,107,13
26855,294,224,56,126,42,0,99,94,25,6,70,8,7,15,40,36,34
26865,114,98,13,40,22,23,18,70,5,5,16,3,0,13,0,8,8
26866,363,280,48,137,61,34,83,138,18,41,83,12,17,28,26,72,11
26884,214,152,30,75,31,16,52,80,12,8,62,7,16,33,6,62,0
26886,97,62,12,32,11,7,5,23,11,23,35,14,6,6,9,21,14
27006,4202,3264,519,1597,910,238,1199,1628,222,215,938,156,276,270,236,811,127
27007,508,447,115,194,94,44,194,211,7,35,61,15,6,40,0,61,0
27009,878,674,199,303,135,37,286,314,26,48,204,19,89,58,38,179,25
27011,2118,1599,395,653,409,142,553,821,159,66,519,55,160,184,120,486,33
27012,8088,6385,1146,3391,1642,206,2733,2876,396,380,1703,327,741,387,248,1455,248
27013,1963,1574,405,718,368,83,583,658,189,144,389,70,122,128,69,350,39
27014,248,156,47,65,39,5,53,63,16,24,92,12,23,28,29,84,8
27016,676,492,122,190,135,45,140,220,67,65,184,41,64,37,42,179,5
27017,3354,2512,683,941,747,141,818,1281,192,221,842,196,227,241,178,755,87
27018,2917,2134,397,1040,539,158,801,1036,144,153,783,94,255,304,130,700,83
27019,1780,1334,278,650,356,50,482,681,105,66,446,88,169,105,84,390,56
27020,2335,1783,489,716,507,71,682,820,155,126,552,104,182,135,131,485,67
27021,6203,4625,1096,2256,1097,176,1749,2119,497,260,1578,191,542,550,295,1447,131
27022,663,538,78,300,147,13,244,284,5,5,125,4,52,30,39,122,3
27023,3830,2999,520,1695,690,94,1259,1374,234,132,831,168,324,241,98,699,132
27024,1000,727,118,349,188,72,229,406,30,62,273,39,103,98,33,236,37
27025,4176,3105,617,1433,855,200,992,1443,297,373,1071,195,305,305,266,941,130
27027,1914,1208,236,551,333,88,346,528,170,164,706,90,192,227,197,659,47
27028,9163,6780,1564,3109,1677,430,2248,3241,820,471,2383,344,746,808,485,2131,252
27030,15611,11192,2477,4927,2969,819,3698,5056,1248,1190,4419,585,1398,1413,1023,4002,417
27040,3645,2872,317,1627,764,164,1136,1451,157,128,773,94,287,264,128,682,91
27041,2864,2089,396,977,549,167,666,1051,190,182,775,152,184,245,194,695,80
27042,255,193,34,94,54,11,75,90,28,0,62,0,8,45,9,54,8
27043,2091,1625,371,807,398,49,644,730,121,130,466,83,164,137,82,419,47
27045,3022,2163,421,1034,627,81,668,1029,241,225,859,98,302,266,193,773,86
27046,833,610,167,305,92,46,273,293,36,8,223,41,102,49,31,191,32
27047,449,367,86,164,103,14,182,131,15,39,82,18,6,58,0,78,4
27048,3248,2450,500,1153,620,177,839,1191,173,247,798,93,257,285,163,701,97
27050,1520,1172,222,656,252,42,462,537,105,68,348,54,129,105,60,306,42
27051,2738,2086,447,989,521,129,732,1005,206,143,652,115,196,233,108,546,106
27052,4076,3029,606,1467,816,140,1079,1352,303,295,1047,150,367,365,165,917,130
27053,1176,898,193,431,217,57,330,414,46,108,278,11,87,113,67,261,17
27054,856,659,125,355,130,49,255,262,78,64,197,36,85,58,18,162,35
27055,5062,3723,912,1595,977,239,1301,1769,358,295,1339,191,335,465,348,1220,119
27101,8071,4075,1193,1838,770,274,900,1264,1174,737,3996,1025,1203,1037,731,3483,513
27103,12478,7227,2028,3050,1583,566,2050,3291,1120,766,5251,1498,1962,954,837,4470,781
27104,12604,7286,1438,3303,1981,564,2491,3697,589,509,5318,1481,1635,1241,961,4647,671
27105,15420,10568,2700,4555,2474,839,2439,3459,2569,2101,4852,725,1615,1680,832,4190,662
27106,16548,10210,2332,4891,2252,735,3380,4464,1566,800,6338,2258,1668,1305,1107,5364,974
27107,14545,10537,2696,4903,2423,515,3329,4122,1746,1340,4008,669,1356,1382,601,3450,558
27109,0,0,0,0,0,0,0,0,0,0,0,0,0,0,0,0,0
27127,10783,7211,1909,3321,1572,409,2220,3123,1165,703,3572,918,1294,894,466,3032,540
27202,22,5,5,0,0,0,0,5,0,0,17,0,0,9,8,17,0
27203,19338,13785,3462,6087,3382,854,4791,6164,1733,1097,5553,1236,1730,1592,995,4770,783
27207,1490,1149,229,563,297,60,362,522,116,149,341,48,106,109,78,320,21
27208,662,527,120,231,139,37,193,249,41,44,135,7,73,33,22,124,11
27209,1320,974,245,429,212,88,379,380,94,121,346,43,115,128,60,294,52
27212,537,420,71,154,145,50,123,171,35,91,117,8,28,57,24,115,2
27214,2310,1836,409,906,422,99,656,813,194,173,474,64,160,168,82,367,107
27215,14454,9353,1643,4473,2392,845,3037,4369,1126,821,5101,1427,1409,1281,984,4379,722
27217,12979,9197,2375,3889,2361,572,2658,3736,1528,1275,3782,676,1036,1335,735,3229,553
27229,1315,1032,247,469,243,73,324,415,153,140,283,27,111,72,73,261,22
27231,793,649,112,343,128,66,230,321,55,43,144,0,54,57,33,144,0
27233,1337,1059,207,503,301,48,403,521,97,38,278,31,97,89,61,245,33
27235,938,685,77,395,183,30,240,375,46,24,253,40,86,78,49,232,21
27239,3347,2572,543,1214,654,161,861,1288,200,223,775,72,216,277,210,681,94
27242,754,569,111,268,135,55,184,224,92,69,185,44,48,62,31,169,16
27243,1217,902,238,403,221,40,326,359,145,72,315,70,107,87,51,235,80
27244,3413,2273,417,1121,561,174,832,1036,192,213,1140,504,244,235,157,748,392
27248,1846,1322,334,585,328,75,531,604,97,90,524,119,127,127,151,420,104
27249,4172,3178,668,1555,784,171,1230,1412,295,241,994,169,371,291,163,885,109
27252,609,455,65,185,154,51,139,209,24,83,154,18,38,41,57,137,17
27253,10135,6969,1795,2972,1777,425,2196,3087,971,715,3166,555,1147,899,565,2680,486
27256,86,67,5,29,18,15,10,49,8,0,19,0,6,13,0,19,0
27258,2090,1485,436,654,310,85,517,631,185,152,605,89,282,178,56,484,121
27260,9654,6360,2222,2457,1309,372,1282,1789,2051,1238,3294,342,1233,1001,718,2782,512
27262,9670,5945,1259,2684,1523,479,1846,2524,773,802,3725,845,1133,964,783,3151,574
27263,7732,5623,1360,2364,1599,300,1675,2576,750,622,2109,458,739,627,285,1823,286
27265,12898,9558,2247,4712,2233,366,3929,4227,714,688,3340,916,1278,674,472,2681,659
27278,7904,5841,1075,3259,1236,271,2010,2353,786,692,2063,401,829,503,330,1671,392
27281,878,687,142,284,158,103,252,321,66,48,191,30,60,44,57,151,40
27282,4447,3348,701,1757,803,87,1401,1538,258,151,1099,313,420,242,124,873,226
27283,1155,917,138,486,228,65,337,431,97,52,238,23,85,63,67,224,14
27284,16754,12474,2802,6268,2967,437,4513,5913,1226,822,4280,1117,1442,1089,632,3711,569
27288,10331,7088,1597,3108,1806,577,2117,3154,957,860,3243,474,929,1144,696,2946,297
27291,820,614,120,296,137,61,239,240,64,71,206,31,54,77,44,197,9
27292,15335,10887,2654,4955,2703,575,3422,4841,1537,1087,4448,798,1495,1288,867,3782,666
27295,13571,10088,2322,4535,2685,546,3362,5119,941,666,3483,608,1200,1058,617,3076,407
27298,3732,2783,618,1371,623,171,1016,1237,259,271,949,115,318,305,211,831,118
27299,1646,1184,324,608,185,67,399,565,140,80,462,106,177,111,68,388,74
27301,2131,1709,287,805,545,72,651,733,174,151,422,47,143,202,30,365,57
27302,8646,6363,1641,2875,1513,334,2340,2617,809,597,2283,461,852,668,302,1942,341
27305,577,465,78,247,121,19,133,186,59,87,112,15,28,44,25,105,7
27306,2491,1852,297,831,561,163,427,940,211,274,639,57,181,240,161,600,39
27310,1433,1216,193,700,281,42,642,509,47,18,217,57,60,80,20,166,51
27311,1505,1147,186,591,296,74,369,563,104,111,358,54,125,112,67,336,22
27312,5124,3627,687,1688,914,338,1174,1777,292,384,1497,223,593,419,262,1224,273
27313,2476,1903,284,950,576,93,671,1009,115,108,573,55,240,155,123,506,67
27314,261,205,40,91,59,15,36,123,13,33,56,4,33,0,19,56,0
27315,696,461,66,192,165,38,131,250,23,57,235,38,73,75,49,199,36
27316,2549,1899,512,790,467,130,667,858,221,153,650,99,179,187,185,572,78
27317,5472,4190,1176,1977,866,171,1514,1707,589,380,1282,246,414,418,204,1150,132
27320,15454,11174,2341,5095,3011,727,3502,5017,1413,1242,4280,667,1258,1424,931,3803,477
27325,2626,1910,509,813,432,156,658,791,261,200,716,84,138,223,271,669,47
27326,1467,1104,261,456,334,53,350,535,116,103,363,33,143,104,83,332,31
27330,20479,14978,3765,6696,3557,960,5241,6189,2157,1391,5501,1037,2067,1498,899,4655,846
27341,2036,1527,332,734,407,54,491,757,153,126,509,51,150,146,162,469,40
27342,13,6,0,0,6,0,0,3,0,3,7,0,3,0,4,7,0
27343,714,473,42,169,201,61,87,219,33,134,241,15,101,106,19,188,53
27344,5780,4117,1022,1809,977,309,1321,1774,584,438,1663,246,434,573,410,1365,298
27349,1730,1358,291,683,300,84,504,620,117,117,372,63,129,94,86,325,47
27350,2221,1709,323,887,437,62,565,838,154,152,512,75,148,201,88,420,92
27355,968,746,117,385,202,42,223,379,79,65,222,33,58,69,62,194,28
27356,1328,918,232,410,224,52,315,406,113,84,410,59,118,168,65,377,33
27357,2453,1877,443,961,396,77,726,856,171,124,576,107,218,150,101,495,81
27358,3670,2972,449,1755,641,127,1290,1333,212,137,698,115,265,205,113,588,110
27360,16661,11965,2873,5398,3013,681,3840,5390,1546,1189,4696,765,1486,1381,1064,4012,684
27370,5681,4606,995,2360,1045,206,1759,2131,370,346,1075,217,335,355,168,924,151
27371,2859,2059,494,852,544,169,636,967,254,202,800,55,232,295,218,743,57
27376,3083,2346,383,791,890,282,601,1435,197,113,737,80,168,303,186,631,106
27377,1520,1144,239,496,360,49,287,667,92,98,376,65,142,129,40,322,54
27379,1941,1378,310,576,391,101,396,554,223,205,563,27,167,191,178,521,42
27401,7358,3826,1149,1485,870,322,685,1152,1077,912,3532,1207,1236,709,380,2812,720
27403,8457,4216,1095,2085,747,289,1407,1588,603,618,4241,2265,1037,448,491,2870,1371
27405,16190,10181,3118,4337,2096,630,2550,3503,2336,1792,6009,1767,1761,1511,970,5014,995
27406,19552,13571,3099,6287,3366,819,3604,5358,2687,1922,5981,1524,1978,1669,810,5017,964
27407,17065,11019,3176,5233,2177,433,3895,4238,1703,1183,6046,2664,1787,1075,520,4625,1421
27408,7863,4948,747,2143,1534,524,1590,2616,336,406,2915,668,929,737,581,2451,464
27409,6689,3083,1028,1468,480,107,953,1216,585,329,3606,1739,1125,491,251,2796,810
27410,19388,12413,2042,6086,3368,917,4610,6307,879,617,6975,2545,2078,1288,1064,5777,1198
27455,9521,6166,1392,3236,1332,206,2375,2747,717,327,3355,1266,1206,606,277,2623,732
27501,4947,3700,1325,1645,617,113,1427,1551,474,248,1247,314,391,354,188,981,266
27502,15736,12400,3158,7363,1599,280,6617,4408,762,613,3336,1189,1374,535,238,2591,745
27503,1303,961,101,621,209,30,414,442,39,66,342,56,150,76,60,269,73
27504,5017,3472,913,1607,782,170,1309,1474,408,281,1545,312,506,460,267,1313,232
27505,1682,1262,351,532,281,98,395,525,172,170,420,36,167,134,83,363,57
27506,468,101,40,21,30,10,12,57,17,15,367,252,23,26,66,251,116
27507,657,497,97,203,155,42,133,253,51,60,160,16,57,47,40,129,31
27508,497,353,88,146,105,14,139,119,44,51,144,8,31,70,35,138,6
27509,1467,1073,235,475,305,58,328,414,209,122,394,97,102,121,74,365,29
27510,6887,2705,973,1342,323,67,772,905,594,434,4182,2782,959,319,122,2665,1517
27511,17089,12119,1993,6895,2830,401,5223,5305,1077,514,4970,1938,1826,806,400,3761,1209
27513,14132,9740,2415,6139,1035,151,5169,3434,647,490,4392,2192,1645,389,166,3343,1049
27514,18831,9713,2031,4458,2507,717,3363,4886,884,580,9118,5014,1699,1169,1236,5814,3304
27516,11341,6670,1470,3932,1053,215,3028,2487,728,427,4671,2017,1540,758,356,3006,1665
27520,11856,9103,2668,4811,1425,199,3826,3652,1049,576,2753,658,1082,668,345,2206,547
27521,2145,1497,413,635,361,88,528,636,191,142,648,245,153,131,119,503,145
27522,3477,2434,530,1278,489,137,848,1055,373,158,1043,199,369,332,143,874,169
27524,3947,2777,817,1222,614,124,1055,1278,240,204,1170,173,390,331,276,1022,148
27525,3982,2949,785,1396,628,140,898,1190,460,401,1033,137,399,333,164,893,140
27526,9168,7040,1774,3672,1323,271,3060,2791,710,479,2128,557,756,508,307,1727,401
27529,11567,8472,2087,4346,1763,276,3386,3453,931,702,3095,844,1281,656,314,2480,615
27530,14789,10090,2288,4712,2586,504,2904,4228,1900,1058,4699,820,1381,1497,1001,4115,584
27534,12212,9023,2427,4160,2131,305,3502,3791,1083,647,3189,916,1043,797,433,2636,553
27536,15258,10891,2963,4689,2624,615,2941,4076,2213,1661,4367,633,1460,1407,867,3821,546
27540,4357,3473,1171,1805,449,48,1639,1305,303,226,884,311,384,117,72,686,198
27541,1371,1018,124,528,330,36,347,561,81,29,353,58,133,93,69,332,21
27542,3042,2152,480,894,616,162,630,962,346,214,890,133,300,269,188,766,124
27544,1351,1076,157,557,293,69,386,468,81,141,275,50,94,85,46,258,17
27545,5747,4353,1284,2304,625,140,1837,1611,613,292,1394,456,571,299,68,1107,287
27546,5158,3728,982,1681,894,171,1236,1465,540,487,1430,365,489,378,198,1191,239
27549,8027,5801,1320,2749,1386,346,1976,2414,731,680,2226,262,776,713,475,1962,264
27551,839,568,36,310,181,41,134,335,36,63,271,26,101,100,44,214,57
27553,711,565,78,314,160,13,194,163,86,122,146,0,65,51,30,139,7
27555,201,128,31,69,23,5,49,50,15,14,73,6,9,30,28,71,2
27557,2557,1925,446,950,462,67,657,822,243,203,632,94,163,224,151,543,89
27559,907,608,120,293,168,27,140,313,51,104,299,63,108,60,68,246,53
27560,4410,2675,808,1472,350,45,1138,1147,224,166,1735,971,533,175,56,1330,405
27562,634,497,66,262,135,34,150,293,18,36,137,27,50,41,19,112,25
27563,1803,1284,274,538,362,110,331,520,222,211,519,48,141,226,104,481,38
27565,8856,6410,1231,3074,1698,407,1857,2531,999,1023,2446,292,710,885,559,2203,243
27568,27,16,2,6,2,6,2,2,4,8,11,0,6,2,3,11,0
27569,2508,1877,374,880,509,114,642,861,196,178,631,130,169,205,127,538,93
27570,94,74,13,20,30,11,13,43,0,18,20,5,10,5,0,20,0
27571,463,355,83,176,91,5,106,170,69,10,108,20,40,34,14,88,20
27572,2344,1883,411,1021,357,94,792,840,136,115,461,58,187,158,58,375,86
27573,9620,6870,1294,3258,1819,499,2097,2857,956,960,2750,423,827,923,577,2485,265
27576,6344,4577,1233,2080,1028,236,1437,1922,707,511,1767,326,495,574,372,1529,238
27577,7267,4782,1206,2052,1204,320,1597,2068,621,496,2485,400,645,798,642,2217,268
27581,941,747,224,355,134,34,277,332,89,49,194,19,92,73,10,154,40
27582,36,26,2,8,12,4,0,20,4,2,10,2,4,4,0,10,0
27583,1841,1416,357,708,300,51,533,586,172,125,425,81,166,113,65,380,45
27584,44,34,9,0,25,0,0,25,0,9,10,0,4,6,0,10,0
27587,10646,8180,1957,4669,1392,162,3947,3193,646,394,2466,617,971,560,318,1983,483
27589,3246,2279,458,1011,589,221,715,859,339,366,967,123,294,303,247,889,78
27591,5678,4111,962,2201,791,157,1616,1622,522,351,1567,362,528,416,261,1280,287
27592,3271,2481,785,1236,437,23,1126,974,206,175,790,208,358,149,75,626,164
27596,3282,2449,631,1267,489,62,968,1104,202,175,833,227,424,110,72,662,171
27597,6559,4773,1017,2557,1012,187,1747,2043,603,380,1786,357,615,538,276,1496,290
27601,3451,1694,637,652,310,95,196,313,756,429,1757,394,604,481,278,1455,302
27603,12584,7860,2189,3976,1411,284,2847,3073,1234,706,4724,2020,1586,901,217,3522,1202
27604,13400,8289,2636,3886,1511,256,2777,3296,1439,777,5111,1946,2008,868,289,3966,1145
27605,2405,623,154,330,87,52,208,297,52,66,1782,842,488,266,186,1505,277
27606,15373,7240,2152,3688,1203,197,2730,2912,861,737,8133,5767,1678,494,194,4579,3554
27607,7210,3726,823,1788,825,290,1305,1622,396,403,3484,1732,802,555,395,2304,1180
27608,5059,2548,565,1193,543,247,801,1326,274,147,2511,932,805,334,440,2031,480
27609,14580,8380,2132,3587,2088,573,2539,3836,1151,854,6200,2463,1959,1136,642,4856,1344
27610,15020,10651,3049,5028,2066,508,3004,3271,2508,1868,4369,1259,1633,1030,447,3476,893
27612,12389,6641,1520,3206,1611,304,2359,3266,556,460,5748,2911,1687,726,424,4315,1433
27613,14651,9660,2110,5920,1465,165,4730,3899,696,335,4991,2578,1761,446,206,3760,1231
27614,3790,3303,375,2205,702,21,1754,1364,105,80,487,108,247,74,58,336,151
27615,15905,11231,1970,6475,2432,354,4745,4876,1040,570,4674,1613,1627,887,547,3797,877
27616,7929,5597,2123,2754,640,80,2380,1769,952,496,2332,922,1000,336,74,1820,512
27701,9293,4978,1981,2007,730,260,996,1034,1694,1254,4315,1284,1605,909,517,3428,887
27703,11688,8386,2514,3983,1527,362,2516,2842,1910,1118,3302,931,1264,759,348,2686,616
27704,10740,7023,1796,3308,1494,425,2007,2461,1407,1148,3717,875,1429,818,595,3091,626
27705,17159,8674,2481,3845,1594,754,2876,3744,1176,878,8485,3785,2270,1295,1135,6394,2091
27706,53,42,10,0,14,18,10,25,0,7,11,0,0,0,11,0,11
27707,17338,10230,2828,4568,2219,615,3038,3813,1913,1466,7108,2837,2409,1262,600,5535,1573
27712,6573,5381,623,3094,1445,219,1978,2653,397,353,1192,156,474,407,155,1003,189
27713,13224,7966,2800,3805,1194,167,3044,3283,872,767,5258,2689,1832,486,251,3936,1322
27801,7919,5792,1162,2783,1560,287,1455,1881,1382,1074,2127,298,747,691,391,1864,263
27803,8452,6137,1287,3078,1422,350,2009,2527,937,664,2315,376,699,746,494,2071,244
27804,10250,6877,1540,3381,1497,459,2312,2810,942,813,3373,891,1087,729,666,2954,419
27805,1307,955,161,448,268,78,244,420,150,141,352,37,110,104,101,328,24
27806,1078,737,125,289,258,65,149,394,99,95,341,15,118,113,95,318,23
27807,2102,1554,345,793,355,61,601,676,152,125,548,122,174,136,116,452,96
27808,953,750,139,285,263,63,226,421,73,30,203,22,60,77,44,191,12
27809,1830,1349,208,726,357,58,361,549,194,245,481,37,172,162,110,433,48
27810,1915,1301,256,512,428,105,317,660,151,173,614,29,201,233,151,567,47
27812,1131,793,102,387,217,87,207,302,146,138,338,28,120,122,68,284,54
27813,146,108,25,52,27,4,30,39,26,13,38,4,19,7,8,21,17
27814,585,459,66,221,135,37,141,197,59,62,126,27,50,13,36,121,5
27816,791,551,110,267,128,46,195,219,49,88,240,46,60,76,58,199,41
27817,2525,1900,345,806,661,88,491,965,235,209,625,116,243,191,75,557,68
27818,546,405,51,177,133,44,104,159,56,86,141,15,49,48,29,124,17
27819,205,131,18,70,41,2,49,47,18,17,74,7,16,46,5,70,4
27820,1076,751,122,340,215,74,225,305,132,89,325,32,121,118,54,285,40
27821,160,115,17,36,50,12,10,48,35,22,45,0,19,21,5,39,6
27822,3035,2281,491,1094,544,152,701,1072,265,243,754,107,202,242,203,666,88
27823,3114,2282,449,1090,582,161,556,718,509,499,832,57,296,311,168,750,82
27824,702,416,57,147,132,80,104,135,40,137,286,9,95,123,59,286,0
27826,283,191,47,67,41,36,64,84,16,27,92,20,32,13,27,92,0
27827,25,15,9,2,3,1,3,7,4,1,10,0,4,1,5,9,1
27828,3512,2475,517,1170,608,180,692,984,414,385,1037,135,244,377,281,933,104
27829,699,502,73,270,121,38,180,180,72,70,197,28,91,48,30,181,16
27830,2034,1403,273,683,366,81,499,633,125,146,631,116,148,229,138,573,58
27831,1259,866,173,421,228,44,166,274,199,227,393,25,138,147,83,372,21
27832,1259,838,200,389,209,40,179,366,174,119,421,47,156,150,68,386,35
27834,16463,10458,3264,4718,1987,489,2875,3440,2447,1696,6005,2521,1801,1151,532,4861,1144
27837,1653,1233,307,596,267,63,380,523,159,171,420,69,165,116,70,320,100
27839,1279,893,106,425,262,100,182,394,144,173,386,42,112,148,84,353,33
27840,156,121,12,75,28,6,34,58,11,18,35,0,11,15,9,35,0
27841,14,7,2,5,0,0,2,5,0,0,7,0,5,0,2,7,0
27842,657,506,16,185,239,66,83,361,21,41,151,15,21,63,52,147,4
27843,563,430,82,142,142,64,85,192,81,72,133,16,54,46,17,124,9
27844,967,705,158,315,220,12,198,239,175,93,262,29,68,93,72,246,16
27845,799,512,62,219,170,61,118,186,68,140,287,8,58,96,125,256,31
27846,1138,870,194,408,227,41,248,415,117,90,268,39,85,89,55,259,9
27847,355,242,47,110,76,9,69,85,30,58,113,9,26,46,32,103,10
27849,606,422,74,233,94,21,104,132,94,92,184,11,65,61,47,168,16
27850,3188,2309,246,990,881,192,445,1266,287,311,879,102,205,357,215,816,63
27851,1810,1369,280,648,353,88,486,609,135,139,441,84,150,140,67,377,64
27852,1064,756,145,329,233,49,199,401,48,108,308,18,102,120,68,284,24
27853,283,217,69,74,55,19,85,69,51,12,66,11,23,23,9,59,7
27855,2319,1584,324,738,399,123,440,707,285,152,735,88,228,237,182,641,94
27856,5531,4176,877,1998,1121,180,1427,1821,430,498,1355,223,452,474,206,1217,138
27857,820,600,102,253,192,53,129,292,81,98,220,12,54,102,52,218,2
27858,18314,9518,2521,4540,1921,536,3593,4050,1078,797,8796,5670,1379,1045,702,5572,3224
27860,800,608,156,198,189,65,193,307,47,61,192,27,21,64,80,191,1
27862,342,239,27,108,78,26,70,87,11,71,103,13,24,44,22,100,3
27863,3024,2285,553,1086,553,93,919,952,224,190,739,164,264,211,100,661,78
27864,1595,1195,273,564,309,49,375,444,214,162,400,41,124,149,86,361,39
27865,772,550,58,307,133,52,254,223,6,67,222,52,20,55,95,197,25
27866,338,276,43,105,107,21,62,143,34,37,62,8,25,12,17,53,9
27869,1028,757,102,354,237,64,165,367,133,92,271,27,56,106,82,250,21
27870,11080,7580,1769,3440,1876,495,2245,3024,1378,933,3500,626,956,1086,832,3116,384
27871,1975,1384,243,689,366,86,396,596,206,186,591,34,146,195,216,550,41
27872,143,99,15,46,26,12,16,42,28,13,44,2,10,14,18,42,2
27873,145,97,18,29,34,16,16,58,18,5,48,13,7,10,18,42,6
27874,2204,1439,234,661,388,156,281,497,298,363,765,50,230,301,184,704,61
27875,231,194,13,129,36,16,48,65,41,40,37,0,17,14,6,37,0
27876,628,391,51,212,96,32,100,160,60,71,237,26,61,73,77,229,8
27877,99,69,8,25,28,8,10,32,7,20,30,3,0,21,6,30,0
27878,637,466,159,216,70,21,146,162,114,44,171,41,65,42,23,137,34
27880,902,664,151,347,140,26,243,273,80,68,238,31,50,97,60,218,20
27882,2352,1706,323,849,433,101,630,679,174,223,646,70,172,213,191,571,75
27883,1254,963,144,458,275,86,279,378,146,160,291,25,97,94,75,268,23
27884,411,296,57,133,98,8,108,146,29,13,115,0,52,28,35,110,5
27885,436,293,70,139,76,8,94,137,43,19,143,23,7,58,55,124,19
27886,7509,5349,1076,2555,1360,358,1401,2154,938,856,2160,285,665,683,527,1928,232
27888,901,724,151,298,232,43,225,315,79,105,177,27,63,48,39,141,36
27889,10241,7158,1629,3190,1874,465,2154,3282,1030,692,3083,486,942,1053,602,2665,418
27890,1052,743,147,340,200,56,151,253,216,123,309,17,110,125,57,293,16
27891,1777,1366,188,728,345,105,380,476,222,288,411,40,168,108,95,355,56
27892,6054,4359,747,2129,1131,352,1313,1690,692,664,1695,252,515,527,401,1546,149
27893,15864,10329,2635,4766,2377,551,2678,3382,2346,1923,5535,1016,1682,1776,1061,4769,766
27896,5457,4101,718,2112,1108,163,1486,1984,315,316,1356,342,358,411,245,1144,212
27897,864,563,109,257,146,51,147,238,109,69,301,37,90,97,77,278,23
27909,12925,9114,2049,4276,2149,640,2610,3758,1750,996,3811,570,1093,1345,803,3271,540
27910,4362,3004,511,1401,899,193,738,1186,621,459,1358,189,476,428,265,1247,111
27915,372,180,34,87,39,20,61,98,13,8,192,65,86,35,6,148,44
27916,194,154,15,79,39,21,67,87,0,0,40,6,7,7,20,40,0
27917,279,219,35,121,43,20,52,71,49,47,60,6,17,23,14,60,0
27919,341,284,33,117,89,45,93,140,11,40,57,6,22,21,8,51,6
27920,731,464,44,187,208,25,139,252,43,30,267,60,99,85,23,203,64
27921,1216,943,151,454,264,74,329,474,82,58,273,25,98,79,71,240,33
27922,395,289,40,121,98,30,62,125,47,55,106,12,23,49,22,98,8
27923,239,168,13,103,47,5,67,65,20,16,71,10,41,12,8,56,15
27924,1440,1037,163,427,400,47,276,452,130,179,403,28,119,147,109,364,39
27925,1438,989,165,443,314,67,249,453,143,144,449,32,134,151,132,424,25
27926,643,484,66,273,113,32,180,181,87,36,159,8,51,58,42,135,24
27927,303,224,10,101,113,0,31,183,10,0,79,8,54,17,0,51,28
27928,793,605,88,246,211,60,169,295,59,82,188,25,43,96,24,166,22
27929,267,227,29,95,82,21,38,131,37,21,40,6,6,7,21,39,1
27932,4650,3286,539,1431,1000,316,918,1481,545,342,1364,143,414,477,330,1232,132
27935,567,421,57,206,127,31,143,238,22,18,146,15,48,60,23,121,25
27936,134,100,23,36,29,12,17,62,13,8,34,14,5,5,10,15,19
27937,1111,828,160,347,209,112,271,363,79,115,283,13,106,91,73,252,31
27938,510,422,56,206,119,41,178,162,40,42,88,1,2,53,32,84,4
27939,692,463,69,174,184,36,126,261,38,38,229,20,90,66,53,195,34
27941,41,28,5,0,23,0,5,15,0,8,13,0,0,6,7,13,0
27942,420,330,64,150,95,21,94,107,57,72,90,5,28,44,13,77,13
27943,283,178,32,88,37,21,77,89,7,5,105,22,23,32,28,88,17
27944,4201,3050,521,1170,1072,287,822,1514,387,327,1151,125,316,394,316,1024,127
27946,488,366,45,186,107,28,130,151,13,72,122,9,27,61,25,112,10
27947,228,173,49,104,20,0,61,37,60,15,55,0,24,31,0,55,0
27948,3947,2458,474,1362,528,94,782,1182,342,152,1489,439,490,448,112,1042,447
27949,2585,1883,201,833,708,141,576,1094,105,108,702,106,229,264,103,565,137
27950,679,500,98,275,104,23,214,223,44,19,179,38,35,81,25,153,26
27953,449,367,48,236,50,33,106,208,44,9,82,0,6,76,0,82,0
27954,2107,1445,221,751,415,58,504,680,161,100,662,103,210,217,132,561,101
27956,176,115,31,61,19,4,51,50,10,4,61,0,17,22,22,51,10
27957,422,280,25,148,86,21,81,134,44,21,142,19,52,27,44,136,6
27958,2494,1965,421,961,501,82,763,851,236,115,529,102,220,146,61,386,143
27959,1175,763,112,371,241,39,222,448,70,23,412,94,147,123,48,307,105
27960,333,208,31,66,99,12,30,163,9,6,125,23,52,33,17,78,47
27962,3172,2273,469,1014,598,192,589,929,486,269,899,102,278,291,228,808,91
27964,250,162,30,49,65,18,22,118,14,8,88,48,15,7,18,68,20
27965,200,151,26,105,20,0,65,62,24,0,49,5,9,19,16,25,24
27966,566,456,120,200,109,27,127,231,68,30,110,26,53,31,0,86,24
27967,272,183,30,92,44,17,61,80,30,12,89,7,25,29,28,82,7
27968,140,89,13,42,34,0,26,63,0,0,51,16,14,21,0,42,9
27970,1427,1038,154,430,361,93,232,544,146,116,389,48,123,124,94,353,36
27972,124,90,20,25,32,13,22,46,0,22,34,15,13,6,0,34,0
27973,404,310,29,139,109,33,69,188,20,33,94,6,34,35,19,84,10
27974,461,329,71,138,113,7,114,171,44,0,132,17,39,53,23,108,24
27976,876,682,164,312,165,41,216,358,55,53,194,11,81,59,43,173,21
27979,612,443,79,193,133,38,155,193,49,46,169,7,52,48,62,157,12
27980,933,704,70,326,220,88,217,314,81,92,229,17,53,78,81,201,28
27981,608,457,92,276,66,23,192,202,34,29,151,20,50,73,8,102,49
27982,30,30,0,14,16,0,0,30,0,0,0,0,0,0,0,0,0
27983,3519,2538,426,1187,716,209,710,980,397,451,981,71,260,364,286,909,72
27985,50,29,1,15,8,5,6,15,5,3,21,0,6,9,6,18,3
27986,652,396,87,179,108,22,56,146,112,82,256,55,85,84,32,214,42
28001,10430,7302,1730,3111,1882,579,2447,3216,882,757,3128,467,863,992,806,2836,292
28006,256,193,48,95,40,10,63,85,17,28,63,37,7,0,19,42,21
28007,252,204,22,87,68,27,32,97,32,43,48,10,8,17,13,48,0
28009,375,246,48,100,55,43,65,116,43,22,129,24,35,23,47,113,16
28012,7539,5205,1172,2463,1188,382,1810,2332,559,504,2334,425,872,683,354,1962,372
28016,5541,4134,1085,1936,943,170,1284,1839,561,450,1407,296,494,394,223,1180,227
28017,263,203,23,112,54,14,92,89,5,17,60,35,12,10,3,45,15
28018,2248,1562,298,781,381,102,594,735,124,109,686,163,148,221,154,620,66
28019,280,209,40,87,62,20,71,99,8,31,71,0,5,37,29,71,0
28020,986,776,154,385,191,46,243,414,72,47,210,35,53,69,53,173,37
28021,4948,3661,707,1748,959,247,1207,1787,311,356,1287,202,273,455,357,1144,143
28023,4960,3779,958,1669,934,218,1299,1710,455,315,1181,154,372,335,320,1031,150
28025,15773,11323,2805,5302,2551,665,4105,4871,1247,1100,4450,931,1421,1124,974,3840,610
28027,11969,8993,2198,4516,1888,391,3549,3630,1047,767,2976,947,1039,630,360,2411,565
28031,5721,3879,659,2113,1007,100,1431,2010,220,218,1842,612,745,349,136,1468,374
28032,962,669,163,301,154,51,246,298,68,57,293,58,77,84,74,244,49
28033,704,608,136,332,114,26,197,244,86,81,96,5,43,25,23,75,21
28034,5502,4095,1093,1775,1060,167,1298,1885,534,378,1407,230,467,507,203,1220,187
28036,3283,2364,375,1365,554,70,1059,1002,156,147,919,241,366,195,117,768,151
28037,5066,3929,787,2003,1017,122,1431,1965,311,222,1137,231,424,297,185,896,241
28038,43,28,4,14,8,2,6,12,2,8,15,0,13,0,2,15,0
28040,2598,1928,487,833,503,105,648,911,199,170,670,160,201,187,122,581,89
28043,8244,5871,1580,2288,1598,405,1628,2674,942,627,2373,256,748,714,655,2172,201
28052,13644,9886,2573,4248,2344,721,2671,3844,1849,1522,3758,668,1270,1220,600,3127,631
28054,13783,9121,2345,3960,2146,670,2690,4142,1188,1101,4662,1162,1381,1267,852,4078,584
28056,10249,8174,1607,4391,1890,286,3295,3789,566,524,2075,530,737,539,269,1708,367
28071,1078,796,187,360,190,59,341,382,47,26,282,69,82,59,72,246,36
28072,103,65,20,23,19,3,21,26,16,2,38,5,8,20,5,33,5
28073,1658,1260,457,525,241,37,488,466,162,144,398,103,107,121,67,302,96
28075,5188,4206,807,2468,805,126,1943,1824,235,204,982,231,418,231,102,816,166
28076,114,87,19,31,18,19,19,56,0,12,27,0,12,9,6,27,0
28077,209,146,57,53,27,9,41,47,33,25,63,12,22,14,15,48,15
28078,10320,7794,2044,4454,1155,141,3636,3125,687,346,2526,988,900,358,280,1956,570
28079,4061,3229,702,1734,688,105,1367,1395,244,223,832,200,354,217,61,663,169
28080,2237,1738,412,846,440,40,653,783,162,140,499,89,220,104,86,404,95
28081,9226,6702,1699,3016,1540,447,2259,2803,867,773,2524,419,707,799,599,2149,375
28083,8172,5611,1345,2266,1471,529,1541,2485,740,845,2561,489,625,809,638,2196,365
28086,9331,7047,1537,3365,1797,348,2366,3172,856,653,2284,433,726,709,416,1996,288
28088,1284,890,165,371,287,67,288,407,90,105,394,63,90,140,101,348,46
28089,49,35,7,7,16,5,10,22,2,1,14,2,3,2,7,14,0
28090,3181,2427,529,1023,710,165,781,1087,294,265,754,116,230,264,144,688,66
28091,930,638,128,272,179,59,156,301,88,93,292,26,82,65,119,264,28
28092,13337,9932,2441,4587,2415,489,3589,4507,1095,741,3405,551,1051,1181,622,2929,476
28097,1151,915,197,448,219,51,350,451,63,51,236,37,86,70,43,207,29
28098,1100,759,176,309,208,66,221,320,89,129,341,41,130,91,79,306,35
28101,198,158,17,82,50,9,35,84,20,19,40,2,16,10,12,37,3
28102,42,33,3,11,16,3,6,19,5,3,9,0,3,5,1,9,0
28103,3391,2570,574,1234,609,153,1016,1118,242,194,821,165,213,269,174,710,111
28104,6650,5721,1067,3371,1178,105,2613,2474,394,240,929,195,392,232,110,773,156
28105,11694,8874,1704,5290,1537,343,4182,3692,659,341,2820,1085,886,506,343,2190,630
28107,1917,1483,288,698,431,66,538,706,129,110,434,70,127,127,110,321,113
28109,20,20,15,5,0,0,15,5,0,0,0,0,0,0,0,0,0
28110,12847,9977,3116,4507,2075,279,3849,3954,1245,929,2870,715,871,780,504,2429,441
28112,8031,6226,1438,2887,1605,296,2162,2813,713,538,1805,338,406,639,422,1545,260
28114,2750,2106,514,906,512,174,708,969,237,192,644,99,169,226,150,600,44
28115,9615,6908,1748,3332,1429,399,2653,2766,971,518,2707,716,737,731,523,2257,450
28117,7043,5564,948,2956,1472,188,2331,2719,317,197,1479,282,693,325,179,1236,243
28119,992,748,194,377,136,41,199,189,223,137,244,31,105,60,48,207,37
28120,6214,4546,938,2248,1103,257,1423,2261,466,396,1668,377,461,481,349,1430,238
28124,1992,1616,322,868,339,87,633,736,151,96,376,71,106,119,80,317,59
28125,777,569,105,297,122,45,293,235,18,23,208,69,49,63,27,176,32
28127,2456,1815,286,833,585,111,558,992,149,116,641,105,220,201,115,555,86
28128,2954,2184,434,1016,595,139,716,1048,243,177,770,99,198,261,212,691,79
28129,1957,1523,283,684,444,112,495,784,118,126,434,66,93,151,124,398,36
28133,1133,925,222,385,264,54,306,450,76,93,208,20,32,88,68,204,4
28134,2897,1883,730,862,247,44,678,726,325,154,1014,388,331,228,67,785,229
28135,1193,825,177,351,249,48,201,421,110,93,368,39,77,138,114,340,28
28137,1102,791,165,367,203,56,297,360,79,55,311,121,90,55,45,264,47
28138,3683,2849,761,1348,622,118,1129,1231,288,201,834,194,290,194,156,728,106
28139,6932,5103,1104,2259,1376,364,1840,2424,375,464,1829,323,533,492,481,1631,198
28144,10205,6380,1579,2735,1494,572,1599,2530,1302,949,3825,861,1142,979,843,3299,526
28146,9871,7430,1466,3647,1893,424,2406,3664,801,559,2441,434,863,680,464,2091,350
28147,8109,5932,1529,2926,1131,346,2274,2620,663,375,2177,580,717,588,292,1925,252
28150,11252,7870,1642,3310,2296,622,2102,3587,1225,956,3382,534,1052,934,862,3081,301
28152,8662,6271,1565,2728,1526,452,1953,2744,978,596,2391,445,849,633,464,2084,307
28159,1164,746,160,411,142,33,279,305,92,70,418,70,106,97,145,375,43
28160,1714,1099,199,468,354,78,276,500,150,173,615,90,160,191,174,573,42
28163,2405,1845,421,897,411,116,722,879,152,92,560,69,187,212,92,492,68
28164,4713,3694,734,1896,916,148,1278,1777,361,278,1019,205,330,335,149,877,142
28166,2478,1869,348,936,469,116,573,919,160,217,609,98,244,180,87,507,102
28167,867,617,111,311,152,43,227,280,20,90,250,7,95,93,55,208,42
28168,3524,2634,573,1283,677,101,1015,1176,245,198,890,106,339,254,191,794,96
28169,86,62,5,35,17,5,12,35,10,5,24,4,11,2,7,21,3
28170,4719,3383,673,1477,896,337,764,1301,669,649,1336,189,333,477,337,1230,106
28173,6056,5056,866,2944,1066,180,2451,2147,228,230,1000,221,377,290,112,816,184
28174,2279,1725,440,807,420,58,627,712,249,137,554,168,154,127,105,392,162
28202,2346,749,286,282,161,20,51,374,245,79,1597,637,387,390,183,1347,250
28203,4797,2271,736,1039,383,113,551,777,515,428,2526,922,909,407,288,2002,524
28204,2281,771,384,248,115,24,144,208,262,157,1510,595,567,196,152,1238,272
28205,19384,10813,3791,4484,1883,655,2741,3592,2343,2137,8571,3259,2946,1543,823,6625,1946
28206,4368,2887,970,1328,446,143,548,667,862,810,1481,352,547,410,172,1197,284
28207,3855,2047,200,1085,562,200,765,1069,110,103,1808,642,492,381,293,1505,303
28208,13094,8787,2762,3744,1855,426,1760,2116,2827,2084,4307,858,1983,1092,374,3518,789
28209,10096,4466,1187,2002,873,404,1147,2137,566,616,5630,2181,1609,997,843,4494,1136
28210,18537,10214,2260,4984,2264,706,3637,4598,989,990,8323,3377,2600,1513,833,6686,1637
28211,12007,7476,1486,3403,1901,686,2459,3640,881,496,4531,1454,1485,925,667,3641,890
28212,14849,8295,3204,3594,1212,285,2688,2723,1805,1079,6554,3084,2087,860,523,5038,1516
28213,9548,5960,2017,2806,1009,128,1978,1747,1174,1061,3588,1813,1310,316,149,2339,1249
28214,7930,5962,1244,2926,1490,302,2131,2689,672,470,1968,319,848,566,235,1621,347
28215,14859,10798,3149,5440,1895,314,4196,3865,1652,1085,4061,1280,1703,838,240,3192,869
28216,11026,7907,1828,3519,2037,523,2108,2855,1535,1409,3119,547,1204,916,452,2587,532
28217,6978,4725,1373,2180,1011,161,1254,1513,1067,891,2253,997,745,389,122,1748,505
28223,0,0,0,0,0,0,0,0,0,0,0,0,0,0,0,0,0
28226,14417,9684,1645,5168,2362,509,3931,4596,705,452,4733,1735,1444,950,604,3739,994
28227,15184,10818,2560,5646,2351,261,4192,4562,1241,823,4366,1429,1631,939,367,3463,903
28262,6947,3607,1326,1722,501,58,1454,1342,448,363,3340,2398,708,193,41,1888,1452
28269,16299,11098,3818,5704,1394,182,5116,4012,1185,785,5201,2416,1915,606,264,3852,1349
28270,9718,7360,1294,4396,1464,206,3401,3171,490,298,2358,899,758,539,162,1968,390
28273,7019,4745,1527,2538,575,105,1981,1720,543,501,2274,1006,1033,185,50,1634,640
28277,12790,9468,1822,5788,1634,224,4721,3988,467,292,3322,1520,1102,555,145,2576,746
28278,2467,1850,389,969,454,38,623,1007,143,77,617,185,291,96,45,466,151
28301,13362,8952,1877,3856,2526,693,2213,3230,1858,1651,4410,659,1561,1410,780,3882,528
28303,12987,8676,2474,3952,1906,344,2834,3499,1549,794,4311,1255,1433,1246,377,3477,834
28304,13484,10023,2772,4806,2072,373,3680,3907,1642,794,3461,924,1401,848,288,2875,586
28305,2903,1645,368,667,439,171,436,777,185,247,1258,226,389,317,326,1135,123
28306,11294,8274,2304,4118,1619,233,3022,3053,1379,820,3020,663,1020,948,389,2554,466
28307,4826,4720,3524,1196,0,0,3701,591,422,6,106,79,27,0,0,106,0
28311,12498,9001,2937,4250,1620,194,3316,3561,1403,721,3497,1200,1255,732,310,2808,689
28314,17254,12847,4515,6338,1789,205,5359,4235,2145,1108,4407,2006,1344,907,150,3337,1070
28315,3801,2640,626,1211,688,115,819,1131,401,289,1161,209,361,318,273,987,174
28318,1565,1198,319,522,300,57,396,499,163,140,367,83,89,126,69,330,37
28320,3677,2457,508,1137,699,113,785,1126,275,271,1220,179,263,523,255,1088,132
28323,926,637,154,290,148,45,214,246,69,108,289,61,110,86,32,261,28
28325,141,101,22,38,33,8,31,47,11,12,40,12,5,15,8,34,6
28326,3754,2884,1004,1371,424,85,1152,1070,485,177,870,224,310,257,79,705,165
28327,5262,3966,758,1717,1180,311,1305,1977,437,247,1296,180,459,384,273,1135,161
28328,9306,6628,1592,2895,1708,433,2028,2698,1025,877,2678,402,748,886,642,2411,267
28330,134,105,48,30,27,0,34,60,11,0,29,0,6,15,8,21,8
28332,222,155,47,57,35,16,43,67,35,10,67,2,27,28,10,63,4
28333,4076,3081,744,1599,636,102,997,1051,635,398,995,228,316,352,99,765,230
28334,9127,6299,1582,2768,1642,307,2056,2741,898,604,2828,429,763,1036,600,2455,373
28337,3591,2401,486,1089,573,253,593,947,489,372,1190,124,335,420,311,1101,89
28338,1848,1290,285,558,336,111,418,530,173,169,558,47,168,181,162,512,46
28339,2724,1884,317,969,460,138,543,768,276,297,840,142,175,359,164,707,133
28340,4132,3048,646,1532,729,141,803,1099,642,504,1084,117,290,446,231,978,106
28341,1569,1084,222,508,274,80,355,404,130,195,485,116,129,157,83,425,60
28342,93,63,13,32,18,0,29,20,5,9,30,8,5,7,10,27,3
28343,641,468,107,274,76,11,151,165,90,62,173,17,55,51,50,166,7
28344,1006,741,201,363,142,35,267,301,84,89,265,50,82,74,59,219,46
28345,4796,3361,861,1373,910,217,922,1298,646,495,1435,254,439,429,313,1276,159
28347,603,475,174,184,103,14,142,150,127,56,128,34,44,32,18,110,18
28348,9116,7098,2150,3667,1139,142,3138,2303,1227,430,2018,430,744,619,225,1615,403
28349,1186,893,196,436,205,56,264,355,129,145,293,43,99,99,52,259,34
28350,148,110,20,44,40,6,38,28,17,27,38,0,28,0,10,38,0
28351,1856,1344,373,608,329,34,387,547,270,140,512,122,186,130,74,431,81
28352,9432,6904,1662,3210,1699,333,2025,2593,1368,918,2528,489,773,846,420,2304,224
28356,1461,1112,244,577,259,32,370,507,146,89,349,71,122,113,43,294,55
28357,1023,820,165,444,184,27,239,285,179,117,203,42,42,89,30,151,52
28358,13526,9540,2578,4549,2015,398,2982,3265,2077,1216,3986,694,1133,1421,738,3500,486
28360,4290,3264,889,1623,681,71,1113,1045,662,444,1026,210,311,361,144,875,151
28362,36,18,0,9,5,4,5,6,2,5,18,4,8,0,6,11,7
28363,410,315,25,131,159,0,81,124,42,68,95,6,48,29,12,83,12
28364,4649,3596,948,1722,744,182,1193,1117,731,555,1053,122,443,351,137,946,107
28365,5609,3920,893,1781,936,310,1349,1544,448,579,1689,302,519,476,392,1462,227
28366,1847,1313,283,631,328,71,454,587,100,172,534,71,134,199,130,490,44
28367,19,12,0,8,4,0,4,4,4,0,7,0,0,4,3,7,0
28368,166,94,50,31,9,4,37,32,22,3,72,30,13,23,6,57,15
28369,1053,846,131,371,277,67,200,433,107,106,207,46,57,64,40,197,10
28371,1596,1221,289,675,237,20,526,413,182,100,375,64,143,117,51,324,51
28372,4197,3049,721,1428,740,160,909,959,666,515,1148,207,412,374,155,1010,138
28373,457,308,82,129,79,18,121,126,43,18,149,25,61,40,23,129,20
28374,5280,4019,245,976,1979,819,693,3087,115,124,1261,161,281,408,411,1174,87
28376,8687,6765,2391,2961,1143,270,2566,2233,1076,890,1922,525,761,371,265,1650,272
28377,4022,3023,686,1542,607,188,857,1033,664,469,999,183,301,329,186,824,175
28378,16,16,6,0,0,10,6,10,0,0,0,0,0,0,0,0,0
28379,10354,7293,1688,3228,1923,454,2054,2938,1308,993,3061,570,888,1033,570,2758,303
28382,2313,1677,402,757,431,87,560,728,218,171,636,60,206,263,107,559,77
28383,2680,2072,559,929,443,141,616,728,436,292,608,57,184,224,143,572,36
28384,3700,2757,615,1325,649,168,831,953,496,477,943,172,314,286,171,806,137
28385,1629,1299,270,616,332,81,461,598,114,126,330,45,113,97,75,299,31
28386,1696,1293,352,650,239,52,471,402,216,204,403,157,148,59,39,282,121
28387,5747,3607,556,1350,1153,548,909,1886,444,368,2140,474,519,619,528,1852,288
28390,7591,5349,2402,2228,626,93,1915,1598,1381,455,2242,731,839,560,112,1737,505
28391,1681,1317,240,699,322,56,473,580,133,131,364,55,139,107,63,310,54
28392,701,511,125,254,75,57,135,230,41,105,190,12,71,88,19,164,26
28393,730,537,110,237,133,57,160,210,88,79,193,50,36,68,39,163,30
28394,1659,1236,263,557,351,65,382,585,149,120,423,132,151,93,47,339,84
28395,845,627,120,323,154,30,229,279,55,64,218,25,55,100,38,187,31
28396,1017,702,154,288,231,29,194,326,92,90,315,48,155,78,34,279,36
28398,2639,1861,462,783,516,100,600,701,307,253,778,94,196,294,194,688,90
28399,805,581,83,322,152,24,148,221,123,89,224,56,20,87,61,193,31
28401,9624,4803,1379,1897,1033,494,829,1638,1406,930,4821,1305,1401,1175,940,3879,942
28403,13862,6291,1727,2510,1414,640,1651,2924,982,734,7571,4093,1707,943,828,5411,2160
28405,10442,7121,1487,3126,2004,504,2045,3456,975,645,3321,1162,839,989,331,2454,867
28409,10071,7880,1092,4161,2227,400,3163,3850,455,412,2191,468,677,827,219,1669,522
28411,6967,5084,1125,2430,1250,279,1874,2492,433,285,1883,587,671,361,264,1465,418
28412,10204,6464,1534,2869,1708,353,2014,3122,761,567,3740,1515,943,852,430,2795,945
28420,1379,1070,306,492,228,44,416,470,122,62,309,29,86,121,73,296,13
28421,564,430,93,211,90,36,143,182,59,46,134,9,45,52,28,121,13
28422,1870,1402,270,634,392,106,358,666,200,178,468,76,141,175,76,383,85
28423,769,571,112,259,145,55,203,217,67,84,198,29,54,82,33,177,21
28425,3267,2351,553,1075,599,124,740,1043,297,271,916,128,294,289,205,810,106
28428,2551,1410,201,597,504,108,371,841,74,124,1141,325,425,330,61,879,262
28429,2755,2102,430,1132,474,66,815,776,235,276,653,149,280,156,68,497,156
28430,807,587,119,272,162,34,155,279,73,80,220,15,53,105,47,211,9
28431,3002,2092,416,894,643,139,582,887,260,363,910,134,265,293,218,823,87
28432,595,467,156,172,129,10,197,196,46,28,128,13,30,43,42,121,7
28433,1942,1328,261,555,393,119,380,466,269,213,614,46,248,203,117,580,34
28434,746,552,113,245,159,35,136,239,113,64,194,31,85,47,31,166,28
28435,909,663,98,362,179,24,194,290,110,69,246,50,75,86,35,216,30
28436,618,488,112,218,136,22,198,197,45,48,130,22,40,41,27,126,4
28438,594,446,66,255,94,31,157,167,51,71,148,23,50,29,46,137,11
28439,718,484,89,226,123,46,139,188,85,72,234,19,52,92,71,220,14
28441,1301,984,282,343,307,52,286,439,116,143,317,60,97,87,73,262,55
28442,671,463,83,190,157,33,119,203,91,50,208,16,82,66,44,171,37
28443,4909,3734,516,1589,1322,307,1112,2166,180,276,1175,134,349,491,201,1017,158
28444,835,604,132,233,202,37,163,218,88,135,231,38,53,89,51,206,25
28445,1944,1292,300,499,429,64,349,672,189,82,652,160,215,191,86,485,167
28447,423,307,37,144,93,33,64,148,39,56,116,19,26,28,43,102,14
28448,425,309,94,122,66,27,80,144,49,36,116,17,58,32,9,116,0
28449,683,457,29,215,186,27,83,309,41,24,226,37,93,77,19,187,39
28450,923,642,152,280,157,53,218,303,59,62,281,42,81,113,45,270,11
28451,5968,4456,1205,2065,1073,113,1557,1706,746,447,1512,293,653,458,108,1176,336
28452,84,58,22,6,30,0,11,29,18,0,26,0,0,12,14,26,0
28453,1218,897,288,373,187,49,372,296,95,134,321,33,117,106,65,294,27
28454,957,730,156,327,190,57,202,301,87,140,227,39,101,58,29,194,33
28455,696,488,78,254,149,7,157,245,30,56,208,34,44,103,27,178,30
28456,1337,1054,210,483,295,66,291,468,178,117,283,47,94,85,57,260,23
28457,3000,2237,580,1073,518,66,758,1058,271,150,763,125,316,249,73,628,135
28458,2233,1571,297,774,393,107,492,620,253,206,662,92,198,206,166,571,91
28460,2266,1584,332,615,588,49,393,916,124,151,682,187,218,233,44,591,91
28461,3889,2838,357,1052,1264,165,673,1621,253,291,1051,155,271,407,218,926,125
28462,4357,3118,433,1286,1224,175,806,1793,296,223,1239,155,460,419,205,1061,178
28463,3086,2220,445,1012,620,143,627,903,390,300,866,94,288,271,213,764,102
28464,690,572,172,232,145,23,167,192,111,102,118,28,25,47,18,118,0
28465,3183,2166,218,756,1056,136,389,1544,122,111,1017,94,379,359,185,800,217
28466,3266,2280,450,1016,645,169,613,1086,325,256,986,85,297,374,230,902,84
28467,2426,1794,140,356,1002,296,211,1389,63,131,632,70,128,292,142,546,86
28468,1479,1097,54,366,558,119,148,808,66,75,382,15,102,196,69,347,35
28469,1952,1358,162,471,638,87,301,883,56,118,594,83,181,245,85,469,125
28470,2754,2026,400,800,721,105,507,1009,337,173,728,85,231,258,154,643,85
28471,810,620,130,281,180,29,236,263,43,78,190,11,72,83,24,179,11
28472,7372,5098,1077,2416,1299,306,1568,2060,923,547,2274,332,681,780,481,2091,183
28478,932,641,122,271,182,66,174,305,91,71,291,36,83,106,66,245,46
28479,1041,698,175,335,166,22,245,338,58,57,343,30,133,117,63,278,65
28480,1300,586,65,265,200,56,109,375,43,59,714,329,218,96,71,426,288
28501,9285,5658,1233,2544,1462,419,1163,2054,1428,1013,3627,305,1057,1278,987,3317,310
28504,8315,6014,1113,2899,1655,347,2021,2719,754,520,2301,460,718,811,312,1982,319
28508,606,462,178,212,52,20,298,96,25,43,144,13,42,54,35,138,6
28510,614,444,57,193,156,38,109,254,36,45,170,18,67,62,23,145,25
28511,361,276,51,109,78,38,55,166,35,20,85,9,8,29,39,85,0
28512,1859,1140,75,348,553,164,148,888,62,42,719,145,244,248,82,612,107
28513,3878,2771,617,1372,655,127,781,1197,491,302,1107,167,244,383,313,953,154
28515,1125,768,86,349,273,60,177,348,109,134,357,50,112,121,74,320,37
28516,4538,2969,440,1326,1014,189,757,1699,305,208,1569,216,496,521,336,1353,216
28518,2337,1714,408,853,363,90,615,736,167,196,623,119,120,256,128,542,81
28519,156,100,27,36,30,7,13,48,18,21,56,10,31,7,8,54,2
28520,119,111,24,41,46,0,71,33,0,7,8,0,0,0,8,8,0
28521,801,575,115,251,185,24,188,277,38,72,226,43,77,35,71,209,17
28523,1030,735,129,348,224,34,256,335,51,93,295,61,95,98,41,241,54
28524,184,123,27,50,31,15,29,47,26,21,61,10,8,26,17,50,11
28525,1143,854,225,397,149,83,352,330,97,75,289,31,103,60,95,208,81
28526,1044,762,111,328,283,40,178,370,89,125,282,30,103,84,65,235,47
28527,404,346,41,195,84,26,131,185,26,4,58,6,37,8,7,54,4
28528,216,166,23,101,8,34,65,83,18,0,50,6,44,0,0,26,24
28529,735,560,91,298,147,24,231,252,43,34,175,26,47,50,52,155,20
28530,2389,1761,363,857,423,118,514,758,265,224,628,78,215,224,111,544,84
28531,665,523,49,223,201,50,130,319,49,25,142,33,36,46,27,108,34
28532,8341,6741,3310,2578,706,147,3213,2435,847,246,1600,456,609,355,180,1300,300
28537,134,126,26,26,74,0,9,89,6,22,8,0,8,0,0,8,0
28538,900,737,148,356,166,67,234,274,135,94,163,38,30,46,49,150,13
28539,4499,3403,1349,1484,525,45,1665,1197,385,156,1096,431,334,228,103,815,281
28540,15726,11509,4432,4827,1854,396,4750,4182,1725,852,4217,1545,1348,921,403,3302,915
28543,1876,1852,1777,75,0,0,1288,371,193,0,24,14,10,0,0,10,14
28544,2362,1831,1238,409,167,17,880,597,265,89,531,256,161,96,18,391,140
28546,11458,8996,3367,3932,1522,175,3758,3448,1271,519,2462,891,760,577,234,2013,449
28547,1419,1393,704,683,6,0,1139,146,108,0,26,13,13,0,0,6,20
28551,4580,3327,774,1676,714,163,1074,1301,570,382,1253,224,418,421,190,1166,87
28552,137,84,14,48,22,0,14,55,8,7,53,0,7,6,40,53,0
28553,228,176,20,29,108,19,35,125,0,16,52,0,0,25,27,52,0
28554,199,140,50,46,44,0,51,48,36,5,59,8,22,19,10,51,8
28555,1699,1254,243,662,271,78,448,491,168,147,445,61,131,165,88,367,78
28556,444,309,52,136,110,11,96,177,11,25,135,11,50,50,24,111,24
28557,5809,3624,631,1670,1037,286,981,1824,504,315,2185,321,659,679,526,1899,286
28560,10739,7272,1595,3046,2021,610,1931,3368,1236,737,3467,663,1195,1035,574,2970,497
28562,11609,8394,1304,3522,2851,717,2559,4411,844,580,3215,498,959,1021,737,2836,379
28570,7023,5375,1153,2734,1295,193,1966,2449,617,343,1648,246,635,526,241,1376,272
28571,1171,810,43,211,446,110,103,556,40,111,361,37,89,156,79,329,32
28572,2268,1705,443,759,447,56,677,708,173,147,563,85,125,205,148,509,54
28573,809,549,90,296,116,47,196,198,67,88,260,9,77,124,50,242,18
28574,3834,2899,694,1346,741,118,1132,1275,234,258,935,186,268,294,187,818,117
28575,50,35,0,29,6,0,9,19,0,7,15,0,0,9,6,8,7
28577,118,94,40,14,33,7,47,37,0,10,24,0,16,8,0,24,0
28578,1510,1047,397,435,163,52,381,443,126,97,463,130,102,124,107,317,146
28579,144,122,5,69,48,0,31,50,18,23,22,5,8,0,9,22,0
28580,3506,2516,543,1183,665,125,800,881,423,412,990,140,255,335,260,924,66
28581,81,39,0,29,10,0,29,10,0,0,42,0,34,8,0,33,9
28582,466,270,45,123,102,0,98,103,20,49,196,29,51,98,18,166,30
28584,3335,2423,362,1006,853,202,675,1346,241,161,912,136,266,340,170,771,141
28585,1647,1208,206,610,313,79,407,449,170,182,439,42,150,173,74,385,54
28586,2482,1798,450,836,402,110,634,749,230,185,684,127,263,168,126,603,81
28589,143,125,26,62,37,0,37,80,8,0,18,0,0,9,9,18,0
28590,5398,3744,1148,1946,542,108,1490,1360,574,320,1654,627,462,388,177,1355,299
28594,1646,1125,93,432,506,94,220,778,59,68,521,69,189,207,56,431,90
28601,18649,12380,2889,5580,3187,724,4136,5731,1464,1049,6269,1788,1876,1573,1032,5267,1002
28602,10720,7526,1732,3639,1828,327,2473,3116,1095,842,3194,641,1094,928,531,2698,496
28604,2201,1393,189,698,423,83,452,723,112,106,808,321,199,206,82,603,205
28605,1462,918,88,400,315,115,223,577,88,30,544,105,191,136,112,442,102
28606,718,516,84,207,176,49,202,240,28,46,202,35,40,78,49,190,12
28607,10011,4967,1016,2271,1342,338,1615,2484,448,420,5044,3075,894,649,426,3067,1977
28609,2179,1707,405,823,423,56,590,827,135,155,472,69,136,140,127,442,30
28610,3243,2477,654,1213,574,36,895,1043,382,157,766,156,249,246,115,656,110
28611,227,196,35,88,60,13,64,100,18,14,31,7,8,7,9,31,0
28612,4663,3526,848,1595,951,132,1261,1562,311,392,1137,206,390,359,182,955,182
28613,7675,5563,1395,2476,1456,236,1938,2606,621,398,2112,429,832,531,320,1716,396
28615,816,578,108,270,155,45,176,260,92,50,238,14,112,67,45,234,4
28616,184,129,16,59,50,4,46,58,5,20,55,1,12,20,22,54,1
28617,956,750,84,364,246,56,252,385,29,84,206,34,13,98,61,171,35
28618,674,489,72,245,141,31,163,278,22,26,185,27,95,39,24,171,14
28619,542,335,67,146,93,29,86,142,55,52,207,36,61,54,56,178,29
28621,4166,2916,549,1406,727,234,836,1501,288,291,1250,148,276,429,397,1149,101
28622,1048,738,183,339,186,30,207,387,108,36,310,31,78,146,55,296,14
28623,715,522,94,236,168,24,164,314,11,33,193,25,37,74,57,184,9
28624,573,371,92,144,109,26,113,224,19,15,202,8,80,64,50,184,18
28625,11849,8952,1949,4208,2294,501,3260,4142,769,781,2897,568,886,912,531,2505,392
28626,722,542,95,281,134,32,207,290,5,40,180,52,77,41,10,158,22
28627,568,405,39,155,181,30,82,273,34,16,163,37,44,36,46,139,24
28629,19,13,0,13,0,0,7,0,0,6,6,0,0,0,6,6,0
28630,6805,5111,1407,2192,1317,195,1817,2360,516,418,1694,245,615,492,342,1467,227
28631,238,144,20,67,31,26,46,87,0,11,94,5,32,35,22,84,10
28634,1989,1467,335,707,342,83,492,685,141,149,522,75,203,134,110,460,62
28635,1316,1028,258,408,284,78,308,545,106,69,288,43,83,93,69,274,14
28636,1837,1328,383,537,319,89,498,664,114,52,509,61,220,144,84,464,45
28637,623,427,88,176,137,26,112,226,39,50,196,48,47,49,52,169,27
28638,4793,3572,874,1655,920,123,1127,1757,424,264,1221,284,448,282,207,983,238
28640,1687,1174,186,444,396,148,297,682,105,90,513,96,122,189,106,459,54
28642,2339,1625,376,656,493,100,451,824,192,158,714,122,198,212,182,658,56
28643,1340,989,167,401,311,110,281,544,58,106,351,47,112,124,68,330,21
28644,700,500,83,223,152,42,150,305,22,23,200,30,33,66,71,161,39
28645,18636,13437,2967,5822,3750,898,3706,6583,1765,1383,5199,895,1621,1668,1015,4552,647
28646,106,86,0,45,31,10,0,76,0,10,20,0,7,3,10,20,0
28649,395,301,61,122,97,21,142,146,8,5,94,9,47,19,19,79,15
28650,3993,2969,675,1369,793,132,931,1382,322,334,1024,155,415,274,180,890,134
28651,2402,1819,407,897,450,65,559,938,158,164,583,81,251,115,136,491,92
28654,1110,857,116,467,231,43,322,444,65,26,253,75,76,43,59,195,58
28655,20915,14771,3360,6727,3837,847,4883,6681,1785,1422,6144,1149,2145,1786,1064,5339,805
28657,4122,2989,589,1222,862,316,855,1580,230,324,1133,197,253,347,336,1013,120
28658,9553,6969,1633,3142,1725,469,2263,3196,884,626,2584,430,745,773,636,2163,421
28659,8798,6135,1450,2519,1680,486,1916,2974,641,604,2663,494,702,1022,445,2402,261
28660,610,487,158,169,150,10,204,216,43,24,123,16,41,34,32,104,19
28662,28,15,0,0,15,0,0,15,0,0,13,0,6,7,0,13,0
28663,262,179,35,59,72,13,47,116,10,6,83,0,32,45,6,60,23
28665,1090,789,218,344,175,52,277,382,49,81,301,54,87,95,65,260,41
28666,249,180,61,85,34,0,74,46,48,12,69,16,24,16,13,69,0
28668,50,43,0,6,19,18,6,37,0,0,7,0,0,0,7,7,0
28669,1177,888,218,385,258,27,308,473,38,69,289,65,103,84,37,266,23
28670,1167,874,211,373,195,95,304,430,76,64,293,47,60,97,89,278,15
28671,189,141,26,74,30,11,46,71,19,5,48,2,10,20,16,45,3
28673,1694,1228,193,581,361,93,398,688,67,75,466,70,216,86,94,402,64
28675,2628,1725,344,734,518,129,551,850,115,209,903,88,200,370,245,813,90
28676,1302,954,206,416,282,50,318,497,27,112,348,36,102,135,75,339,9
28677,12595,8615,2163,3657,2145,650,2464,3713,1482,956,3980,726,1367,1098,789,3456,524
28678,1773,1393,302,645,364,82,486,646,147,114,380,61,163,85,71,303,77
28679,629,472,65,224,141,42,179,231,28,34,157,43,45,31,38,137,20
28681,9475,7037,1606,3318,1744,369,2423,3308,731,575,2438,469,863,707,399,2089,349
28682,359,282,11,149,112,10,82,168,19,13,77,5,45,8,19,50,27
28683,691,522,137,235,137,13,274,241,7,0,169,17,32,91,29,151,18
28684,918,688,146,272,194,76,237,376,28,47,230,41,46,71,72,207,23
28685,762,576,164,241,149,22,239,268,37,32,186,28,49,79,30,173,13
28689,731,541,77,289,133,42,181,326,6,28,190,56,53,43,38,174,16
28690,3984,2650,481,1105,849,215,767,1320,315,248,1334,178,398,453,305,1222,112
28692,1491,1017,201,490,268,58,340,539,63,75,474,151,137,99,87,378,96
28693,734,549,123,215,188,23,169,298,37,45,185,19,52,67,47,178,7
28694,2957,2026,333,887,612,194,555,1096,206,169,931,193,239,258,241,829,102
28697,5117,3724,817,1659,978,270,1287,1780,281,376,1393,239,431,443,280,1303,90
28698,952,714,156,295,193,70,233,345,88,48,238,29,112,53,44,219,19
28701,1201,945,179,450,252,64,405,391,61,88,256,49,76,105,26,223,33
28702,16,0,0,0,0,0,0,0,0,0,16,0,16,0,0,16,0
28704,6100,4309,818,2315,981,195,1485,2004,590,230,1791,387,724,487,193,1488,303
28705,2436,1784,321,667,626,170,514,1013,77,180,652,68,177,242,165,596,56
28707,13,8,0,8,0,0,8,0,0,0,5,0,0,5,0,0,5
28708,248,148,58,59,31,0,70,45,19,14,100,0,29,49,22,95,5
28709,621,466,104,209,133,20,161,195,61,49,155,34,47,58,16,141,14
28710,66,58,16,19,23,0,19,32,0,7,8,0,0,8,0,8,0
28711,5025,3238,550,1406,922,360,898,1679,336,325,1787,282,557,518,430,1529,258
28712,7433,5072,742,1797,1946,587,1311,2888,474,399,2361,337,626,782,616,2066,295
28713,3614,2500,423,986,854,237,682,1364,208,246,1114,171,327,338,278,1022,92
28714,6629,4718,853,2070,1383,412,1422,2522,413,361,1911,265,436,669,541,1716,195
28715,8906,6433,1315,2995,1718,405,2028,3126,740,539,2473,445,818,789,421,2126,347
28716,7035,5069,1095,1934,1587,453,1675,2524,341,529,1966,274,558,687,447,1765,201
28717,649,394,35,130,201,28,83,243,28,40,255,23,118,61,53,194,61
28718,141,113,28,44,24,17,51,62,0,0,28,0,0,19,9,28,0
28719,2052,1574,273,871,369,61,453,469,415,237,478,90,150,182,56,442,36
28721,3442,2464,459,1064,790,151,788,1269,247,160,978,217,285,315,161,850,128
28722,2448,1593,243,512,501,337,380,1043,80,90,855,58,238,250,309,741,114
28723,2811,1543,274,685,470,114,456,825,142,120,1268,687,272,219,90,830,438
28725,48,25,0,16,8,1,11,13,0,1,23,9,6,4,4,14,9
28726,1263,855,211,378,213,53,256,328,108,163,408,70,112,115,111,367,41
28729,1253,892,117,306,307,162,183,573,86,50,361,34,58,154,115,329,32
28730,3075,2444,393,1220,696,135,864,1174,251,155,631,98,260,193,80,546,85
28731,2613,1893,317,737,703,136,533,1168,101,91,720,104,191,260,165,666,54
28732,4852,3640,773,1703,980,184,1356,1725,264,295,1212,241,437,326,208,1006,206
28733,10,0,0,0,0,0,0,0,0,0,10,10,0,0,0,10,0
28734,9893,6915,1100,2617,2462,736,1821,3859,713,522,2978,317,777,1033,851,2660,318
28735,46,33,0,12,21,0,0,25,6,2,13,7,6,0,0,13,0
28736,312,226,16,75,108,27,72,141,0,13,86,8,25,24,29,75,11
28739,7746,5438,835,1965,1888,750,1361,3310,435,332,2308,317,603,783,605,2108,200
28740,946,747,160,289,226,72,264,404,31,48,199,14,35,64,86,189,10
28741,1551,1041,98,387,421,135,248,659,81,53,510,80,137,170,123,433,77
28742,2445,1871,330,857,594,90,672,959,106,134,574,79,202,176,117,476,98
28743,1034,699,154,300,202,43,221,350,70,58,335,49,86,125,75,302,33
28745,289,197,5,43,114,35,32,159,6,0,92,0,12,42,38,81,11
28746,1012,709,57,262,318,72,131,495,31,52,303,68,77,102,56,237,66
28747,777,527,100,216,183,28,176,304,39,8,250,32,63,107,48,205,45
28748,3777,2819,722,1308,637,152,1045,1306,222,246,958,183,377,279,119,746,212
28749,7,0,0,0,0,0,0,0,0,0,7,0,0,7,0,7,0
28751,1382,925,97,351,380,97,172,640,62,51,457,36,151,166,104,384,73
28752,11460,8187,1796,3546,2264,581,2642,3946,890,709,3273,555,981,954,783,2933,340
28753,4276,2975,696,1254,777,248,918,1451,333,273,1301,180,376,469,276,1162,139
28754,2806,2017,405,878,583,151,593,1058,172,194,789,142,237,258,152,660,129
28755,84,53,13,23,9,8,16,33,0,4,31,0,20,5,6,27,4
28756,1613,1153,264,497,345,47,398,537,123,95,460,73,156,134,97,392,68
28757,95,48,0,23,19,6,15,30,3,0,47,11,8,9,19,45,2
28758,298,172,35,56,65,16,28,83,27,34,126,28,29,43,26,91,35
28761,2716,2046,426,1050,517,53,705,1010,176,155,670,95,190,224,161,568,102
28762,2520,1847,382,790,555,120,571,885,200,191,673,101,242,238,92,566,107
28763,1054,771,95,367,202,107,194,470,68,39,283,29,96,84,74,229,54
28765,23,18,0,18,0,0,10,0,8,0,5,0,5,0,0,5,0
28766,351,271,44,111,90,26,106,135,10,20,80,12,14,39,15,80,0
28768,2828,2155,274,900,817,164,542,1300,184,129,673,74,208,219,172,609,64
28771,3365,2430,499,921,785,225,723,1301,195,211,935,95,225,369,246,868,67
28772,448,335,78,149,82,26,122,134,52,27,113,11,42,35,25,99,14
28773,1118,823,126,351,309,37,230,495,42,56,295,61,118,74,42,258,37
28774,345,249,24,75,145,5,74,175,0,0,96,17,13,35,31,71,25
28777,3931,2815,554,1263,790,208,975,1403,239,198,1116,128,276,484,228,1026,90
28778,3481,2405,482,1159,597,167,828,1091,280,206,1076,146,372,319,239,935,141
28779,5931,3906,833,1631,1144,298,1101,1963,469,373,2025,488,537,618,382,1716,309
28781,396,268,65,75,107,21,79,151,24,14,128,0,22,74,32,128,0
28782,2809,1851,201,715,659,276,486,1103,135,127,958,74,302,298,284,881,77
28783,548,397,125,103,107,62,126,210,28,33,151,31,42,50,28,118,33
28784,54,42,0,29,6,7,29,0,6,7,12,5,0,0,7,12,0
28786,10965,7500,1245,3086,2471,698,1961,4046,794,699,3465,528,933,1154,850,3085,380
28787,6656,4947,938,2436,1213,360,1730,2424,414,379,1709,344,537,560,268,1483,226
28789,2058,1537,283,712,444,98,426,775,189,147,521,88,177,164,92,402,119
28790,951,703,148,326,145,84,260,323,60,60,248,13,79,128,28,212,36
28791,5489,3887,344,1347,1417,779,878,2533,194,282,1602,118,350,559,575,1506,96
28792,11039,7557,1711,3083,2085,678,2199,3814,971,573,3482,398,1003,1077,1004,2980,502
28801,6226,2629,713,1167,533,216,556,822,761,490,3597,1081,1152,906,458,2899,698
28803,10476,6470,1033,2905,1726,806,1896,3238,734,602,4006,939,1156,914,997,3428,578
28804,7962,5017,718,2196,1537,566,1513,2655,443,406,2945,770,851,809,515,2347,598
28805,7148,4121,699,1802,1269,351,1218,2100,430,373,3027,620,992,812,603,2506,521
28806,13941,8879,2265,3695,2149,770,2480,3961,1353,1085,5062,1317,1641,1260,844,4091,971
28901,2255,1550,277,617,517,139,447,847,125,131,705,58,162,267,218,647,58
28902,343,250,20,135,64,31,74,132,20,24,93,0,33,42,18,70,23
28904,3285,2325,337,886,882,220,614,1390,158,163,960,108,223,323,306,899,61
28905,1126,849,164,363,264,58,247,498,60,44,277,67,80,67,63,237,40
28906,6920,4991,928,1859,1752,452,1379,2778,407,427,1929,155,589,676,509,1768,161
28909,214,163,16,88,48,11,60,82,5,16,51,10,30,7,4,38,13
29001,792,619,87,343,142,47,220,200,79,120,173,23,75,54,21,152,21
29003,2715,1924,349,899,511,165,528,673,335,388,791,110,243,254,184,741,50
29006,3736,2643,600,1148,705,190,902,1104,362,275,1093,240,291,330,232,947,146
29009,922,633,78,301,221,33,155,323,80,75,289,33,97,87,72,266,23
29010,4518,3219,639,1535,836,209,896,1118,628,577,1299,141,480,451,227,1193,106
29014,672,521,74,241,186,20,220,218,42,41,151,18,65,63,5,128,23
29015,630,450,100,172,134,44,82,150,102,116,180,12,84,30,54,163,17
29016,3753,2930,398,1788,663,81,1118,1300,282,230,823,151,339,232,101,663,160
29018,1515,1123,220,519,308,76,310,357,207,249,392,31,112,174,75,371,21
29020,8582,6024,1103,2636,1606,679,1613,2574,893,944,2558,245,795,921,597,2319,239
29030,866,612,80,278,192,62,136,301,81,94,254,27,78,59,90,216,38
29031,503,362,50,229,81,2,128,139,51,44,141,11,36,64,30,130,11
29032,1436,1115,308,595,191,21,478,358,154,125,321,69,91,113,48,256,65
29033,5111,3129,600,1380,893,256,831,1310,493,495,1982,596,664,389,333,1517,465
29036,4682,3786,393,1997,1140,256,1421,2001,196,168,896,57,310,358,171,798,98
29037,375,282,59,108,100,15,46,149,29,58,93,15,17,40,21,73,20
29038,941,719,140,370,170,39,282,250,98,89,222,23,71,85,43,196,26
29039,1341,1063,234,563,229,37,366,404,190,103,278,47,104,92,35,216,62
29040,2476,1928,459,976,409,84,643,727,370,188,548,103,199,167,79,462,86
29042,2213,1512,361,652,408,91,340,448,432,292,701,53,263,249,136,642,59
29044,2132,1589,268,834,419,68,436,609,317,227,543,83,224,161,75,484,59
29045,4876,3834,941,2075,720,98,1618,1428,531,257,1042,179,528,243,92,834,208
29046,101,73,6,42,15,10,11,25,14,23,28,6,8,9,5,25,3
29047,1569,1044,158,421,366,99,237,484,150,173,525,33,152,214,126,486,39
29048,1857,1325,179,639,409,98,389,523,224,189,532,38,183,220,91,484,48
29051,328,237,36,115,67,19,89,77,38,33,91,15,22,31,23,91,0
29052,742,603,77,353,114,59,160,202,90,151,139,7,55,58,19,117,22
29053,5739,4376,1276,2214,779,107,1580,1611,885,300,1363,360,613,343,47,986,377
29054,2971,2346,487,1145,629,85,825,1200,220,101,625,99,245,204,77,512,113
29055,1914,1390,311,594,385,100,332,551,268,239,524,84,146,146,148,491,33
29056,1063,729,130,304,254,41,220,270,107,132,334,8,130,115,81,315,19
29058,1802,1352,275,590,370,117,460,577,102,213,450,47,108,195,100,408,42
29059,2253,1643,282,816,440,105,490,584,280,289,610,69,196,196,149,560,50
29061,4604,3513,652,1901,844,116,1213,1193,592,515,1091,164,567,286,74,908,183
29062,28,13,0,13,0,0,0,13,0,0,15,0,8,7,0,15,0
29063,8544,6991,1799,4122,898,172,3456,2365,888,282,1553,471,700,281,101,1310,243
29065,276,153,19,80,36,18,33,67,38,15,123,6,38,54,25,111,12
29067,3455,2545,538,1124,704,179,817,1169,329,230,910,97,242,352,219,842,68
29069,1919,1372,251,668,354,99,365,593,177,237,547,87,152,235,73,470,77
29070,5028,3842,753,1888,1024,177,1335,1866,468,173,1186,205,369,405,207,1028,158
29072,11247,8709,1734,4897,1826,252,4045,3493,652,519,2538,692,949,572,325,2143,395
29073,11265,8374,2101,4501,1592,180,3341,3388,1034,611,2891,703,1117,728,343,2326,565
29074,231,157,21,20,96,20,8,133,0,16,74,12,33,29,0,68,6
29075,1039,781,133,360,247,41,205,400,92,84,258,41,73,86,58,243,15
29078,4591,3669,760,1898,878,133,1405,1532,444,288,922,128,396,291,107,790,132
29079,117,88,11,53,24,0,29,32,20,7,29,0,8,13,8,29,0
29080,1464,1081,170,531,298,82,283,369,128,301,383,32,97,142,112,353,30
29081,595,400,58,188,112,42,93,200,42,65,195,37,54,52,52,174,21
29082,231,161,19,100,17,25,35,79,27,20,70,4,19,6,41,66,4
29101,1007,779,136,400,197,46,236,325,112,106,228,25,95,64,44,190,38
29102,5944,4287,868,1975,1165,279,1247,1658,831,551,1657,228,496,587,346,1469,188
29104,686,526,29,266,168,63,103,154,109,160,160,6,57,64,33,151,9
29105,442,341,101,167,61,12,121,136,54,30,101,29,33,22,17,96,5
29107,1213,860,218,360,237,45,295,371,98,96,353,43,114,124,72,318,35
29108,7376,5106,1176,2261,1277,392,1442,1894,921,849,2270,422,642,607,599,2034,236
29111,570,431,69,182,148,32,133,187,55,56,139,13,28,71,27,125,14
29112,1846,1305,249,628,342,86,384,543,204,174,541,77,147,192,125,486,55
29113,600,446,65,215,138,28,139,190,42,75,154,16,50,51,37,124,30
29114,745,572,152,249,117,54,185,158,90,139,173,17,58,62,36,162,11
29115,11882,7653,1731,3478,1819,625,1873,2413,1812,1555,4229,1038,1088,1431,672,3512,717
29118,5221,3886,688,2048,950,200,1320,1627,578,361,1335,302,320,481,232,1197,138
29122,29,18,4,6,6,2,4,7,4,3,11,2,2,5,2,11,0
29123,2212,1720,500,911,288,21,749,641,215,115,492,74,140,203,75,410,82
29124,57,39,10,14,10,5,11,8,9,11,18,2,8,6,2,18,0
29125,1310,920,146,387,274,113,195,380,164,181,390,19,128,183,60,369,21
29126,894,651,156,248,173,74,196,301,65,89,243,52,55,82,54,207,36
29127,3011,2262,363,1099,651,149,617,1189,233,223,749,77,222,284,166,686,63
29128,2062,1457,241,744,390,82,392,473,329,263,605,59,175,203,168,550,55
29129,1010,755,132,371,185,67,225,303,127,100,255,42,80,85,48,215,40
29130,1969,1480,198,731,461,90,421,692,161,206,489,78,143,217,51,461,28
29132,21,21,8,7,6,0,8,7,0,6,0,0,0,0,0,0,0
29133,395,312,73,104,107,28,93,114,39,66,83,3,26,23,31,80,3
29135,3658,2666,503,1292,678,193,845,1014,369,438,992,119,319,333,221,865,127
29137,1040,737,167,303,221,46,171,337,113,116,303,21,114,108,60,267,36
29138,3599,2704,678,1153,719,154,810,1044,428,422,895,149,202,305,239,767,128
29142,1765,1350,167,570,475,138,239,576,279,256,415,41,147,140,87,365,50
29145,372,252,55,123,61,13,78,109,36,29,120,20,46,26,28,93,27
29146,759,538,102,215,169,52,121,222,86,109,221,32,48,81,60,204,17
29148,2551,1791,265,635,715,176,332,864,270,325,760,66,250,293,151,673,87
29150,14803,10052,2125,4734,2310,883,2675,3606,2056,1715,4751,808,1232,1458,1253,4328,423
29152,1621,1511,1021,490,0,0,1048,294,144,25,110,88,22,0,0,102,8
29153,5182,3948,858,1807,967,316,1219,1589,650,490,1234,215,441,409,169,1106,128
29154,9024,6955,1743,3523,1515,174,2740,2757,945,513,2069,553,740,591,185,1677,392
29160,2710,1939,440,926,473,100,706,754,255,224,771,107,315,247,102,641,130
29161,3929,3101,745,1396,792,168,1011,1207,443,440,828,134,259,242,193,755,73
29162,950,723,178,315,190,40,208,297,108,110,227,17,45,112,53,223,4
29163,758,555,67,311,144,33,147,204,97,107,203,18,45,82,58,193,10
29164,1589,1152,245,535,299,73,334,464,223,131,437,107,133,121,76,369,68
29166,395,278,36,171,61,10,86,143,30,19,117,13,7,63,34,112,5
29168,1208,937,199,466,230,42,280,344,179,134,271,75,60,114,22,230,41
29169,9249,5063,1387,1915,1264,497,1213,2375,838,637,4186,1184,1250,905,847,3326,860
29170,6955,5188,1153,2531,1301,203,1929,2193,625,441,1767,349,715,534,169,1378,389
29172,3356,2430,573,1232,584,41,807,984,362,277,926,251,290,279,106,785,141
29175,148,108,32,39,37,0,32,53,9,14,40,5,4,12,19,36,4
29177,0,0,0,0,0,0,0,0,0,0,0,0,0,0,0,0,0
29178,1645,1082,233,431,278,140,266,472,182,162,563,69,142,193,159,512,51
29180,5507,3996,893,1726,1111,266,1060,1596,803,537,1511,203,612,368,328,1354,157
29201,5740,1917,523,803,436,155,316,725,381,495,3823,1974,849,570,430,2728,1095
29202,0,0,0,0,0,0,0,0,0,0,0,0,0,0,0,0,0
29203,14685,10238,2317,4684,2598,639,1830,3236,2902,2270,4447,798,1816,1149,684,3851,596
29204,8916,4950,1026,2225,1197,502,1154,1728,1146,922,3966,674,1301,1208,783,3431,535
29205,11991,5341,1336,2486,1019,500,1603,2252,818,668,6650,3155,1872,975,648,4951,1699
29206,8605,5907,1466,2491,1265,685,2380,2335,774,418,2698,569,808,716,605,2330,368
29207,0,0,0,0,0,0,0,0,0,0,0,0,0,0,0,0,0
29209,10946,7403,1539,3587,1852,425,2315,2894,1217,977,3543,1189,1221,817,316,2857,686
29210,16589,8192,2631,3351,1789,421,1999,3295,1833,1065,8397,4557,2415,1080,345,6583,1814
29212,10598,7928,1441,4651,1573,263,3183,3390,905,450,2670,647,1018,659,346,2223,447
29223,16818,11889,2342,6374,2839,334,4127,4785,1854,1123,4929,1598,1877,1069,385,4159,770
29229,6053,5164,1273,3175,683,33,2671,1636,626,231,889,279,384,210,16,722,167
29301,11530,7955,1763,3734,2016,442,2378,3206,1285,1086,3575,904,1235,862,574,3070,505
29302,7032,4603,884,2160,1275,284,1628,2160,381,434,2429,637,875,484,433,2115,314
29303,9099,5736,1659,2325,1385,367,1561,2336,1031,808,3363,946,1030,931,456,2835,528
29306,6478,4222,1153,1700,1109,260,830,1256,1302,834,2256,253,732,720,551,2017,239
29307,8393,5516,1034,2507,1439,536,1632,2607,688,589,2877,601,805,694,777,2567,310
29316,5595,4427,1046,2088,1122,171,1717,1903,458,349,1168,365,383,317,103,976,192
29320,169,120,22,61,37,0,28,78,5,9,49,10,6,22,11,43,6
29321,984,743,168,326,228,21,252,363,73,55,241,43,97,72,29,223,18
29322,2902,2267,405,1110,651,101,903,1063,139,162,635,107,194,190,144,601,34
29323,5210,3926,849,1775,1077,225,1272,1859,383,412,1284,203,432,344,305,1119,165
29325,5699,3928,846,1775,1131,176,1053,1560,753,562,1771,310,557,528,376,1556,215
29330,3049,2209,498,1056,548,107,813,920,238,238,840,170,189,300,181,702,138
29332,1098,783,104,336,309,34,157,461,88,77,315,28,125,136,26,281,34
29334,3052,2337,641,974,645,77,778,959,385,215,715,186,271,152,106,596,119
29335,1705,1292,236,624,356,76,408,626,100,158,413,35,134,159,85,354,59
29338,6,0,0,0,0,0,0,0,0,0,6,0,0,6,0,6,0
29340,8247,5818,1433,2590,1476,319,1627,2452,984,755,2429,488,726,639,576,2138,291
29341,6496,4757,1198,2224,1071,264,1599,1940,718,500,1739,315,502,626,296,1569,170
29349,8929,6821,1603,3384,1569,265,2502,3107,725,487,2108,363,704,705,336,1849,259
29351,757,512,83,239,140,50,132,240,79,61,245,0,79,79,87,235,10
29353,1705,1227,265,559,340,63,391,554,151,131,478,59,149,163,107,438,40
29355,305,218,32,114,50,22,86,98,26,8,87,22,51,14,0,87,0
29356,3278,2279,336,1028,741,174,657,1220,215,187,999,127,300,350,222,886,113
29360,8553,5988,1420,2727,1440,401,1686,2328,1091,883,2565,421,643,988,513,2338,227
29364,246,173,51,53,69,0,65,51,22,35,73,3,16,20,34,73,0
29365,3196,2380,543,1057,617,163,808,1150,183,239,816,144,247,255,170,705,111
29369,3324,2739,452,1608,602,77,1103,1114,237,285,585,153,187,221,24,489,96
29370,321,254,43,118,76,17,65,92,21,76,67,7,12,9,39,61,6
29372,2139,1561,370,609,446,136,451,674,196,240,578,107,167,184,120,536,42
29373,86,55,0,37,6,12,17,17,3,18,31,5,5,17,4,31,0
29374,1312,1010,209,502,215,84,376,454,84,96,302,59,80,96,67,275,27
29375,8,8,0,0,0,8,0,8,0,0,0,0,0,0,0,0,0
29376,2107,1632,442,769,400,21,653,705,145,129,475,101,150,146,78,427,48
29377,86,68,27,33,8,0,55,0,5,8,18,7,0,0,11,18,0
29379,8155,5643,1163,2544,1400,536,1375,2413,995,860,2512,300,806,847,559,2321,191
29384,1691,1189,243,465,464,17,330,636,141,82,502,102,154,194,52,415,87
29385,2543,1848,490,819,511,28,503,707,333,305,695,115,269,193,118,571,124
29388,5219,3848,934,1823,878,213,1411,1680,385,372,1371,134,444,470,323,1232,139
29401,4687,1858,241,771,677,169,479,1075,178,126,2829,1500,406,415,508,2065,764
29403,9291,4558,1022,1804,1213,519,487,1044,1384,1643,4733,1939,1130,1032,632,3392,1341
29404,1225,1197,850,336,5,6,823,291,83,0,28,21,4,3,0,9,19
29405,10927,6837,1664,2846,1629,698,1228,1912,2151,1546,4090,788,1565,1199,538,3466,624
29406,14872,8955,2729,3898,1876,452,2405,3374,2124,1052,5917,2057,2027,1238,595,4559,1358
29407,16131,9170,1850,4013,2326,981,2478,4084,1310,1298,6961,2556,1821,1579,1005,5421,1540
29412,13317,8629,1397,4157,2425,650,2750,4131,821,927,4688,1487,1246,1195,760,3491,1197
29414,9568,6232,1211,3388,1389,244,2316,2655,700,561,3336,1505,1092,601,138,2396,940
29418,8685,5573,1488,2963,1022,100,1762,1867,1270,674,3112,1261,1185,566,100,2484,628
29420,5129,4119,1176,2239,683,21,1629,1162,931,397,1010,378,434,182,16,743,267
29423,0,0,0,0,0,0,0,0,0,0,0,0,0,0,0,0,0
29426,670,484,55,257,134,38,133,196,73,82,186,23,57,71,35,157,29
29429,1000,732,82,411,203,36,237,332,55,108,268,21,91,111,45,248,20
29430,32,27,11,8,8,0,14,8,5,0,5,0,0,5,0,5,0
29431,2132,1626,290,835,415,86,571,812,114,129,506,85,146,163,112,421,85
29432,1060,733,117,365,173,78,220,330,104,79,327,40,82,112,93,299,28
29434,225,176,26,107,30,13,54,46,52,24,49,12,22,15,0,31,18
29435,1409,1115,241,480,302,92,330,466,151,168,294,55,105,104,30,239,55
29436,1581,1191,139,540,443,69,382,438,211,160,390,35,152,150,53,357,33
29437,727,642,60,391,140,51,157,255,121,109,85,12,20,26,27,63,22
29438,1010,705,111,256,270,68,128,384,108,85,305,45,94,131,35,259,46
29439,929,437,52,230,132,23,101,268,35,33,492,204,201,63,24,306,186
29440,10350,7794,1466,3671,2088,569,2343,3171,1222,1058,2556,420,876,711,549,2248,308
29445,16022,12504,3963,6101,2231,209,5390,4510,1820,784,3518,1252,1260,784,222,2630,888
29446,542,374,90,155,102,27,128,115,43,88,168,16,67,63,22,149,19
29448,987,636,123,271,202,40,183,246,104,103,351,54,77,128,92,321,30
29449,2590,1976,218,992,642,124,510,843,239,384,614,62,246,192,114,520,94
29450,1048,799,113,402,238,46,268,290,122,119,249,11,117,97,24,230,19
29451,1950,1385,95,690,520,80,404,807,85,89,565,152,182,148,83,419,146
29452,202,156,31,73,52,0,55,73,19,9,46,0,20,20,6,46,0
29453,496,356,68,153,94,41,69,168,54,65,140,9,61,43,27,140,0
29455,5369,4061,600,1757,1452,252,1077,2105,375,504,1308,138,516,449,205,1076,232
29456,6215,4956,1283,2718,848,107,1996,1759,802,399,1259,376,433,348,102,970,289
29458,1039,753,84,366,235,68,224,286,96,147,286,8,112,112,54,251,35
29461,8660,6548,1202,3291,1711,344,2200,2907,940,501,2112,375,708,678,351,1878,234
29464,16059,10474,1937,5640,2350,547,4186,4492,985,811,5585,1855,1799,1225,706,4140,1445
29466,4645,3682,841,1992,770,79,1659,1521,288,214,963,335,375,204,49,778,185
29468,894,607,144,182,241,40,213,235,76,83,287,45,108,51,83,277,10
29469,307,271,17,158,85,11,73,134,32,32,36,0,0,25,11,36,0
29470,1516,1137,190,597,286,64,359,448,173,157,379,70,114,161,34,326,53
29471,650,454,77,229,121,27,167,194,46,47,196,12,34,102,48,187,9
29472,2638,2037,419,937,587,94,609,846,275,307,601,58,192,212,139,549,52
29474,629,485,120,169,168,28,149,240,63,33,144,28,58,34,24,133,11
29475,1009,705,194,322,148,41,254,263,76,112,304,33,65,129,77,300,4
29477,2568,1803,366,773,521,143,547,719,272,265,765,104,168,327,166,710,55
29479,2499,1810,383,855,433,139,556,603,372,279,689,74,250,247,118,615,74
29481,715,552,111,227,171,43,138,257,89,68,163,7,37,74,45,147,16
29482,802,485,32,297,124,32,200,211,43,31,317,91,125,67,34,243,74
29483,17222,13250,3314,6910,2592,434,4932,5063,2234,1021,3972,821,1328,1268,555,3324,648
29485,10319,8034,1562,4292,1896,284,3353,3204,945,532,2285,632,837,531,285,1882,403
29487,953,688,68,354,173,93,197,317,74,100,265,4,96,114,51,253,12
29488,8193,5946,1266,2771,1538,371,1831,2113,1151,851,2247,334,748,716,449,1947,300
29492,697,596,114,354,115,13,253,254,50,39,101,8,57,30,6,101,0
29493,59,42,6,20,11,5,18,21,2,1,17,0,3,4,10,16,1
29501,15669,10556,2297,5136,2587,536,3535,4398,1468,1155,5113,1448,1674,1239,752,4529,584
29505,7138,5498,1100,2769,1384,245,2201,2286,544,467,1640,348,589,445,258,1435,205
29506,7368,5322,1178,2420,1477,247,1254,1687,1274,1107,2046,383,740,590,333,1793,253
29510,4395,3222,699,1511,782,230,984,1236,653,349,1173,157,333,464,219,1076,97
29511,1647,1255,331,571,289,64,438,541,172,104,392,51,121,153,67,344,48
29512,6807,4726,1009,2234,1158,325,1208,1633,935,950,2081,285,629,799,368,1882,199
29516,271,186,53,61,64,8,66,74,12,34,85,11,25,22,27,71,14
29518,494,395,79,203,108,5,140,176,36,43,99,13,30,43,13,86,13
29519,70,43,9,10,17,7,0,12,7,24,27,0,15,9,3,27,0
29520,5484,3928,854,1924,890,260,1294,1346,734,554,1556,224,458,614,260,1473,83
29525,758,526,124,252,100,50,125,180,130,91,232,35,42,106,49,210,22
29526,11466,8356,1718,3860,2323,455,2597,3806,1013,940,3110,705,1026,1019,360,2416,694
29527,6500,4839,1342,2194,1109,194,1538,1766,942,593,1661,314,638,509,200,1416,245
29530,1017,737,181,340,176,40,249,304,94,90,280,74,80,90,36,254,26
29532,8132,5742,1351,2801,1328,262,1591,2056,1169,926,2390,256,834,740,560,2180,210
29536,6194,4429,1111,2013,1073,232,1295,1361,922,851,1765,258,611,574,322,1550,215
29540,1766,1278,380,540,335,23,378,407,265,228,488,75,138,204,71,401,87
29541,2950,2196,499,1121,498,78,747,868,313,268,754,116,320,218,100,662,92
29543,214,159,21,80,39,19,42,78,12,27,55,0,22,18,15,50,5
29544,1714,1219,301,572,273,73,508,495,99,117,495,80,152,207,56,411,84
29545,527,376,82,181,106,7,113,156,60,47,151,34,26,62,29,127,24
29546,1049,784,152,370,210,52,190,324,143,127,265,67,92,67,39,222,43
29547,842,671,184,250,205,32,213,273,100,85,171,23,59,65,24,171,0
29550,12224,8629,1828,4065,2243,493,2577,3412,1337,1303,3595,618,1177,1159,641,3154,441
29554,3852,2857,547,1337,743,230,979,1046,359,473,995,163,342,320,170,929,66
29555,2327,1776,328,891,455,102,583,586,334,273,551,79,196,169,107,486,65
29556,5256,3756,762,1707,1023,264,1074,1283,814,585,1500,144,576,521,259,1421,79
29560,4938,3605,853,1665,848,239,984,1090,771,760,1333,110,434,534,255,1228,105
29563,1081,737,123,345,211,58,192,288,118,139,344,13,125,128,78,317,27
29564,424,326,55,158,93,20,68,127,56,75,98,16,35,30,17,90,8
29565,2519,1831,395,907,421,108,555,610,349,317,688,93,226,212,157,631,57
29566,4994,3516,435,1319,1477,285,725,2123,287,381,1478,218,499,573,188,1184,294
29567,224,153,33,91,19,10,36,53,9,55,71,15,35,7,14,58,13
29568,2887,2172,513,890,647,122,616,850,411,295,715,187,256,201,71,599,116
29569,5239,3806,760,1775,1026,245,1163,1535,603,505,1433,261,527,414,231,1237,196
29570,1561,1131,261,555,247,68,359,407,188,177,430,58,154,134,84,398,32
29571,6237,4532,1001,2172,1044,315,1135,1682,989,726,1705,242,558,570,335,1562,143
29572,4021,2233,292,839,848,254,463,1465,153,152,1788,445,492,564,287,1409,379
29574,5033,3561,779,1608,1008,166,855,1360,728,618,1472,128,535,531,278,1329,143
29575,12773,8843,1206,3711,3263,663,2314,5084,897,548,3930,1119,1114,1167,530,3058,872
29576,7395,4797,661,1519,2110,507,880,3236,311,370,2598,369,820,937,472,2130,468
29577,12379,6763,1835,2892,1651,385,1924,3049,964,826,5616,1800,1900,1318,598,4038,1578
29579,6010,4075,1022,1895,1063,95,1502,1856,498,219,1935,915,680,278,62,1271,664
29580,530,418,46,244,119,9,159,125,56,78,112,12,32,60,8,103,9
29581,1795,1298,223,653,322,100,369,538,173,218,497,68,124,167,138,441,56
29582,5839,3434,497,1239,1368,330,594,2141,390,309,2405,469,789,794,353,1907,498
29583,1946,1486,263,706,428,89,392,694,174,226,460,48,166,161,85,414,46
29584,941,716,192,365,133,26,270,308,75,63,225,29,60,94,42,209,16
29585,4533,3328,377,1202,1459,290,739,2166,271,152,1205,144,414,447,200,1032,173
29589,46,36,11,8,9,8,10,10,7,9,10,0,3,7,0,10,0
29590,1110,874,150,481,151,92,248,207,265,154,236,5,93,95,43,228,8
29591,1952,1505,299,755,359,92,538,647,139,181,447,67,184,138,58,371,76
29592,377,262,50,133,62,17,61,84,55,62,115,9,59,30,17,105,10
29593,938,655,94,354,181,26,170,278,82,125,283,23,88,109,63,268,15
29594,27,14,0,6,3,5,0,6,4,4,13,0,5,6,2,13,0
29596,986,738,115,340,239,44,238,332,66,102,248,17,104,82,45,223,25
29601,4360,1815,327,850,458,180,421,589,368,437,2545,615,734,683,513,2208,337
29605,13025,8485,1905,3740,2204,636,2290,3226,1698,1271,4540,910,1504,1159,967,4027,513
29607,12288,7398,1877,3340,1714,467,2031,2964,1366,1037,4890,1635,1568,979,708,4133,757
29609,11346,7306,1788,3210,1687,621,2222,3396,945,743,4040,1038,1342,965,695,3362,678
29611,10976,7386,2068,3060,1782,476,1846,2986,1456,1098,3590,571,1203,1175,641,3021,569
29615,14229,8170,1604,3410,2445,711,2595,4347,632,596,6059,2646,1596,944,873,5028,1031
29617,9454,6497,1575,2699,1775,448,1859,2842,1017,779,2957,766,881,773,537,2487,470
29620,5315,3804,779,1836,961,228,1141,1605,606,452,1511,232,421,515,343,1368,143
29621,12689,9025,1815,4243,2331,636,3260,4063,1011,691,3664,747,1058,997,862,3228,436
29624,6348,4074,908,1730,1074,362,980,1452,890,752,2274,271,712,787,504,2021,253
29625,9710,6656,1509,2995,1633,519,1949,2993,921,793,3054,713,871,947,523,2575,479
29626,4787,3614,779,1651,1002,182,1036,1701,521,356,1173,259,369,360,185,1022,151
29627,6871,5077,1059,2311,1400,307,1553,2532,499,493,1794,231,478,685,400,1638,156
29628,1311,949,187,424,289,49,271,361,167,150,362,12,104,154,92,350,12
29630,4829,2882,672,1341,718,151,977,1281,327,297,1947,973,426,356,192,1334,613
29631,4976,2221,416,899,634,272,672,1088,236,225,2755,2048,273,168,266,1305,1450
29635,473,347,41,124,164,18,89,204,33,21,126,19,42,45,20,107,19
29638,1268,928,169,463,237,59,284,451,113,80,340,64,63,106,107,293,47
29639,481,313,86,113,82,32,95,145,43,30,168,33,48,59,28,149,19
29640,11465,8505,2052,3896,2036,521,2930,3708,943,924,2960,535,991,864,570,2514,446
29642,9278,7254,1582,3740,1703,229,2893,3341,556,464,2024,425,669,619,311,1722,302
29643,1016,730,108,354,215,53,194,373,66,97,286,56,107,108,15,238,48
29644,5953,4558,1256,2117,1001,184,1704,1855,648,351,1395,210,557,467,161,1219,176
29645,3927,3015,754,1423,750,88,1108,1310,254,343,912,211,247,301,153,733,179
29646,10824,7427,1824,3396,1711,496,2051,2794,1556,1026,3397,714,851,1059,773,2910,487
29649,9039,6054,1553,2658,1466,377,1970,2723,857,504,2985,820,806,802,557,2431,554
29650,9085,6720,1264,3766,1460,230,2826,2918,599,377,2365,751,713,560,341,2039,326
29651,12798,9534,2172,4459,2309,594,3474,4048,1077,935,3264,506,1008,1045,705,2855,409
29653,1758,1387,276,601,415,95,462,648,140,137,371,44,143,115,69,333,38
29654,4042,2959,719,1291,779,170,961,1339,328,331,1083,121,254,344,364,988,95
29655,2914,2049,454,859,607,129,620,1033,185,211,865,102,207,321,235,763,102
29656,129,51,32,0,0,19,14,0,18,19,78,16,28,28,6,62,16
29657,5448,4111,1031,1926,943,211,1651,1816,409,235,1337,253,514,388,182,1151,186
29658,95,67,27,21,14,5,12,33,12,10,28,12,0,16,0,16,12
29659,62,52,16,22,14,0,14,24,8,6,10,4,3,2,1,10,0
29661,2228,1606,374,785,391,56,597,722,134,153,622,128,162,241,91,495,127
29662,5339,3744,949,1741,937,117,1362,1652,394,336,1595,429,617,320,229,1392,203
29664,618,421,54,189,161,17,127,235,21,38,197,20,95,48,34,176,21
29665,18,6,0,0,6,0,0,6,0,0,12,0,0,0,12,12,0
29666,2578,1822,421,815,488,98,580,799,234,209,756,47,213,309,187,681,75
29667,97,82,37,22,16,7,25,32,14,11,15,0,8,5,2,15,0
29669,4299,3198,674,1508,822,194,1167,1492,248,291,1101,175,344,366,216,937,164
29670,3026,2078,443,918,566,151,561,1008,278,231,948,277,299,189,183,815,133
29671,7118,5222,1093,2309,1438,382,1763,2556,542,361,1896,351,493,678,374,1738,158
29672,3979,2852,409,1121,1133,189,806,1651,214,181,1127,325,358,275,169,995,132
29673,8249,6311,1336,3094,1586,295,2172,2826,841,472,1938,288,673,705,272,1708,230
29676,2276,1754,154,421,990,189,277,1312,93,72,522,54,160,154,154,481,41
29677,87,56,7,16,33,0,7,38,6,5,31,0,0,18,13,31,0
29678,7806,5322,1236,2272,1463,351,1555,2451,766,550,2484,713,646,762,363,2112,372
29680,6910,5465,1620,2971,699,175,2647,1948,527,343,1445,478,631,267,69,1180,265
29681,10791,8678,1771,4849,1775,283,4062,3417,677,522,2113,452,924,521,216,1787,326
29682,1235,951,233,411,243,64,344,468,81,58,284,61,99,99,25,249,35
29683,113,91,27,52,0,12,21,36,19,15,22,0,22,0,0,22,0
29684,1593,1262,308,571,312,71,440,534,149,139,331,65,98,130,38,284,47
29685,446,329,55,103,150,21,85,195,34,15,117,16,68,20,13,99,18
29686,386,298,76,78,135,9,70,180,34,14,88,6,23,40,19,67,21
29687,13945,10004,2193,4867,2442,502,3651,4304,1151,898,3941,984,1371,1020,566,3377,564
29688,0,0,0,0,0,0,0,0,0,0,0,0,0,0,0,0,0
29689,1558,1162,224,539,346,53,306,644,140,72,396,71,146,129,50,334,62
29690,6330,4927,1152,2440,1130,205,1792,2068,607,460,1403,236,463,409,295,1219,184
29691,4429,3217,766,1432,840,179,1068,1469,426,254,1212,104,401,447,260,1141,71
29692,2029,1370,290,596,350,134,480,560,158,172,659,43,171,229,216,597,62
29693,5541,4064,910,1725,1178,251,1386,2006,378,294,1477,215,530,406,326,1311,166
29696,1281,1027,206,490,298,33,337,561,78,51,254,49,77,92,36,247,7
29697,4058,3134,825,1425,677,207,1123,1263,410,338,924,179,256,290,199,815,109
29702,3841,2763,695,1211,702,155,799,1196,457,311,1078,182,412,294,190,969,109
29704,1029,790,102,451,204,33,327,341,72,50,239,77,57,88,17,178,61
29706,8044,5836,1385,2649,1453,349,1550,2278,1147,861,2208,319,673,759,457,1975,233
29708,3836,3137,438,1855,784,60,1451,1442,161,83,699,133,281,252,33,603,96
29709,2412,1714,369,781,440,124,478,747,276,213,698,100,237,232,129,621,77
29710,8453,6382,1110,3120,1881,271,2156,3046,620,560,2071,394,770,505,402,1741,330
29712,842,617,118,312,141,46,233,253,81,50,225,31,101,80,13,187,38
29714,1052,785,188,356,210,31,263,308,112,102,267,72,97,81,17,220,47
29715,7591,5644,1257,2750,1354,283,2210,2436,600,398,1947,322,657,639,329,1687,260
29717,438,350,85,143,107,15,150,160,9,31,88,11,25,21,31,76,12
29718,1308,950,226,432,228,64,337,366,145,102,358,55,87,130,86,329,29
29720,17043,12296,2906,5719,2995,676,3682,5087,2170,1357,4747,846,1589,1509,803,4114,633
29724,44,36,7,25,0,4,32,0,0,4,8,0,0,8,0,8,0
29726,550,430,71,233,104,22,128,177,72,53,120,20,32,42,26,112,8
29727,498,391,107,162,94,28,144,162,48,37,107,16,38,46,7,78,29
29728,3392,2388,649,1047,588,104,832,771,395,390,1004,195,397,274,138,820,184
29729,692,517,90,311,89,27,169,200,103,45,175,10,66,73,26,163,12
29730,16812,11837,3038,5278,2875,646,3564,4475,2073,1725,4975,1526,1479,1207,763,3821,1154
29732,15103,10825,2388,5575,2387,475,4380,4665,1081,699,4278,1551,1315,867,545,3446,832
29741,745,472,108,208,120,36,166,187,42,77,273,50,99,88,36,254,19
29742,651,489,77,221,161,30,171,197,48,73,162,27,47,70,18,143,19
29743,416,339,94,176,60,9,136,147,24,32,77,18,28,23,8,64,13
29745,8090,6287,1469,3056,1433,329,2237,2423,876,751,1803,289,691,521,302,1463,340
29801,10021,6591,1362,3089,1647,493,1894,2428,1224,1045,3430,573,1069,962,826,2923,507
29803,11916,8822,1422,4457,2410,533,3071,4475,824,452,3094,796,1098,720,480,2684,410
29805,1789,1357,358,704,241,54,576,569,124,88,432,52,183,147,50,377,55
29809,993,700,79,339,246,36,169,384,67,80,293,37,105,120,31,267,26
29810,2103,1393,353,553,380,107,296,470,337,290,710,55,226,270,159,625,85
29812,4604,3365,775,1743,667,180,1087,1211,703,364,1239,227,321,394,297,1135,104
29816,452,316,59,134,84,39,83,140,22,71,136,30,26,54,26,133,3
29817,2008,1439,270,660,426,83,371,524,273,271,569,70,222,174,103,522,47
29819,466,360,78,154,123,5,133,178,25,24,106,22,14,65,5,97,9
29821,388,295,53,144,80,18,101,129,37,28,93,18,35,28,12,83,10
29822,185,116,23,54,28,11,24,44,31,17,69,10,39,5,15,44,25
29824,2597,1851,327,893,492,139,574,764,263,250,746,63,205,275,203,689,57
29826,22,14,2,10,2,0,2,10,2,0,8,0,5,3,0,8,0
29827,1401,947,213,460,212,62,177,335,233,202,454,41,133,173,107,430,24
29828,439,299,78,126,70,25,67,115,90,27,140,36,28,37,39,140,0
29829,2686,1981,434,914,522,111,609,809,367,196,705,105,177,307,116,626,79
29831,1709,1231,266,634,288,43,398,551,197,85,478,59,192,150,77,448,30
29832,2086,1545,313,740,358,134,425,593,297,230,541,54,163,174,150,514,27
29834,449,277,65,87,93,32,77,98,35,67,172,18,35,82,37,149,23
29835,2500,1846,283,674,747,142,300,983,316,247,654,46,210,260,138,613,41
29836,235,167,40,107,14,6,30,57,49,31,68,0,7,37,24,68,0
29838,185,130,0,49,64,17,29,81,0,20,55,4,11,22,18,55,0
29840,83,66,10,25,25,6,15,26,12,13,17,0,9,8,0,17,0
29841,12440,8432,1990,3944,1951,547,2809,3388,1291,944,4008,895,1355,1110,648,3499,509
29842,2399,1853,324,1002,424,103,602,665,374,212,546,70,279,142,55,478,68
29843,594,383,63,138,152,30,94,213,20,56,211,33,47,86,45,183,28
29844,104,81,32,24,20,5,17,53,8,3,23,3,3,11,6,20,3
29845,465,358,29,168,144,17,62,174,77,45,107,11,46,26,24,100,7
29846,34,19,4,7,6,2,3,14,0,2,15,0,0,7,8,15,0
29847,1391,1075,161,565,289,60,347,418,131,179,316,53,129,73,61,290,26
29848,364,276,51,102,93,30,77,148,22,29,88,2,40,25,21,61,27
29849,156,103,31,40,30,2,29,57,0,17,53,11,24,13,5,50,3
29850,26,26,0,26,0,0,7,19,0,0,0,0,0,0,0,0,0
29851,2714,1850,487,822,449,92,599,753,328,170,864,109,319,310,126,739,125
29853,2688,1895,428,891,480,96,536,742,371,246,793,87,226,290,190,715,78
29856,885,735,235,381,111,8,362,204,98,71,150,15,73,56,6,117,33
29860,3830,3191,636,1780,690,85,1407,1295,278,211,639,87,243,253,56,568,71
29902,9085,6430,1709,2878,1484,359,2323,2733,934,440,2655,624,907,612,512,2236,419
29906,6620,5435,2249,2316,759,111,2499,1526,894,516,1185,379,431,247,128,833,352
29910,7178,5435,1021,1932,2092,390,1563,3080,528,264,1743,311,551,699,182,1332,411
29911,684,532,108,224,180,20,189,250,50,43,152,27,45,44,36,136,16
29916,580,434,82,177,140,35,124,209,48,53,146,33,26,48,39,125,21
29918,1844,1338,330,621,324,63,392,441,279,226,506,54,158,183,111,457,49
29920,3775,2801,371,1120,1064,246,691,1475,325,310,974,115,273,412,174,882,92
29921,104,77,15,27,29,6,22,35,14,6,27,3,15,7,2,27,0
29922,309,220,31,117,28,44,66,66,55,33,89,11,25,27,26,67,22
29923,167,112,19,57,29,7,28,37,17,30,55,6,25,12,12,48,7
29924,1815,1243,255,542,335,111,367,527,200,149,572,78,167,204,123,534,38
29926,7644,5799,758,2034,2310,697,1433,3619,497,250,1845,299,580,474,492,1452,393
29927,2287,1669,481,752,376,60,618,507,312,232,618,75,186,238,119,514,104
29928,7790,5178,591,1701,2242,644,1103,3497,241,337,2612,482,740,716,674,2116,496
29929,489,325,39,175,105,6,123,159,30,13,164,0,27,83,54,156,8
29932,74,53,5,21,5,22,12,19,3,19,21,0,9,7,5,21,0
29934,423,339,54,160,65,60,114,94,43,88,84,20,29,24,11,71,13
29935,1463,884,390,330,147,17,331,305,140,108,579,221,181,95,82,472,107
29936,3643,2614,580,1179,629,226,818,1068,384,344,1029,149,330,401,149,912,117
29939,72,50,8,32,7,3,19,14,12,5,22,0,8,9,5,17,5
29940,1534,1152,242,608,206,96,330,347,286,189,382,32,125,145,80,338,44
29941,0,0,0,0,0,0,0,0,0,0,0,0,0,0,0,0,0
29943,118,86,0,44,42,0,9,38,10,29,32,0,7,25,0,32,0
29944,1730,1260,269,626,316,49,440,448,226,146,470,61,167,156,86,413,57
29945,1561,1103,152,584,329,38,291,437,181,194,458,46,132,186,94,414,44
30002,2337,1276,514,494,154,114,360,408,342,166,1061,310,437,188,126,751,310
30004,15769,11251,2441,6336,2072,402,5253,4594,773,631,4518,1484,1837,878,319,3589,929
30005,9377,7248,1541,4936,698,73,4379,2233,438,198,2129,913,896,265,55,1675,454
30008,10247,6986,2382,3426,943,235,2682,2168,1303,833,3261,1042,1357,593,269,2616,645
30011,3840,3133,980,1605,516,32,1621,1061,256,195,707,236,279,100,92,533,174
30012,8040,5944,1488,2798,1373,285,1989,2155,941,859,2096,328,812,611,345,1702,394
30013,6690,5240,1084,2632,1298,226,1960,2405,590,285,1450,434,566,350,100,1159,291
30014,9309,7071,1676,3178,1824,393,2314,2760,1118,879,2238,416,672,700,450,1920,318
30016,9251,7414,2191,3545,1396,282,3049,2834,899,632,1837,552,677,370,238,1456,381
30017,4011,3542,627,2178,646,91,1780,1385,247,130,469,94,164,156,55,393,76
30019,6532,5651,1219,3371,969,92,2793,2290,354,214,881,187,377,211,106,659,222
30021,8511,5470,2204,2697,498,71,1758,1127,1531,1054,3041,1488,1128,311,114,1967,1074
30022,19095,14672,2525,9986,1940,221,8129,4739,1177,627,4423,1654,1933,730,106,3443,980
30024,11532,9942,2357,6272,1199,114,5687,3425,513,317,1590,475,774,249,92,1169,421
30025,2500,1993,422,845,597,129,556,904,284,249,507,94,185,146,82,442,65
30030,11536,5350,1427,2506,1087,330,1503,2320,853,674,6186,2054,2148,935,1049,4592,1594
30032,19351,13810,3488,6749,3146,427,3080,3344,3752,3634,5541,1816,2219,1185,321,4259,1282
30033,12862,6036,1341,2591,1321,783,1857,3040,375,764,6826,2357,2182,1252,1035,5254,1572
30034,14966,11524,2453,6670,2108,293,3616,3331,2684,1893,3442,1066,1658,623,95,2806,636
30035,6578,4807,1127,2711,819,150,1330,1349,1233,895,1771,531,796,322,122,1396,375
30038,8206,6355,1438,3840,985,92,2481,1711,1319,844,1851,634,731,360,126,1506,345
30039,4345,3480,554,2249,598,79,1585,1268,443,184,865,263,329,163,110,691,174
30040,14848,12109,2770,6453,2492,394,5329,5234,726,820,2739,544,1007,771,417,2377,362
30041,11801,9544,2171,5308,1857,208,4414,4109,537,484,2257,424,1088,551,194,1803,454
30043,19535,16379,3598,10425,2043,313,9029,5263,1496,591,3156,1121,1433,480,122,2393,763
30044,22784,17260,4782,10050,2226,202,8439,5634,1871,1316,5524,2213,2264,751,296,4126,1398
30045,12782,9698,2606,5283,1489,320,4302,3380,1138,878,3084,766,1018,705,595,2486,598
30047,17919,14733,1791,9109,3512,321,6579,6069,1166,919,3186,563,1300,995,328,2511,675
30052,11973,10046,2565,5346,1854,281,4622,4116,811,497,1927,402,679,522,324,1593,334
30054,3141,2543,426,1350,680,87,794,1307,225,217,598,134,178,149,137,481,117
30055,759,608,144,263,174,27,191,323,45,49,151,10,81,40,20,123,28
30056,616,530,129,295,91,15,251,195,61,23,86,9,43,28,6,73,13
30058,19409,15066,3926,9131,1801,208,6441,3888,2936,1801,4343,1184,2279,642,238,3358,985
30060,13204,8282,2771,3440,1650,421,2474,2833,1646,1329,4922,1617,1676,958,671,3670,1252
30062,22043,17370,2732,10451,3829,358,7828,7162,1400,980,4673,1342,2232,841,258,3611,1062
30064,15471,11896,2191,6828,2390,487,5158,5024,990,724,3575,705,1435,796,639,2983,592
30066,17865,14255,2206,8684,2866,499,6428,5947,1067,813,3610,1160,1465,758,227,2715,895
30067,20564,10948,3806,5098,1705,339,3796,4197,1763,1192,9616,5049,3116,1140,311,6825,2791
30068,12034,9313,954,5462,2558,339,4039,4280,493,501,2721,617,1070,837,197,2198,523
30070,125,90,40,28,18,4,45,14,18,13,35,0,8,10,17,27,8
30071,6829,4752,1745,2316,626,65,1831,1446,720,755,2077,780,876,320,101,1437,640
30072,195,88,27,38,14,9,20,38,16,14,107,17,78,8,4,74,33
30075,16480,12795,1808,7802,2715,470,6201,5294,686,614,3685,931,1460,878,416,2787,898
30076,15783,10830,2576,5858,1998,398,4355,4576,965,934,4953,1785,1936,889,343,3711,1242
30078,9576,8062,1315,4867,1586,294,3629,3133,620,680,1514,340,501,398,275,1236,278
30079,974,650,203,251,147,49,126,117,260,147,324,39,148,118,19,258,66
30080,20241,9874,3756,4087,1621,410,2753,4031,1625,1465,10367,4973,3585,1274,535,7961,2406
30082,9337,6002,1684,2698,1230,390,1878,2545,955,624,3335,1081,1385,575,294,2675,660
30083,20111,13737,4193,7152,1984,408,4730,3455,3245,2307,6374,2453,2520,946,455,4943,1431
30084,12790,8643,1719,4284,2129,511,2769,3692,1003,1179,4147,1037,1649,1017,444,3235,912
30087,11264,9099,1271,5418,2011,399,3882,3737,779,701,2165,398,955,574,238,1766,399
30088,10183,7494,1755,4642,968,129,2639,1927,1858,1070,2689,1093,1085,452,59,2156,533
30092,13828,8947,2403,5023,1321,200,3987,3117,1115,728,4881,2329,1746,662,144,3730,1151
30093,17141,10740,4370,5041,1244,85,4428,3048,1906,1358,6401,3017,2691,594,99,4514,1887
30094,8908,7462,1099,4388,1615,360,3208,3054,690,510,1446,229,588,448,181,1224,222
30096,20945,13273,3974,7001,2059,239,5615,4787,1500,1371,7672,3186,3335,1007,144,5700,1972
30097,8159,6674,1172,4430,1000,72,3737,2313,403,221,1485,441,738,201,105,1186,299
30101,13719,10929,2962,6024,1701,242,5310,4079,966,574,2790,835,1017,697,241,2227,563
30102,10999,8848,2220,4917,1532,179,4024,3310,796,718,2151,385,1093,541,132,1568,583
30103,4085,3253,915,1451,712,175,1300,1455,291,207,832,88,326,302,116,743,89
30104,1457,1099,263,514,275,47,377,583,60,79,358,70,98,137,53,301,57
30105,897,705,146,325,193,41,275,322,60,48,192,33,54,80,25,164,28
30106,5649,4091,1216,1893,808,174,1417,1570,626,478,1558,472,555,372,159,1180,378
30107,2849,2295,524,1150,528,93,938,1018,170,169,554,98,190,182,84,460,94
30108,2945,2143,442,984,570,147,689,997,250,207,802,105,205,253,239,711,91
30110,4359,3196,721,1429,763,283,1108,1372,340,376,1163,149,431,349,234,1044,119
30113,2224,1596,408,602,502,84,484,782,190,140,628,92,236,192,108,560,68
30114,7938,5904,1542,2830,1284,248,2402,2550,572,380,2034,422,767,531,314,1587,447
30115,6998,5828,1269,3086,1321,152,2465,2647,386,330,1170,263,394,329,184,953,217
30116,6281,5062,1363,2508,1016,175,2047,2047,525,443,1219,253,392,408,166,993,226
30117,11734,7612,1985,3516,1717,394,2426,3012,1235,939,4122,1577,949,907,689,3154,968
30120,10692,8162,1967,3911,1835,449,3256,3217,802,887,2530,458,852,708,512,2198,332
30121,5546,4251,1204,1915,984,148,1669,1778,438,366,1295,345,387,390,173,1051,244
30122,6406,4350,1269,2003,933,145,1579,1766,624,381,2056,809,649,310,288,1539,517
30124,1131,875,230,349,242,54,280,466,66,63,256,24,60,114,58,256,0
30125,8317,6138,1541,2602,1601,394,2109,2534,724,771,2179,271,538,797,573,1912,267
30126,9827,7191,1589,3678,1587,337,2468,2948,970,805,2636,518,1115,612,391,2165,471
30127,15299,13068,2857,7823,2139,249,6116,4602,1458,892,2231,333,1043,648,207,1824,407
30132,6233,4806,1613,2078,962,153,2114,1894,526,272,1427,286,518,369,254,1170,257
30134,11205,8581,2906,4047,1360,268,3558,3120,1238,665,2624,690,923,627,384,2004,620
30135,14742,12136,2473,6963,2380,320,5088,4810,1315,923,2606,713,1082,624,187,2044,562
30137,415,335,67,146,99,23,84,187,25,39,80,16,33,20,11,64,16
30139,1283,993,186,497,253,57,322,517,71,83,290,69,86,100,35,229,61
30141,4420,3576,973,1926,587,90,1676,1336,334,230,844,146,348,254,96,692,152
30143,7159,5486,1056,2285,1818,327,1698,3021,404,363,1673,222,539,596,316,1493,180
30144,14824,10289,3000,5377,1659,253,4625,3777,992,895,4535,2116,1549,633,237,3201,1334
30145,2015,1637,475,792,293,77,742,649,114,132,378,72,148,99,59,313,65
30147,1760,1366,337,633,300,96,597,574,112,83,394,60,94,121,119,340,54
30148,177,135,16,97,14,8,18,100,17,0,42,0,32,0,10,42,0
30152,8792,7244,1412,4530,1107,195,3766,2639,467,372,1548,372,766,329,81,1251,297
30153,5343,4020,921,1923,947,229,1347,1591,606,476,1323,283,354,447,239,1163,160
30157,9537,8022,2615,4013,1301,93,3910,2986,683,443,1515,338,650,368,159,1219,296
30161,13070,9077,1889,4017,2420,751,2701,3834,1305,1237,3993,732,993,1281,987,3424,569
30165,13737,9693,2327,4329,2518,519,3322,4140,1249,982,4044,917,987,1160,980,3479,565
30168,7609,5139,1921,2351,727,140,1765,1446,1225,703,2470,1017,1066,238,149,1853,617
30170,1036,808,237,392,150,29,356,323,77,52,228,55,51,81,41,177,51
30171,1038,844,261,391,172,20,358,401,54,31,194,41,57,43,53,163,31
30173,2264,1827,445,866,446,70,735,791,120,181,437,114,149,84,90,410,27
30175,1676,1317,309,594,353,61,476,644,124,73,359,70,133,108,48,307,52
30176,2542,1888,481,729,565,113,635,826,234,193,654,101,152,231,170,594,60
30177,149,107,20,52,31,4,31,51,25,0,42,0,15,8,19,42,0
30178,1044,835,217,439,174,5,414,368,31,22,209,35,72,45,57,171,38
30179,3519,2788,798,1229,695,66,1095,1241,230,222,731,140,212,260,119,609,122
30180,6531,5059,1341,2239,1234,245,1925,2053,517,564,1472,269,584,404,215,1154,318
30182,878,730,195,343,158,34,281,295,100,54,148,29,46,49,24,115,33
30183,1330,1058,195,464,345,54,265,663,72,58,272,38,96,70,68,230,42
30184,1670,1397,296,732,304,65,537,653,111,96,273,69,78,88,38,217,56
30185,1394,1049,212,579,221,37,418,447,107,77,345,45,157,101,42,278,67
30187,2176,1813,265,1056,469,23,667,852,136,158,363,34,152,68,109,287,76
30188,12958,10138,2465,5870,1516,287,4605,4017,900,616,2820,708,1280,590,242,2255,565
30189,11414,9300,2263,5543,1417,77,4768,3495,624,413,2114,599,1030,396,89,1563,551
30204,4364,3225,662,1476,881,206,992,1271,498,464,1139,265,358,300,216,982,157
30205,928,805,100,469,207,29,343,343,51,68,123,32,35,40,16,119,4
30206,812,634,109,314,174,37,189,298,69,78,178,25,48,57,48,146,32
30213,5019,4072,874,1978,1011,209,1397,1696,519,460,947,184,337,299,127,788,159
30214,7901,6258,681,3339,1878,360,2405,3029,422,402,1643,209,626,464,344,1426,217
30215,8887,7656,991,4620,1771,274,3622,3175,461,398,1231,240,482,305,204,1003,228
30216,757,633,115,337,144,37,195,257,93,88,124,15,62,37,10,108,16
30217,3304,2470,647,1140,591,92,922,987,339,222,834,98,278,293,165,732,102
30218,636,499,90,251,149,9,144,200,59,96,137,34,40,26,37,121,16
30220,1096,832,141,407,233,51,284,310,118,120,264,40,86,74,64,228,36
30222,1531,1110,224,508,269,109,262,420,208,220,421,43,145,155,78,372,49
30223,12548,9186,2283,4203,2303,397,2584,3289,1754,1559,3362,521,1328,919,594,2780,582
30224,8104,5962,1277,2741,1552,392,1836,2647,802,677,2142,350,709,661,422,1892,250
30228,6931,5688,1450,2961,1142,135,2367,2176,708,437,1243,296,467,315,165,973,270
30230,3080,2249,564,968,501,216,743,982,256,268,831,61,319,275,176,748,83
30233,6495,4818,1070,2168,1329,251,1665,2039,557,557,1677,201,577,668,231,1444,233
30234,194,146,34,68,39,5,55,57,11,23,48,9,17,15,7,34,14
30236,15246,11257,2820,5646,2414,377,3837,4137,1985,1298,3989,1213,1515,915,346,3204,785
30238,10360,8124,2313,4356,1318,137,3097,2147,1906,974,2236,475,1160,495,106,1745,491
30240,9734,6993,1607,3312,1609,465,2306,2701,1162,824,2741,730,781,753,477,2388,353
30241,7391,5263,1249,2461,1157,396,1627,1762,969,905,2128,382,626,700,420,1829,299
30248,3733,3186,918,1636,583,49,1486,1165,235,300,547,111,212,130,94,458,89
30250,20,16,6,3,7,0,6,7,0,3,4,0,4,0,0,0,4
30251,759,611,194,238,153,26,209,211,109,82,148,10,70,53,15,130,18
30252,6289,5574,1129,3023,1228,194,2384,2602,356,232,715,148,212,239,116,621,94
30253,9236,7201,2014,3709,1301,177,3167,2701,833,500,2035,596,820,398,221,1619,416
30256,710,559,79,281,157,42,221,254,42,42,151,6,55,45,45,142,9
30257,1113,893,134,405,298,56,286,451,59,97,220,27,100,47,46,187,33
30258,726,602,119,280,175,28,199,293,62,48,124,12,37,45,30,102,22
30259,925,754,130,397,204,23,267,347,77,63,171,21,50,63,37,158,13
30260,8254,5717,1574,2760,1104,279,1863,1886,1147,821,2537,828,796,674,239,2006,531
30263,14710,11015,2843,5101,2494,577,3696,4266,1645,1408,3695,922,1190,922,661,3048,647
30265,6378,5105,1144,2969,918,74,2433,1997,378,297,1273,364,535,270,104,1030,243
30268,2625,1885,458,889,469,69,586,721,343,235,740,62,336,217,125,620,120
30269,11291,9196,1011,5931,1915,339,4672,3534,702,288,2095,362,815,511,407,1840,255
30273,3749,3055,753,1756,468,78,1244,1130,431,250,694,189,313,135,57,600,94
30274,11187,8119,2666,4218,1083,152,2839,2114,2152,1014,3068,1086,1334,522,126,2463,605
30275,60,51,22,21,8,0,22,20,9,0,9,0,0,0,9,9,0
30276,3062,2514,759,1128,526,101,981,1016,279,238,548,169,182,131,66,470,78
30277,5300,4653,1147,2514,917,75,2165,2019,310,159,647,200,220,154,73,540,107
30281,17640,13445,3562,7163,2412,308,5709,5088,1813,835,4195,1156,1666,952,421,3260,935
30285,211,151,59,64,26,2,72,44,27,8,60,25,9,13,13,45,15
30286,9495,6746,1400,2999,1891,456,1849,2816,1144,937,2749,313,810,934,692,2510,239
30288,2099,1648,389,840,369,50,476,502,374,296,451,82,238,125,6,371,80
30290,1775,1506,158,943,344,61,658,705,94,49,269,48,80,98,43,219,50
30291,5150,2957,1001,1423,356,177,737,819,869,532,2193,453,764,390,586,1859,334
30292,1592,1267,315,653,244,55,534,539,96,98,325,92,134,65,34,240,85
30293,1364,1042,143,500,290,109,256,473,144,169,322,15,76,157,74,290,32
30294,8659,7137,1716,4111,1083,227,2890,2157,1147,943,1522,339,708,364,111,1161,361
30295,1220,950,251,421,226,52,378,404,78,90,270,30,64,100,76,248,22
30296,7269,5729,1198,3323,1018,190,2160,1900,961,708,1540,264,896,294,86,1297,243
30297,9700,6979,2252,3055,1350,322,2078,1959,1690,1252,2721,622,1129,690,280,2156,565
30303,900,213,84,109,13,7,55,54,48,56,687,454,174,38,21,530,157
30305,11716,4424,745,2053,1171,455,1456,2403,137,428,7292,3206,1797,966,1323,5811,1481
30306,11415,3614,869,1970,563,212,1199,1884,254,277,7801,4135,2630,638,398,5440,2361
30307,7246,3405,1010,1676,550,169,1057,1335,553,460,3841,1879,1402,359,201,2567,1274
30308,6452,1388,584,513,220,71,168,472,389,359,5064,2551,1636,604,273,3889,1175
30309,11562,2418,866,1018,430,104,637,1372,153,256,9144,4784,3192,915,253,7115,2029
30310,12392,7535,1888,3316,1964,367,1154,1552,2470,2359,4857,972,1962,1313,610,3913,944
30311,13939,9025,2155,3662,2659,549,1266,2418,2743,2598,4914,1024,1763,1533,594,4101,813
30312,8974,3864,1561,1635,523,145,588,747,1703,826,5110,1721,1811,1048,530,3966,1144
30313,1608,361,210,131,20,0,60,54,173,74,1247,448,392,306,101,1046,201
30314,9497,5320,1418,2036,1284,582,673,942,1917,1788,4177,1208,1217,1011,741,3316,861
30315,12154,8435,2791,3657,1541,446,1554,1509,3197,2175,3719,642,1268,1251,558,3014,705
30316,11552,7505,2028,3457,1674,346,1276,2000,2277,1952,4047,1257,1625,940,225,2970,1077
30317,5087,3101,766,1103,977,255,321,799,918,1063,1986,499,813,455,219,1454,532
30318,18726,10583,3539,4015,2152,877,1742,2621,3454,2766,8143,3043,2591,1782,727,5875,2268
30319,16414,7878,2071,3574,1617,616,2300,3920,707,951,8536,3765,2801,1187,783,6047,2489
30322,0,0,0,0,0,0,0,0,0,0,0,0,0,0,0,0,0
30324,10914,3424,1278,1321,556,269,816,1824,224,560,7490,3421,2773,835,461,5170,2320
30326,643,177,57,47,73,0,25,152,0,0,466,183,227,56,0,401,65
30327,8836,5781,422,3070,1873,416,2398,2909,239,235,3055,803,975,653,624,2581,474
30328,13369,7268,1742,3059,1816,651,2264,3702,540,762,6101,2203,1869,1053,976,4656,1445
30329,11649,4683,1679,1929,632,443,1617,1792,415,859,6966,3811,1863,584,708,4638,2328
30331,16041,11556,2945,5254,2876,481,2467,3367,3268,2454,4485,1051,1686,1339,409,3914,571
30336,39,16,0,9,7,0,0,7,9,0,23,0,0,5,18,18,5
30337,6309,3655,1399,1638,496,122,781,748,1301,825,2654,1184,994,250,226,2074,580
30338,12191,8011,1200,3635,2717,459,2643,4566,325,477,4180,1730,1297,781,372,3211,969
30339,8777,2678,1034,1075,538,31,580,1509,276,313,6099,4167,1539,293,100,3951,2148
30340,9875,5988,1988,2613,1182,205,2066,2074,990,858,3887,1645,1429,591,222,2831,1056
30341,11615,6646,2463,2602,1215,366,1952,2752,826,1116,4969,1883,1800,995,291,3297,1672
30342,11653,5391,1544,2398,1082,367,2043,2280,325,743,6262,3221,1935,664,442,4552,1710
30344,13199,8663,2671,3922,1570,500,1860,2349,2731,1723,4536,1184,1910,1022,420,3515,1021
30345,8495,5770,1419,2382,1418,551,1904,2586,510,770,2725,815,1023,622,265,1785,940
30346,843,191,102,79,0,10,24,140,13,14,652,480,151,12,9,527,125
30349,21105,13756,4450,7054,1919,333,3821,3310,4024,2601,7349,3174,2853,1023,299,5889,1460
30350,15146,7010,2156,3282,1350,222,2202,3160,914,734,8136,4571,2425,712,428,5947,2189
30354,6149,4371,1453,2059,649,210,835,1012,1620,904,1778,428,760,401,189,1411,367
30360,5534,3484,1103,1611,617,153,1037,1449,505,493,2050,885,757,287,121,1501,549
30401,4659,3282,832,1464,734,252,1007,1220,730,325,1377,199,417,469,292,1185,192
30410,759,533,131,246,139,17,199,226,69,39,226,28,75,85,38,211,15
30411,997,723,146,369,151,57,240,259,121,103,274,46,61,76,91,264,10
30412,98,72,11,37,20,4,23,45,0,4,26,2,0,8,16,22,4
30413,597,461,60,142,216,43,80,246,67,68,136,25,24,39,48,133,3
30414,85,75,5,39,31,0,12,44,5,14,10,0,1,6,3,8,2
30415,2044,1552,190,872,381,109,635,685,174,58,492,68,134,199,91,450,42
30417,3359,2399,578,1075,561,185,748,904,507,240,960,157,343,288,172,847,113
30420,726,574,138,269,112,55,199,248,72,55,152,22,49,38,43,130,22
30421,1079,680,171,255,203,51,219,274,103,84,399,40,76,179,104,368,31
30423,121,89,4,55,24,6,17,48,4,20,32,1,7,18,6,30,2
30425,515,397,82,142,151,22,136,172,51,38,118,11,10,54,43,103,15
30426,472,343,83,182,69,9,115,107,71,50,129,9,29,77,14,125,4
30427,3760,2642,664,1270,604,104,967,1049,380,246,1118,192,389,339,198,927,191
30428,968,662,172,278,156,56,236,263,84,79,306,38,72,84,112,278,28
30429,199,148,52,61,25,10,43,39,32,34,51,16,19,14,2,44,7
30434,2184,1568,378,686,391,113,410,502,363,293,616,42,201,232,141,600,16
30436,4185,2933,823,1282,703,125,1003,1132,463,335,1252,136,379,469,268,1094,158
30438,91,59,4,30,23,2,8,27,13,11,32,2,6,17,7,29,3
30439,3146,2244,597,910,546,191,742,821,406,275,902,108,238,349,207,791,111
30441,792,562,106,260,117,79,178,218,50,116,230,30,39,95,66,214,16
30442,2914,2026,459,991,445,131,535,637,457,397,888,73,259,346,210,782,106
30445,945,686,182,352,124,28,263,214,133,76,259,61,95,53,50,208,51
30446,542,411,83,157,99,72,98,175,59,79,131,6,31,47,47,130,1
30447,22,16,5,5,6,0,5,5,0,6,6,0,0,6,0,6,0
30448,15,11,2,6,3,0,2,4,0,5,4,2,0,0,2,4,0
30450,999,746,177,331,196,42,198,337,126,85,253,33,79,78,63,232,21
30452,500,368,88,153,104,23,135,153,51,29,132,16,36,55,25,97,35
30453,2184,1564,488,646,362,68,559,563,275,167,620,86,250,196,88,542,78
30454,217,149,48,59,42,0,60,56,33,0,68,8,16,31,13,53,15
30455,272,198,42,82,66,8,75,80,27,16,74,5,22,16,31,73,1
30456,695,530,120,231,130,49,150,208,108,64,165,16,27,78,44,146,19
30457,2347,1676,429,726,406,115,462,673,301,240,671,86,148,276,161,617,54
30458,12092,5834,1519,2629,1400,286,1785,2339,945,765,6258,4080,832,698,648,3412,2846
30461,3829,2863,787,1420,494,162,1195,1002,443,223,966,335,216,283,132,730,236
30464,54,36,11,20,2,3,8,5,14,9,18,6,7,3,2,8,10
30467,5020,3552,705,1708,969,170,1192,1343,517,500,1468,104,504,450,410,1348,120
30470,320,261,61,147,39,14,123,73,7,58,59,3,5,36,15,45,14
30471,1550,1152,269,549,299,35,425,428,181,118,398,35,95,160,108,361,37
30473,1039,795,191,324,265,15,301,346,83,65,244,20,91,88,45,226,18
30474,5998,4106,979,1825,1029,273,1260,1607,746,493,1892,344,667,547,334,1702,190
30477,1172,815,209,376,160,70,236,210,188,181,357,37,92,131,97,337,20
30501,9538,6267,2022,2459,1244,542,2231,2129,841,1066,3271,848,948,796,679,2586,685
30504,5085,3717,1030,1546,910,231,1235,1548,471,463,1368,443,431,319,175,1124,244
30506,11361,9214,1904,4345,2467,498,3443,4543,661,567,2147,419,754,659,315,1831,316
30507,6519,5343,1597,2444,1160,142,2225,2066,512,540,1176,166,482,377,151,989,187
30510,1999,1574,445,747,327,55,595,711,160,108,425,93,125,143,64,344,81
30511,1034,774,150,372,189,63,261,402,58,53,260,62,72,85,41,235,25
30512,6624,4784,648,1788,1924,424,1274,2824,357,329,1840,206,439,728,467,1622,218
30513,4021,2944,514,1211,968,251,845,1617,228,254,1077,95,259,486,237,994,83
30516,649,489,111,214,112,52,144,257,33,55,160,18,63,41,38,153,7
30517,1842,1485,407,614,404,60,564,708,118,95,357,59,149,115,34,319,38
30518,10748,7883,2080,3972,1506,325,3272,3062,839,710,2865,700,1148,725,292,2282,583
30519,6117,5258,1230,2952,978,98,2547,2205,253,253,859,195,369,225,70,664,195
30520,1545,1128,258,504,304,62,389,537,105,97,417,38,141,162,76,392,25
30521,1767,1313,325,520,401,67,495,596,99,123,454,51,114,169,120,412,42
30522,270,223,39,50,129,5,34,172,5,12,47,0,31,10,6,36,11
30523,4332,3210,580,1366,992,272,1007,1816,232,155,1122,167,274,412,269,1001,121
30525,2987,2037,385,835,632,185,646,1056,171,164,950,107,252,372,219,829,121
30527,1164,947,185,458,240,64,379,478,34,56,217,60,72,63,22,180,37
30528,6314,4799,1086,2032,1346,335,1646,2429,439,285,1515,220,483,514,298,1328,187
30529,3475,2472,630,1055,599,188,756,1102,338,276,1003,162,338,241,262,870,133
30530,1718,1300,271,581,409,39,498,640,50,112,418,66,155,125,72,316,102
30531,3841,2741,623,1229,679,210,937,1242,324,238,1100,194,292,347,267,945,155
30533,6763,4737,1161,2279,1081,216,1867,2081,464,325,2026,692,545,505,284,1518,508
30534,6398,4958,1244,2389,1174,151,1802,2394,467,295,1440,309,561,414,156,1167,273
30535,2228,1605,287,805,425,88,567,753,172,113,623,152,147,208,116,571,52
30537,586,414,45,142,180,47,86,257,36,35,172,29,20,82,41,148,24
30538,842,689,174,251,184,80,202,346,75,66,153,22,41,71,19,142,11
30539,174,112,39,39,17,17,37,48,9,18,62,12,16,25,9,46,16
30540,7925,5844,1292,2528,1684,340,1910,2929,584,421,2081,308,682,759,332,1773,308
30541,526,400,64,242,79,15,155,199,16,30,126,15,11,47,53,126,0
30542,7364,5988,1713,3067,1098,110,2620,2374,666,328,1376,313,539,390,134,1095,281
30543,1192,917,256,393,221,47,373,357,97,90,275,29,92,102,52,229,46
30545,371,199,40,69,69,21,55,94,27,23,172,14,68,54,36,162,10
30546,2762,1936,330,619,783,204,468,1254,125,89,826,58,169,337,262,752,74
30547,1024,779,197,366,184,32,308,366,52,53,245,16,101,80,48,213,32
30548,2138,1728,390,910,389,39,731,746,114,137,410,50,126,141,93,352,58
30549,4552,3468,909,1593,775,191,1334,1417,403,314,1084,132,438,356,158,967,117
30552,672,458,75,174,186,23,119,239,30,70,214,12,75,98,29,188,26
30553,2713,1993,411,769,677,136,510,982,260,241,720,65,195,278,182,684,36
30554,2171,1742,492,797,363,90,676,776,154,136,429,53,120,164,92,372,57
30555,947,610,166,212,169,63,161,275,93,81,337,15,59,171,92,315,22
30557,1725,1323,298,599,350,76,454,628,116,125,402,53,141,150,58,351,51
30558,1698,1334,363,605,306,60,524,590,143,77,364,32,86,167,79,321,43
30559,1417,1026,190,366,375,95,305,550,85,86,391,39,77,170,105,362,29
30560,1475,1102,162,457,398,85,374,605,43,80,373,74,128,104,67,326,47
30562,368,223,58,87,61,17,68,84,41,30,145,25,36,47,37,118,27
30563,1564,1315,258,632,352,73,439,630,155,91,249,32,112,74,31,211,38
30564,1239,959,176,561,206,16,428,361,99,71,280,54,108,83,35,211,69
30565,1368,1076,356,468,214,38,496,393,87,100,292,62,112,84,34,224,68
30566,2512,1905,478,972,392,63,787,794,156,168,607,228,180,107,92,485,122
30567,715,613,182,223,162,46,200,352,32,29,102,12,44,13,33,79,23
30568,561,431,58,194,163,16,137,237,39,18,130,6,40,49,35,127,3
30571,1097,851,77,400,302,72,301,492,19,39,246,39,59,101,47,190,56
30572,571,420,26,155,168,71,86,300,11,23,151,16,47,55,33,131,20
30575,487,423,147,167,81,28,200,172,34,17,64,15,22,6,21,50,14
30576,975,731,152,284,251,44,283,344,47,57,244,10,103,96,35,209,35
30577,8696,6101,1460,2567,1600,474,2108,2851,635,507,2595,433,719,797,646,2291,304
30581,6,6,6,0,0,0,0,0,6,0,0,0,0,0,0,0,0
30582,1335,989,130,357,376,126,267,622,39,61,346,47,60,158,81,306,40
30598,59,59,23,36,0,0,41,0,0,18,0,0,0,0,0,0,0
30601,6980,3965,1342,1645,826,152,840,1148,1086,891,3015,1485,726,438,366,2102,913
30602,0,0,0,0,0,0,0,0,0,0,0,0,0,0,0,0,0
30605,14685,6267,2211,2543,1240,273,1889,2454,1105,819,8418,6065,1286,711,356,4453,3965
30606,15023,7654,2106,3224,1842,482,2414,3278,1045,917,7369,4235,1571,912,651,4578,2791
30607,2976,2131,802,948,299,82,751,641,479,260,845,348,235,163,99,566,279
30619,405,281,36,150,72,23,106,118,41,16,124,25,42,28,29,112,12
30620,1871,1536,514,692,249,81,684,668,103,81,335,94,134,66,41,270,65
30621,1073,832,192,438,170,32,380,326,69,57,241,28,81,89,43,220,21
30622,2831,2102,374,1051,606,71,834,963,155,150,729,169,224,196,140,613,116
30624,964,728,181,360,150,37,255,274,97,102,236,33,52,102,49,210,26
30625,724,577,73,317,153,34,209,309,32,27,147,23,66,54,4,110,37
30627,915,660,120,345,176,19,224,287,102,47,255,34,81,80,60,196,59
30628,1922,1478,331,814,283,50,695,512,142,129,444,100,130,160,54,387,57
30629,1632,1182,263,526,322,71,367,560,134,121,450,30,146,162,112,411,39
30630,1037,768,165,329,234,40,186,347,125,110,269,33,75,88,73,250,19
30631,894,584,144,197,161,82,147,230,106,101,310,40,88,109,73,286,24
30633,3336,2507,602,1241,541,123,923,1151,245,188,829,193,211,258,167,711,118
30634,854,671,127,329,197,18,291,318,33,29,183,35,38,64,46,158,25
30635,6505,4693,998,1997,1368,330,1399,1996,733,565,1812,184,584,555,489,1657,155
30638,16,9,0,9,0,0,9,0,0,0,7,0,0,0,7,7,0
30639,18,11,3,0,8,0,2,9,0,0,7,0,1,4,2,7,0
30641,485,388,80,176,107,25,127,230,21,10,97,9,37,27,24,87,10
30642,3733,2827,527,1111,1015,174,633,1390,514,290,906,128,269,288,221,780,126
30643,5963,4241,851,1652,1353,385,1175,2022,514,530,1722,160,542,573,447,1581,141
30646,2421,1825,456,831,427,111,644,798,205,178,596,122,224,175,75,469,127
30648,866,645,109,370,143,23,215,270,100,60,221,28,104,49,40,174,47
30650,3695,2871,543,1393,748,187,945,1157,386,383,824,118,204,323,179,716,108
30655,6425,4739,1270,2034,1179,256,1470,1888,799,582,1686,364,514,394,414,1369,317
30656,3581,2921,762,1356,631,172,1108,1293,290,230,660,131,251,168,110,530,130
30660,416,307,47,164,83,13,116,111,58,22,109,13,18,53,25,109,0
30662,3122,2200,457,962,572,209,784,969,226,221,922,150,217,351,204,790,132
30663,886,698,132,330,187,49,248,311,62,77,188,13,60,85,30,176,12
30664,11,11,0,7,4,0,1,5,3,2,0,0,0,0,0,0,0
30665,147,97,8,51,15,23,15,25,8,49,50,4,21,18,7,38,12
30666,1930,1532,437,647,377,71,564,611,207,150,398,63,116,134,85,325,73
30667,330,209,35,89,69,16,67,75,23,44,121,14,34,65,8,100,21
30668,794,570,147,246,140,37,163,284,51,72,224,16,53,105,50,194,30
30669,1312,910,165,442,259,44,241,366,168,135,402,44,104,163,91,368,34
30671,12,8,2,4,2,0,2,6,0,0,4,2,2,0,0,0,4
30673,3308,2265,323,1100,654,188,583,966,428,288,1043,79,324,306,334,942,101
30677,4783,3939,754,2278,768,139,1743,1613,398,185,844,153,280,220,191,682,162
30678,415,315,35,110,157,13,57,118,40,100,100,15,16,37,32,94,6
30680,9434,6988,2087,3139,1395,367,2651,2760,893,684,2446,455,798,686,507,2019,427
30683,2074,1483,348,664,400,71,556,618,177,132,591,163,183,149,96,438,153
30701,10762,8132,2188,3801,1820,323,3223,3376,836,697,2630,384,763,983,500,2302,328
30705,11424,8868,2668,4149,1780,271,3500,3596,1108,664,2556,440,1028,730,358,2150,406
30707,5251,4103,833,1963,1081,226,1481,1823,344,455,1148,215,332,324,277,1014,134
30708,177,112,27,38,40,7,35,66,11,0,65,5,33,20,7,49,16
30710,1860,1565,324,869,343,29,659,716,111,79,295,32,127,71,65,255,40
30711,1387,1120,332,492,253,43,419,455,158,88,267,48,86,108,25,249,18
30720,9152,6496,1811,2841,1518,326,2484,2729,760,523,2656,532,764,819,541,2323,333
30721,13560,10548,3211,4399,2480,458,4243,4150,984,1171,3012,422,1055,959,576,2546,466
30724,69,51,9,10,31,1,10,24,2,15,18,2,9,6,1,14,4
30725,1375,991,200,463,268,60,358,521,59,53,384,69,97,125,93,349,35
30726,18,18,0,9,9,0,9,9,0,0,0,0,0,0,0,0,0
30728,6699,4934,1151,2185,1287,311,1551,2135,680,568,1765,255,465,628,417,1580,185
30730,752,550,102,270,143,35,148,282,71,49,202,47,67,63,25,182,20
30731,963,698,137,364,158,39,230,348,49,71,265,28,87,94,56,220,45
30733,701,538,108,273,134,23,158,289,52,39,163,7,70,72,14,129,34
30734,1140,882,224,413,207,38,337,429,74,42,258,17,118,71,52,218,40
30735,1934,1504,381,685,379,59,517,685,209,93,430,91,122,119,98,347,83
30736,12440,9829,2281,4639,2434,475,3871,4437,920,601,2611,443,954,840,374,2222,389
30738,1346,1083,141,577,293,72,343,549,53,138,263,24,92,93,54,223,40
30739,1254,1009,234,402,345,28,333,490,134,52,245,35,88,72,50,245,0
30740,2396,1837,388,818,555,76,616,914,154,153,559,110,208,145,96,433,126
30741,11343,8023,1926,3521,1994,582,2551,3562,1127,783,3320,500,808,1243,769,2924,396
30742,2558,1670,387,692,494,97,425,860,251,134,888,172,181,341,194,760,128
30746,474,357,87,176,75,19,123,177,33,24,117,21,47,49,0,96,21
30747,5865,4245,916,1845,1150,334,1349,1840,591,465,1620,262,355,618,385,1446,174
30750,1216,911,148,485,192,86,397,418,45,51,305,86,77,73,69,268,37
30752,3378,2592,636,1132,681,143,969,1203,223,197,786,94,192,334,166,724,62
30753,2681,1878,446,844,459,129,669,794,206,209,803,99,217,263,224,719,84
30755,3379,2599,783,1157,566,93,965,1089,371,174,780,99,325,262,94,659,121
30757,764,552,118,278,133,23,186,268,28,70,212,22,51,99,40,212,0
30802,1756,1374,254,699,356,65,583,591,84,116,382,39,197,130,16,305,77
30803,287,197,42,92,37,26,56,90,32,19,90,0,50,27,13,85,5
30805,668,538,111,294,122,11,222,177,93,46,130,37,40,45,8,112,18
30807,79,41,15,12,7,7,15,16,2,8,38,7,8,13,10,35,3
30808,1619,1259,267,611,319,62,453,524,157,125,360,48,111,99,102,314,46
30809,8495,7334,1138,4465,1484,247,3749,2848,437,300,1161,203,366,335,257,1050,111
30810,717,521,107,220,161,33,185,253,42,41,196,22,47,60,67,175,21
30813,5449,4334,1160,2239,863,72,1743,1404,681,506,1115,207,471,312,125,911,204
30814,2554,1936,458,887,483,108,684,806,251,195,618,90,259,188,81,491,127
30815,12463,10293,2361,5996,1683,253,4373,3035,1997,888,2170,347,1077,601,145,1762,408
30816,788,562,91,245,201,25,186,165,76,135,226,8,99,66,53,200,26
30817,3104,2258,356,999,763,140,711,995,242,310,846,94,274,332,146,750,96
30818,177,170,25,125,20,0,110,28,7,25,7,0,7,0,0,7,0
30820,429,315,82,152,66,15,130,105,50,30,114,13,17,47,37,112,2
30821,401,275,16,154,76,29,72,132,19,52,126,21,43,22,40,117,9
30822,170,132,36,56,40,0,43,62,27,0,38,14,8,0,16,38,0
30823,598,449,108,202,114,25,132,167,91,59,149,15,67,36,31,144,5
30824,6351,4620,1106,2151,1097,266,1343,1769,917,591,1731,295,532,502,402,1550,181
30828,1696,1191,266,519,315,91,270,432,284,205,505,72,149,175,109,454,51
30830,4708,3420,806,1688,755,171,997,1013,907,503,1288,205,439,397,247,1121,167
30833,1478,1035,239,416,261,119,234,370,211,220,443,20,140,193,90,380,63
30901,8568,4850,1268,1840,1174,568,456,948,1896,1550,3718,560,1076,1248,834,3265,453
30904,12283,6910,1950,2827,1582,551,1436,2625,1674,1175,5373,1540,1584,1217,1032,4548,825
30905,856,832,481,351,0,0,607,79,133,13,24,7,17,0,0,24,0
30906,20686,15613,3454,7637,3911,611,4272,5305,3449,2587,5073,787,2001,1650,635,4453,620
30907,17070,12933,2491,7104,2873,465,5516,5345,1213,859,4137,1237,1320,1146,434,3554,583
30909,15207,9260,2763,3753,2127,617,2831,3847,1532,1050,5947,2116,1889,1356,586,4917,1030
31001,967,680,147,299,158,76,233,294,83,70,287,24,93,66,104,260,27
31002,958,655,190,266,143,56,223,241,81,110,303,54,41,127,81,279,24
31003,87,57,13,27,17,0,20,28,7,2,30,0,8,8,14,29,1
31005,3247,2771,521,1567,615,68,1221,1190,240,120,476,103,189,135,49,412,64
31006,1801,1258,346,479,343,90,332,477,251,198,543,41,209,166,127,502,41
31007,298,214,59,86,53,16,69,70,33,42,84,9,15,35,25,81,3
31008,4801,3867,955,1859,945,108,1541,1593,451,282,934,132,399,252,151,785,149
31009,448,314,62,164,66,22,86,190,17,21,134,20,30,46,38,115,19
31011,276,222,29,117,58,18,67,80,26,49,54,11,18,14,11,52,2
31012,526,369,97,140,119,13,116,151,55,47,157,27,49,46,35,140,17
31014,4647,3303,667,1535,889,212,1007,1359,509,428,1344,249,337,452,306,1207,137
31015,7850,5592,1346,2650,1280,316,1478,2083,1323,708,2258,262,694,787,515,2045,213
31016,555,394,65,193,106,30,117,178,56,43,161,19,50,63,29,139,22
31017,784,543,99,258,138,48,138,219,111,75,241,33,71,78,59,218,23
31018,416,303,61,153,79,10,83,109,86,25,113,13,34,39,27,93,20
31019,795,605,143,295,119,48,224,275,65,41,190,18,75,46,51,180,10
31020,1150,865,185,369,253,58,297,306,105,157,285,42,80,91,72,249,36
31021,10456,7301,1883,3158,1709,551,2131,2921,1417,832,3155,555,907,1018,675,2855,300
31022,434,306,43,130,95,38,99,143,13,51,128,19,25,41,43,114,14
31023,5280,3641,911,1546,992,192,1162,1387,610,482,1639,262,530,532,315,1507,132
31024,6843,5074,948,2104,1711,311,1330,2618,606,520,1769,290,601,629,249,1529,240
31025,465,375,52,171,145,7,128,162,48,37,90,14,24,42,10,83,7
31027,3645,2752,747,1209,645,151,837,1130,427,358,893,162,248,349,134,806,87
31028,1490,1128,180,556,309,83,365,498,141,124,362,94,125,117,26,299,63
31029,4833,3668,702,1863,888,215,1225,1439,505,499,1165,163,364,436,202,999,166
31030,6097,4226,975,1963,1065,223,1075,1445,929,777,1871,575,493,521,282,1460,411
31031,2514,1877,425,870,488,94,592,812,269,204,637,99,235,214,89,551,86
31032,3867,3089,614,1538,785,152,1165,1254,392,278,778,99,197,348,134,691,87
31033,795,550,136,264,135,15,157,255,91,47,245,27,92,97,29,224,21
31034,0,0,0,0,0,0,0,0,0,0,0,0,0,0,0,0,0
31035,556,433,70,206,131,26,128,190,44,71,123,5,49,29,40,117,6
31036,3733,2603,615,1115,687,186,767,1174,394,268,1130,137,340,359,294,1017,113
31037,922,637,136,271,176,54,207,242,111,77,285,23,105,97,60,248,37
31038,310,220,33,124,51,12,76,84,10,50,90,20,25,30,15,86,4
31039,18,18,0,14,4,0,6,8,4,0,0,0,0,0,0,0,0
31041,370,271,49,124,72,26,72,111,45,43,99,18,15,16,50,99,0
31042,767,578,104,283,160,31,128,233,142,75,189,12,74,67,36,159,30
31044,1235,973,190,462,271,50,261,365,155,192,262,29,74,105,54,242,20
31045,49,21,0,12,5,4,4,9,4,4,28,0,16,4,8,24,4
31046,989,807,138,376,262,31,295,336,64,112,182,23,45,47,67,167,15
31047,1909,1653,252,1002,343,56,688,716,132,117,256,49,100,61,46,224,32
31049,598,432,110,142,142,38,173,169,40,50,166,17,63,42,44,163,3
31050,343,236,75,97,56,8,115,116,5,0,107,33,55,19,0,87,20
31051,74,39,9,22,6,2,5,12,16,6,35,10,8,5,12,33,2
31052,2406,1979,273,1037,577,92,770,1003,72,134,427,94,199,65,69,323,104
31054,550,411,123,127,128,33,108,166,77,60,139,9,43,65,22,134,5
31055,1731,1218,312,481,325,100,388,483,186,161,513,53,165,155,140,478,35
31057,760,553,86,291,136,40,102,175,141,135,207,21,66,89,31,203,4
31058,628,468,86,251,125,6,228,173,26,41,160,8,76,47,29,133,27
31060,856,591,111,266,172,42,227,253,50,61,265,39,71,104,51,258,7
31061,14562,9763,2052,4712,2482,517,2731,3737,1942,1353,4799,1645,1317,1216,621,3752,1047
31063,2128,1560,380,701,412,67,517,467,316,260,568,53,172,169,174,533,35
31064,2981,2221,519,957,598,147,654,1022,315,230,760,84,225,301,150,662,98
31065,316,238,38,117,73,10,84,111,25,18,78,6,26,28,18,77,1
31066,476,384,74,188,101,21,171,170,8,35,92,4,10,34,44,85,7
31067,72,59,3,32,20,4,7,43,3,6,13,3,4,3,3,11,2
31068,1296,941,230,446,222,43,283,297,209,152,355,58,87,141,69,310,45
31069,5862,4317,872,2169,1036,240,1523,1687,632,475,1545,299,528,428,290,1356,189
31070,363,261,53,109,64,35,82,142,22,15,102,21,22,35,24,95,7
31071,508,368,49,177,130,12,105,150,49,64,140,23,39,47,31,114,26
31072,531,369,83,187,92,7,122,154,54,39,162,9,38,47,68,155,7
31075,667,517,95,288,111,23,192,177,84,64,150,15,38,63,34,131,19
31076,1255,882,162,419,251,50,204,383,153,142,373,34,93,143,103,332,41
31077,518,357,55,167,99,36,125,168,24,40,161,11,55,49,46,157,4
31078,1290,930,147,430,288,65,237,371,157,165,360,42,147,71,100,329,31
31079,1037,755,155,358,192,50,254,283,109,109,282,39,69,121,53,256,26
31081,86,61,15,19,21,6,30,31,0,0,25,6,9,10,0,20,5
31082,3986,2877,520,1446,762,149,830,997,574,476,1109,146,355,348,260,1016,93
31083,65,50,11,30,9,0,19,23,6,2,15,2,4,7,2,11,4
31085,299,258,47,146,47,18,101,81,46,30,41,11,6,21,3,41,0
31087,3225,2352,418,1002,747,185,434,847,553,518,873,67,347,230,229,831,42
31088,14632,10653,2292,5641,2348,372,3994,4364,1545,750,3979,1092,1456,1030,401,3390,589
31089,1729,1223,315,586,240,82,445,358,251,169,506,67,142,157,140,449,57
31090,416,272,35,153,47,37,66,119,35,52,144,19,23,56,46,130,14
31091,1064,754,162,320,219,53,142,300,175,137,310,27,83,133,67,287,23
31092,2113,1526,383,687,373,83,513,551,239,223,587,91,206,171,119,511,76
31093,10999,7516,1963,3438,1787,328,2024,2986,1708,798,3483,794,1336,919,434,3055,428
31094,535,384,63,183,120,18,105,139,97,43,151,29,62,30,30,134,17
31096,2379,1715,390,797,431,97,466,707,346,196,664,63,192,203,206,619,45
31097,545,462,88,194,141,39,128,222,51,61,83,16,13,17,37,83,0
31098,1101,1072,621,446,5,0,793,152,119,8,29,9,19,1,0,29,0
31201,4087,1948,701,671,400,176,193,425,791,539,2139,657,620,499,363,1875,264
31204,13988,8586,2081,3701,1967,837,1880,3024,2014,1668,5402,916,1765,1547,1174,4686,716
31206,11520,8045,2304,3420,1813,508,1788,2267,2581,1409,3475,753,1224,1005,493,2978,497
31210,11203,7824,1467,4134,1757,466,3095,3485,847,397,3379,1315,927,760,377,2802,577
31211,6537,4296,917,2100,1023,256,1273,1733,718,572,2241,459,754,600,428,1959,282
31216,4890,3842,608,1910,1073,251,1341,1911,323,267,1048,187,420,258,183,918,130
31217,6663,4949,1168,2227,1230,324,1162,1616,1260,911,1714,203,603,622,286,1478,236
31220,4288,3221,689,1838,610,84,1352,1358,302,209,1067,324,488,145,110,896,171
31301,1462,1093,549,410,118,16,500,314,223,56,369,154,167,38,10,300,69
31302,2669,2049,445,939,550,115,808,881,167,193,620,87,265,190,78,522,98
31303,766,610,100,390,76,44,231,250,74,55,156,14,32,79,31,133,23
31305,1955,1400,290,660,408,42,439,589,217,155,555,101,209,156,89,488,67
31307,362,284,61,154,69,0,104,118,36,26,78,9,14,55,0,69,9
31308,2300,1806,444,870,446,46,681,798,141,186,494,98,180,143,73,422,72
31309,399,309,42,202,57,8,140,120,26,23,90,54,16,0,20,63,27
31312,3855,3036,712,1588,608,128,1438,1109,298,191,819,134,277,294,114,661,158
31313,12436,9524,4015,4453,939,117,4228,2696,1968,632,2912,1372,905,545,90,2187,725
31314,0,0,0,0,0,0,0,0,0,0,0,0,0,0,0,0,0
31315,2447,2404,1822,582,0,0,1820,319,250,15,43,28,15,0,0,43,0
31316,2133,1621,531,720,284,86,689,540,254,138,512,129,168,160,55,433,79
31318,88,88,24,45,19,0,34,31,23,0,0,0,0,0,0,0,0
31319,39,28,0,19,9,0,11,13,0,4,11,0,5,0,6,5,6
31320,2565,1875,358,886,542,89,597,983,151,144,690,113,236,261,80,589,101
31321,1987,1594,366,760,403,65,600,602,244,148,393,62,161,101,69,331,62
31322,2225,1786,476,882,398,30,680,718,241,147,439,62,166,142,69,352,87
31323,640,496,90,256,106,44,158,157,88,93,144,22,38,40,44,134,10
31324,4948,4125,861,2503,655,106,1966,1455,506,198,823,248,260,170,145,725,98
31326,4262,3444,770,1969,628,77,1605,1255,357,227,818,137,248,295,138,702,116
31327,47,15,0,15,0,0,6,9,0,0,32,0,0,20,12,32,0
31328,1697,1016,70,497,368,81,202,665,74,75,681,86,240,280,75,555,126
31329,2325,1878,450,918,441,69,755,763,197,163,447,83,128,126,110,393,54
31331,2073,1515,288,624,491,112,439,738,179,159,558,91,199,206,62,463,95
31333,457,346,207,116,15,8,173,90,83,0,111,30,71,10,0,94,17
31401,8849,4146,1229,1596,1014,307,536,1141,1450,1019,4703,2060,1035,1056,552,3603,1100
31404,12098,7871,1871,3789,1555,656,1842,2550,2048,1431,4227,970,1339,1094,824,3461,766
31405,11990,7849,1682,3319,2055,793,2213,3102,1227,1307,4141,806,1353,995,987,3561,580
31406,13582,9418,2006,4538,2191,683,3194,3702,1449,1073,4164,1142,1219,984,819,3391,773
31407,1264,885,138,385,286,76,233,467,94,91,379,97,104,87,91,319,60
31408,3848,2671,793,1104,563,211,763,1018,572,318,1177,174,472,340,191,957,220
31410,8740,6370,991,3596,1449,334,2535,2873,576,386,2370,691,830,620,229,1887,483
31411,3197,2709,38,635,1626,410,426,2232,17,34,488,20,52,221,195,453,35
31415,4897,3230,704,1069,1112,345,406,908,1038,878,1667,102,499,552,514,1532,135
31419,16198,10838,3073,5187,2113,465,3912,4448,1575,903,5360,2437,1501,932,490,4029,1331
31501,6096,3892,841,1604,1096,351,865,1613,719,695,2204,281,665,696,562,2048,156
31503,7517,5517,1276,2504,1463,274,1831,2561,675,450,2000,375,516,685,424,1763,237
31510,3354,2513,672,1043,674,124,805,1042,365,301,841,126,296,288,131,788,53
31512,947,697,161,326,162,48,212,320,88,77,250,54,40,92,64,221,29
31513,5787,4376,1100,1959,1119,198,1461,1879,564,472,1411,167,484,461,299,1285,126
31516,4586,3438,873,1501,867,197,1188,1485,453,312,1148,105,421,417,205,1036,112
31518,305,224,53,113,42,16,88,112,9,15,81,0,19,44,18,81,0
31519,1308,928,247,452,193,36,335,338,159,96,380,40,114,107,119,345,35
31520,8543,5512,1379,2313,1408,412,1342,1918,1320,932,3031,460,1077,1002,492,2650,381
31522,6767,4338,435,1917,1457,529,1278,2520,285,255,2429,421,761,677,570,2126,303
31523,3400,2728,604,1408,618,98,950,1350,326,102,672,126,242,223,81,546,126
31525,8086,5768,1377,2787,1412,192,2042,2284,913,529,2318,525,875,674,244,1918,400
31527,452,303,25,43,155,80,32,242,13,16,149,0,9,39,101,133,16
31532,204,124,47,33,27,17,55,44,11,14,80,3,17,40,20,78,2
31533,6157,4346,1284,1782,991,289,1473,1621,674,578,1811,262,614,640,295,1515,296
31535,3084,2452,802,1250,372,28,1008,898,380,166,632,146,270,151,65,550,82
31537,2785,2087,498,1001,505,83,727,818,370,172,698,111,199,227,161,632,66
31539,4618,3556,845,1590,904,217,1216,1413,398,529,1062,179,322,348,213,976,86
31542,859,662,163,266,202,31,269,244,86,63,197,52,51,72,22,178,19
31543,1453,1134,284,555,266,29,465,493,129,47,319,36,84,163,36,288,31
31544,332,227,38,110,49,30,45,113,23,46,105,3,26,31,45,98,7
31545,5211,3876,922,1830,970,154,1420,1594,536,326,1335,332,404,379,220,1183,152
31546,2135,1601,291,782,422,106,537,710,170,184,534,50,139,243,102,518,16
31548,5096,4061,1532,2061,438,30,2144,1170,521,226,1035,323,308,298,106,862,173
31549,786,539,111,272,123,33,174,195,108,62,247,19,82,87,59,224,23
31550,300,251,40,150,61,0,122,108,16,5,49,7,18,19,5,46,3
31551,300,211,46,92,63,10,87,104,1,19,89,10,32,16,31,77,12
31552,276,214,104,30,67,13,83,118,9,4,62,10,19,33,0,57,5
31553,1480,1120,294,458,295,73,367,503,152,98,360,44,98,134,84,337,23
31554,1771,1363,386,548,350,79,508,587,135,133,408,38,140,143,87,353,55
31555,922,725,213,315,168,29,273,352,63,37,197,36,50,57,54,177,20
31557,1061,765,155,314,259,37,295,368,39,63,296,41,66,107,82,272,24
31558,6706,5215,2324,2185,588,118,2399,1810,853,153,1491,473,612,304,102,1121,370
31560,905,704,148,306,210,40,240,330,68,66,201,17,43,75,66,194,7
31563,553,359,62,175,87,35,118,181,30,30,194,20,41,75,58,181,13
31565,615,461,76,204,168,13,152,222,34,53,154,21,60,49,24,131,23
31566,963,728,142,368,204,14,299,293,86,50,235,73,94,44,24,181,54
31567,265,165,37,76,46,6,77,75,6,7,100,13,43,21,23,82,18
31568,365,265,49,144,72,0,126,114,16,9,100,0,28,41,31,96,4
31569,1785,1337,240,700,356,41,494,564,182,97,448,75,203,135,35,354,94
31601,10755,7271,2075,3246,1613,337,1941,2057,1939,1334,3484,939,1022,1000,523,2728,756
31602,11372,7024,2021,3242,1396,365,2442,2972,898,712,4348,2018,1036,720,574,3144,1204
31605,5272,4105,1208,2016,793,88,1797,1605,496,207,1167,518,338,236,75,903,264
31606,1355,1087,222,556,256,53,403,439,167,78,268,63,102,86,17,230,38
31620,3804,2774,678,1188,739,169,856,1131,485,302,1030,213,256,349,212,909,121
31622,717,527,155,198,138,36,169,243,76,39,190,18,45,86,41,166,24
31623,62,45,14,24,4,3,18,14,6,7,17,2,10,5,0,17,0
31624,421,334,92,156,64,22,172,130,20,12,87,10,24,35,18,87,0
31625,410,322,50,139,101,32,115,94,32,81,88,10,34,23,21,61,27
31626,1199,825,137,379,230,79,222,299,165,139,374,52,102,151,69,323,51
31627,115,90,19,37,27,7,22,45,17,6,25,5,1,14,5,22,3
31629,423,323,61,128,69,65,73,149,62,39,100,4,16,55,25,96,4
31630,232,154,29,93,27,5,58,63,20,13,78,18,32,18,10,68,10
31631,235,183,48,85,47,3,69,72,15,27,52,3,15,19,15,51,1
31632,2615,2011,515,962,447,87,813,840,248,110,604,123,152,220,109,542,62
31634,1972,1421,371,630,323,97,483,483,240,215,551,68,193,179,111,477,74
31635,1757,1273,273,553,384,63,412,501,178,182,484,87,131,163,103,429,55
31636,3027,2136,560,977,502,97,766,910,324,136,891,152,279,307,153,735,156
31637,1102,832,151,383,250,48,289,386,76,81,270,37,68,105,60,249,21
31638,383,235,56,91,81,7,74,88,29,44,148,15,38,46,49,130,18
31639,3701,2619,654,1150,679,136,863,1143,376,237,1082,146,314,405,217,945,137
31641,442,351,92,205,54,0,171,128,31,21,91,7,36,48,0,79,12
31642,1544,1120,365,500,201,54,432,372,179,137,424,74,138,119,93,356,68
31643,3480,2461,589,1024,664,184,609,987,484,381,1019,63,351,351,254,949,70
31645,1194,915,299,411,174,31,382,320,139,74,279,65,112,60,42,244,35
31646,547,417,99,200,112,6,151,192,61,13,130,5,37,58,30,95,35
31647,985,751,219,341,156,35,295,238,125,93,234,35,58,103,38,199,35
31648,342,285,109,119,53,4,121,85,53,26,57,0,33,24,0,52,5
31649,313,233,89,93,46,5,96,77,49,11,80,26,32,15,7,46,34
31650,1139,842,248,349,219,26,306,340,133,63,297,48,82,105,62,273,24
31699,0,0,0,0,0,0,0,0,0,0,0,0,0,0,0,0,0
31701,8174,5246,1397,2261,1214,374,929,1349,1647,1321,2928,527,923,928,550,2551,377
31705,12729,9415,2503,4441,2106,365,2359,2847,2616,1593,3314,749,1122,1040,403,2781,533
31707,17201,11819,2539,5502,3020,758,3911,5227,1450,1231,5382,1394,1713,1363,912,4611,771
31709,9696,6825,1958,3068,1472,327,1945,2296,1598,986,2871,689,800,866,516,2497,374
31711,383,298,48,138,92,20,107,125,28,38,85,28,24,27,6,76,9
31712,400,269,40,155,52,22,85,137,19,28,131,20,28,33,50,107,24
31713,882,646,105,300,184,57,176,225,129,116,236,31,72,97,36,218,18
31714,2518,1824,443,835,429,117,492,635,418,279,694,77,218,207,192,625,69
31715,735,591,84,290,164,53,127,200,99,165,144,27,35,49,33,124,20
31716,1150,877,174,406,252,45,273,352,134,118,273,29,118,92,34,231,42
31717,8163,5896,1425,2613,1489,369,1738,2153,1204,801,2267,324,716,777,450,2048,219
31720,202,130,43,51,28,8,21,39,45,25,72,6,23,15,28,69,3
31722,124,86,31,19,25,11,37,32,8,9,38,2,14,4,18,27,11
31723,3883,2714,628,1151,702,233,759,982,542,431,1169,67,299,425,378,1060,109
31724,174,130,33,54,20,23,25,55,27,23,44,5,18,7,14,39,5
31725,550,426,90,201,112,23,172,169,51,34,124,23,29,47,25,124,0
31726,279,184,35,87,38,24,65,41,39,39,95,14,32,28,21,82,13
31728,6655,4908,1294,2074,1228,312,1514,1855,823,716,1747,254,492,608,393,1504,243
31729,28,20,6,5,5,4,6,14,0,0,8,0,0,0,8,8,0
31730,3467,2598,695,1028,655,220,620,867,609,502,869,71,335,311,152,786,83
31732,43,15,5,10,0,0,15,0,0,0,28,0,0,18,10,28,0
31733,575,439,62,207,145,25,153,238,14,34,136,9,54,49,24,122,14
31734,851,642,117,328,141,56,251,266,64,61,209,42,52,69,46,199,10
31735,335,247,35,93,76,43,61,159,14,13,88,10,54,24,0,80,8
31736,197,129,23,51,42,13,40,73,4,12,68,4,23,32,9,65,3
31737,2427,1752,347,784,478,143,499,716,282,255,675,101,167,229,178,621,54
31738,779,562,101,277,126,58,167,236,65,94,217,10,66,76,65,202,15
31740,2161,1481,271,664,405,141,334,600,309,238,680,44,164,267,205,657,23
31741,329,208,25,68,94,21,28,98,27,55,121,0,47,54,20,105,16
31742,3570,2608,550,1137,717,204,545,945,623,495,962,129,321,275,237,869,93
31743,247,182,27,111,28,16,41,39,46,56,65,0,26,15,24,59,6
31744,1164,883,209,369,235,70,280,386,107,110,281,51,54,102,74,256,25
31745,3203,2303,541,920,640,202,645,1029,346,283,900,94,250,349,207,805,95
31746,727,488,106,256,79,47,137,165,115,71,239,15,74,73,77,227,12
31747,66,54,14,25,13,2,10,36,2,6,12,0,8,0,4,8,4
31749,796,606,174,282,137,13,261,236,85,24,190,19,86,55,30,151,39
31750,7168,5045,1306,2112,1264,363,1544,1974,878,649,2123,294,592,734,503,1916,207
31751,1006,683,136,268,234,45,81,279,192,131,323,33,116,81,93,285,38
31752,49,32,15,17,0,0,19,7,6,0,17,0,12,5,0,17,0
31754,1052,748,113,318,228,89,163,370,97,118,304,36,88,115,65,274,30
31756,368,288,49,151,80,8,133,103,36,16,80,0,14,42,24,80,0
31757,3630,2833,647,1460,614,112,1096,1117,414,206,797,132,355,164,146,658,139
31759,512,394,68,186,99,41,93,186,62,53,118,25,30,31,32,118,0
31761,335,278,47,131,78,22,59,150,40,29,57,6,24,8,19,50,7
31762,333,231,60,112,43,16,62,100,23,46,102,15,43,17,27,91,11
31763,6324,5251,1390,2799,956,106,2344,1868,702,337,1073,280,371,286,136,901,172
31764,541,428,53,256,97,22,150,181,42,55,113,20,21,43,29,103,10
31765,932,692,168,326,152,46,171,239,151,131,240,28,62,95,55,212,28
31766,346,234,48,112,42,32,70,109,19,36,112,12,49,34,17,108,4
31767,185,146,25,53,68,0,39,65,10,32,39,12,7,9,11,39,0
31768,11964,8486,2226,3533,2175,552,2707,3179,1520,1080,3478,550,902,1139,887,3078,400
31770,1083,761,136,382,203,40,244,284,126,107,322,61,67,126,68,285,37
31771,1608,1237,347,513,295,82,465,537,124,111,371,64,123,98,86,330,41
31772,193,144,48,22,57,17,41,71,15,17,49,0,22,27,0,42,7
31773,1329,1037,229,439,272,97,382,491,77,87,292,44,96,86,66,255,37
31774,2452,1839,527,763,410,139,702,630,299,208,613,80,137,269,127,549,64
31775,993,747,159,330,215,43,274,302,84,87,246,38,64,70,74,218,28
31777,216,154,16,66,57,15,48,71,12,23,62,0,25,18,19,55,7
31778,961,690,103,336,174,77,230,319,58,83,271,36,76,104,55,235,36
31779,2945,2121,435,987,515,184,481,845,464,331,824,118,304,238,164,754,70
31780,859,639,140,272,181,46,191,274,81,93,220,36,95,60,29,206,14
31781,544,399,67,199,101,32,160,151,40,48,145,24,50,33,38,137,8
31783,447,350,84,157,91,18,112,165,26,47,97,25,20,29,23,87,10
31784,301,247,44,134,57,12,74,116,35,22,54,1,10,27,16,54,0
31786,560,392,83,167,118,24,112,145,81,54,168,20,44,53,51,151,17
31787,659,513,127,240,118,28,173,185,91,64,146,7,42,75,22,134,12
31789,569,443,101,210,104,28,178,190,36,39,126,30,23,52,21,118,8
31790,743,602,138,244,179,41,198,298,47,59,141,14,33,56,38,138,3
31791,4775,3623,866,1750,853,154,1280,1231,579,533,1152,116,274,437,325,1026,126
31792,8830,5819,1236,2613,1431,539,1634,2269,1140,776,3011,540,942,854,675,2603,408
31794,12323,8936,2124,4255,2147,410,2820,3594,1625,897,3387,805,987,857,738,2886,501
31795,756,550,121,226,162,41,143,248,83,76,206,51,57,41,57,178,28
31796,435,333,64,167,63,39,127,133,32,41,102,9,12,52,29,84,18
31797,1335,1006,215,462,273,56,364,427,133,82,329,50,84,122,73,299,30
31798,324,262,51,108,70,33,80,121,20,41,62,7,9,31,15,62,0
31801,898,735,173,350,200,12,204,345,121,65,163,21,45,74,23,154,9
31803,1804,1229,291,565,322,51,349,454,231,195,575,72,156,210,137,517,58
31804,1582,1371,224,728,347,72,501,656,98,116,211,34,82,50,45,198,13
31805,1146,850,239,395,194,22,240,340,167,103,296,61,87,110,38,248,48
31806,1418,1031,271,442,286,32,312,404,192,123,387,24,113,157,93,356,31
31807,551,433,76,236,94,27,143,209,30,51,118,0,72,27,19,93,25
31808,1702,1504,301,785,383,35,601,734,86,83,198,29,66,85,18,161,37
31810,106,67,8,25,23,11,15,34,6,12,39,9,13,8,9,34,5
31811,1495,1013,144,479,335,55,320,461,109,123,482,48,149,179,106,428,54
31812,184,120,18,35,45,22,26,43,26,25,64,4,8,24,28,64,0
31814,137,81,0,53,19,9,15,17,12,37,56,15,31,0,10,39,17
31815,887,607,148,241,157,61,138,214,128,127,280,27,77,119,57,257,23
31816,2282,1567,309,689,377,192,422,547,312,286,715,119,222,174,200,650,65
31820,1708,1486,182,916,348,40,748,597,52,89,222,18,127,39,38,182,40
31821,159,110,9,56,30,15,19,56,10,25,49,0,14,6,29,49,0
31822,1830,1362,238,656,374,94,413,618,177,154,468,98,111,99,160,390,78
31823,316,254,17,122,102,13,96,158,0,0,62,6,5,42,9,51,11
31824,654,476,115,208,125,28,132,194,73,77,178,12,45,53,68,165,13
31825,906,616,103,313,162,38,153,225,123,115,290,27,85,120,58,263,27
31826,763,602,86,370,110,36,182,258,89,73,161,11,62,58,30,147,14
31827,892,599,105,327,127,40,174,209,115,101,293,30,96,104,63,251,42
31829,271,239,17,161,45,16,110,87,22,20,32,0,12,13,7,25,7
31830,880,617,107,260,208,42,182,264,90,81,263,33,75,67,88,235,28
31831,970,748,180,337,187,44,239,364,70,75,222,12,50,121,39,212,10
31832,59,46,8,21,17,0,29,13,0,4,13,0,7,2,4,13,0
31833,2621,1851,415,791,498,147,455,702,374,320,770,72,263,236,199,708,62
31836,429,313,96,111,79,27,78,113,62,60,116,6,54,38,18,110,6
31901,3595,1649,729,569,220,131,267,480,644,258,1946,437,545,505,459,1716,230
31903,8539,5620,1754,2401,1122,343,1040,1436,1945,1199,2919,488,1046,995,390,2468,451
31904,12091,8133,1883,3622,1983,645,2447,3212,1363,1111,3958,727,1247,1121,863,3435,523
31905,3895,3725,2645,1080,0,0,2791,580,348,6,170,92,68,10,0,130,40
31906,10227,6118,1600,2406,1567,545,1284,2146,1470,1218,4109,1014,1256,1097,742,3447,662
31907,20553,14848,3584,7124,3446,694,4571,5215,2899,2163,5705,1489,1823,1723,670,4832,873
31909,10803,7976,1856,3940,1801,379,3104,3350,931,591,2827,825,911,712,379,2380,447
32008,1778,1320,225,580,435,80,419,627,167,107,458,71,105,201,81,377,81
32009,967,749,190,403,142,14,365,317,59,8,218,43,101,62,12,195,23
32011,4062,3359,735,1575,912,137,1274,1477,350,258,703,52,237,293,121,641,62
32013,21,21,0,13,8,0,0,8,0,13,0,0,0,0,0,0,0
32024,5579,4326,776,2026,1273,251,1404,2120,495,307,1253,192,298,512,251,1029,224
32025,6428,4345,960,1817,1231,337,1323,1974,595,453,2083,311,575,686,511,1774,309
32033,861,656,96,259,271,30,189,382,58,27,205,21,86,60,38,168,37
32034,10208,7215,1099,3194,2473,449,2185,3924,661,445,2993,468,1022,1039,464,2378,615
32038,2506,1844,220,914,589,121,589,858,164,233,662,66,218,277,101,559,103
32040,2077,1725,465,776,395,89,729,728,161,107,352,73,110,133,36,299,53
32043,7176,5556,951,2794,1608,203,1932,2588,646,390,1620,196,409,657,358,1348,272
32044,510,402,60,205,121,16,148,154,60,40,108,37,20,36,15,73,35
32046,2878,2241,568,1027,511,135,871,973,218,179,637,57,189,257,134,565,72
32052,2264,1643,331,748,452,112,482,694,280,187,621,63,238,203,117,594,27
32053,1210,927,195,387,272,73,275,336,155,161,283,40,104,93,46,211,72
32054,2783,2214,656,972,481,105,861,806,346,201,569,77,175,225,92,499,70
32055,5846,4002,895,1778,1089,240,1175,1546,750,531,1844,233,549,652,410,1526,318
32058,1426,1102,242,520,310,30,410,458,126,108,324,28,116,97,83,294,30
32059,543,403,62,206,119,16,109,206,75,13,140,0,45,52,43,133,7
32060,9233,6603,1360,2707,1984,552,1977,3170,862,594,2630,266,759,930,675,2257,373
32061,59,46,7,10,29,0,0,39,7,0,13,5,8,0,0,8,5
32062,728,619,96,291,188,44,214,270,98,37,109,8,21,62,18,74,35
32063,3681,2918,637,1424,762,95,1091,1152,440,235,763,145,210,288,120,660,103
32065,7106,5720,1181,3140,1238,161,2308,2251,734,427,1386,314,611,336,125,1055,331
32066,1551,1167,271,510,342,44,426,494,146,101,384,36,80,154,114,345,39
32068,12591,10335,2443,5590,2046,256,4253,4084,1424,574,2256,508,835,620,293,1654,602
32071,1346,986,195,411,319,61,284,513,94,95,360,50,86,163,61,293,67
32072,141,103,0,46,39,18,14,55,8,26,38,8,15,8,7,38,0
32073,18073,14051,2581,7511,3336,623,5751,5944,1388,968,4022,1198,1341,1018,465,3259,763
32079,158,96,0,1,28,67,1,95,0,0,62,0,3,22,37,62,0
32082,11885,8118,807,4191,2423,697,2878,4314,617,309,3767,988,1289,955,535,3036,731
32083,430,332,63,206,54,9,141,125,49,17,98,2,60,28,8,80,18
32084,9316,5466,677,2193,1987,609,1208,3319,559,380,3850,900,1069,1084,797,2864,986
32086,9367,6527,981,2903,1860,783,1901,3420,681,525,2840,335,780,1060,665,2295,545
32087,1091,850,210,420,163,57,350,205,161,134,241,55,66,86,34,189,52
32091,5423,3904,862,1754,1059,229,1246,1762,559,337,1519,234,455,528,302,1281,238
32092,2352,1901,272,969,541,119,725,892,147,137,451,93,148,149,61,390,61
32094,1053,769,168,319,237,45,216,457,60,36,284,36,82,132,34,244,40
32095,8484,5370,1066,2545,1397,362,1588,2254,831,697,3114,640,1072,982,420,2353,761
32096,1068,770,135,332,244,59,208,300,109,153,298,58,60,98,82,266,32
32097,3777,2943,697,1478,682,86,1111,1302,289,241,834,117,319,298,100,656,178
32102,1146,780,151,242,265,122,151,462,84,83,366,0,95,216,55,313,53
32110,2146,1452,285,694,422,51,405,631,277,139,694,128,213,242,111,550,144
32112,2810,1898,324,614,680,280,403,1105,244,146,912,101,176,362,273,754,158
32113,2491,1841,297,821,567,156,450,825,327,239,650,68,203,228,151,497,153
32114,13890,6681,1864,2513,1770,534,1036,2410,1886,1349,7209,2643,1853,1612,1101,5441,1768
32117,10454,6074,1494,2552,1499,529,1591,2346,1276,861,4380,882,1365,1097,1036,3483,897
32118,9866,4713,578,1606,1678,851,732,3005,507,469,5153,824,1578,1612,1139,4127,1026
32119,18370,11365,1793,4150,3787,1635,2485,6256,1513,1111,7005,1447,1757,2101,1700,5543,1462
32124,3992,3177,296,1276,1257,348,861,2044,72,200,815,43,259,348,165,669,146
32127,13101,8701,985,3592,3050,1074,2124,5068,840,669,4400,488,1163,1638,1111,3533,867
32130,1624,1214,250,523,352,89,452,479,148,135,410,40,177,105,88,302,108
32131,1794,1267,146,555,427,139,369,651,108,139,527,75,158,218,76,409,118
32132,3018,1992,353,730,689,220,460,1080,287,165,1026,80,281,363,302,844,182
32134,3568,2315,257,948,886,224,514,1375,175,251,1253,58,267,628,300,1040,213
32136,3420,2102,123,798,872,309,372,1466,103,161,1318,101,343,526,348,1128,190
32137,9502,7137,581,2140,3261,1155,1478,4953,360,346,2365,175,379,1052,759,1959,406
32138,65,51,12,21,14,4,21,30,0,0,14,0,7,0,7,14,0
32139,237,155,7,61,87,0,54,93,0,8,82,11,18,26,27,82,0
32140,622,498,81,213,192,12,141,256,57,44,124,10,57,46,11,97,27
32141,6521,4867,501,1874,1792,700,1222,2862,425,358,1654,106,469,691,388,1286,368
32145,1374,1013,288,456,252,17,356,411,170,76,361,40,132,126,63,272,89
32147,281,220,34,119,50,17,57,106,50,7,61,6,13,8,34,42,19
32148,4397,3003,564,1214,910,315,865,1391,462,285,1394,177,360,529,328,1115,279
32157,434,303,40,87,123,53,60,211,21,11,131,9,47,49,26,117,14
32159,13970,10391,546,1101,6721,2023,704,8983,331,373,3579,147,386,1801,1245,3128,451
32164,5807,4652,585,1630,1910,527,1220,2793,377,262,1155,124,187,572,272,954,201
32168,8967,5819,641,2169,2047,962,1206,3370,586,657,3148,380,873,1039,856,2627,521
32169,5313,3260,254,1024,1435,547,421,2395,191,253,2053,186,492,762,613,1691,362
32174,17200,11956,1276,5023,4185,1472,3176,6712,1081,987,5244,559,1441,1741,1503,4358,886
32176,7750,4722,402,1549,1856,915,815,3129,408,370,3028,333,690,1029,976,2541,487
32177,9634,6758,1542,2813,1993,410,1980,2938,1150,690,2876,371,752,1030,723,2505,371
32179,3377,2397,451,941,741,264,638,1284,285,190,980,58,228,457,237,835,145
32180,1196,942,173,470,265,34,376,415,110,41,254,12,77,103,62,233,21
32181,664,461,84,193,131,53,146,245,43,27,203,27,39,120,17,178,25
32182,66,57,10,38,9,0,26,31,0,0,9,0,0,0,9,9,0
32183,57,57,15,9,33,0,15,30,0,12,0,0,0,0,0,0,0
32185,27,27,4,11,12,0,4,11,3,9,0,0,0,0,0,0,0
32187,785,572,92,253,185,42,167,295,65,45,213,32,71,60,50,196,17
32189,2591,1781,271,541,749,220,364,1104,159,154,810,11,183,454,162,660,150
32190,448,303,61,90,117,35,116,152,18,17,145,0,64,56,25,145,0
32193,409,259,33,56,142,28,38,190,12,19,150,11,30,58,51,128,22
32195,1226,893,90,446,300,57,298,473,82,40,333,12,146,86,89,288,45
32202,1386,288,61,91,61,75,40,123,70,55,1098,34,168,476,420,1022,76
32204,3258,1465,444,612,318,91,350,283,424,408,1793,560,623,309,301,1427,366
32205,13379,7380,2198,3222,1407,553,2071,2912,1458,939,5999,1651,2071,1302,975,4760,1239
32206,8461,4751,1279,2114,1017,341,796,1021,1732,1202,3710,511,1453,1227,519,3193,517
32207,15165,8613,2152,3898,1827,736,2542,3349,1590,1132,6552,1571,2141,1724,1116,5486,1066
32208,12548,8883,1452,4435,2428,568,1972,2946,1852,2113,3665,236,1176,1427,826,3246,419
32209,15119,10098,2368,3696,2932,1102,1391,2441,3109,3157,5021,384,1477,1853,1307,4434,587
32210,22731,15693,4122,7034,3481,1056,4919,5939,3104,1731,7038,1521,2619,1748,1150,5734,1304
32211,13951,8791,2743,3771,1703,574,2454,3103,2166,1068,5160,1699,1805,1139,517,4187,973
32212,349,349,233,116,0,0,224,4,111,10,0,0,0,0,0,0,0
32215,198,184,103,71,10,0,136,16,32,0,14,14,0,0,0,6,8
32216,11702,7908,1878,3641,1850,539,2466,3421,1255,766,3794,974,1457,962,401,3112,682
32217,8521,5452,1052,2758,1192,450,1812,2279,788,573,3069,736,950,769,614,2596,473
32218,13771,10273,2448,5235,2282,308,3273,3986,1914,1100,3498,668,1426,997,407,2872,626
32219,3582,2641,553,1185,763,140,798,1109,388,346,941,138,331,310,162,816,125
32220,3848,2899,658,1526,657,58,1110,1215,402,172,949,108,387,318,136,754,195
32221,6242,4961,1218,2454,1078,211,1801,2125,628,407,1281,238,496,424,123,1012,269
32222,1531,1155,287,510,308,50,426,382,181,166,376,73,166,108,29,288,88
32223,9627,7482,1110,4370,1712,290,3076,3352,624,430,2145,544,848,572,181,1683,462
32224,12601,8288,2583,4163,1253,289,3447,3439,924,478,4313,2267,1217,539,290,2850,1463
32225,16572,12693,3010,7024,2308,351,5657,4929,1363,744,3879,1243,1471,878,287,2958,921
32226,2982,2346,381,1268,643,54,826,1158,219,143,636,89,278,184,85,472,164
32227,594,594,336,258,0,0,517,31,46,0,0,0,0,0,0,0,0
32233,9785,6667,1975,3292,953,447,2501,2486,1143,537,3118,906,1184,628,400,2212,906
32234,2228,1739,360,966,356,57,619,776,200,144,489,81,129,220,59,374,115
32244,17295,12686,3614,6507,2117,448,4811,4271,2478,1126,4609,1237,1887,1114,371,3645,964
32246,13265,9625,3005,4855,1534,231,3781,3319,1534,991,3640,1202,1431,757,250,2719,921
32250,10937,6172,1148,3133,1479,412,1810,3177,636,549,4765,1508,1714,997,546,3646,1119
32254,5417,3741,901,1910,783,147,1005,1045,1000,691,1676,178,724,563,211,1379,297
32256,14112,7047,2480,2988,1284,295,2223,3357,838,629,7065,3751,1952,887,475,5341,1724
32257,14825,9808,2290,5343,1798,377,3927,3919,1345,617,5017,1469,1842,1029,677,4082,935
32258,4292,3522,740,2230,498,54,1808,1325,215,174,770,61,382,215,112,588,182
32259,5998,5229,663,3396,984,186,2660,2086,340,143,769,100,310,186,173,641,128
32266,3270,1878,299,1012,429,138,670,807,197,204,1392,411,490,337,154,1025,367
32277,10843,7606,2045,3558,1708,295,2586,2939,1352,729,3237,884,1167,789,397,2605,632
32301,12292,4905,1850,1986,791,278,1040,1855,1127,883,7387,4185,1879,772,551,5232,2155
32303,19287,10535,3009,5221,1800,505,3439,4108,1716,1272,8752,4445,2197,1389,721,5583,3169
32304,15314,4196,1916,1403,664,213,580,1310,1258,1048,11118,9002,1272,534,310,5840,5278
32308,18114,12242,2172,6679,2747,644,4594,5081,1449,1118,5872,1787,1879,1404,802,4820,1052
32310,11893,7620,2272,3476,1522,350,1963,2462,1940,1255,4273,1468,1509,966,330,3439,834
32311,9608,7104,1385,3992,1554,173,2498,2892,1179,535,2504,548,1116,622,218,2082,422
32312,10325,8326,939,5034,2017,336,3995,3365,662,304,1999,374,754,623,248,1646,353
32320,1473,990,187,451,256,96,274,455,150,111,483,79,149,185,70,425,58
32321,1577,1130,241,542,300,47,361,465,201,103,447,87,105,156,99,386,61
32322,1070,725,107,273,276,69,164,419,86,56,345,20,99,178,48,315,30
32323,228,90,17,0,43,30,4,60,13,13,138,27,35,34,42,116,22
32324,1780,1253,299,464,368,122,271,529,236,217,527,50,141,198,138,512,15
32327,6720,5078,1142,2618,1161,157,1860,1917,840,461,1642,282,772,431,157,1357,285
32328,1196,830,159,285,350,36,191,451,151,37,366,25,124,168,49,289,77
32330,310,241,71,100,54,16,98,79,30,34,69,18,11,31,9,62,7
32331,1526,1120,120,549,345,106,328,432,161,199,406,51,115,140,100,386,20
32332,635,508,120,251,106,31,128,114,166,100,127,19,66,29,13,106,21
32333,4584,3337,575,1680,852,230,929,1477,534,397,1247,145,583,320,199,1020,227
32334,625,398,88,196,114,0,156,166,42,34,227,35,60,110,22,185,42
32335,10,5,0,0,0,5,0,5,0,0,5,0,5,0,0,5,0
32336,428,322,50,124,105,43,79,150,21,72,106,13,22,65,6,83,23
32337,6,6,0,0,6,0,0,6,0,0,0,0,0,0,0,0,0
32340,4305,3059,585,1220,927,327,763,1264,538,494,1246,122,364,469,291,1085,161
32343,436,337,85,167,62,23,81,89,109,58,99,9,56,25,9,90,9
32344,3774,2598,521,1160,714,203,772,1133,390,303,1176,185,404,333,254,1020,156
32346,984,670,45,309,275,41,114,339,109,108,314,16,156,101,41,268,46
32347,6320,4558,1014,2028,1218,298,1402,1926,737,493,1762,207,621,567,367,1529,233
32350,435,315,68,178,35,34,124,91,61,39,120,8,46,31,35,111,9
32351,8097,5872,1242,2693,1610,327,1589,1989,1145,1149,2225,269,714,697,545,2003,222
32355,137,68,20,27,15,6,18,36,12,2,69,9,26,30,4,62,7
32356,31,26,0,14,12,0,8,18,0,0,5,0,0,5,0,5,0
32357,54,49,7,20,14,8,13,29,7,0,5,5,0,0,0,5,0
32358,744,527,77,242,170,38,180,263,39,45,217,55,33,73,56,202,15
32359,637,412,52,107,217,36,85,276,21,30,225,9,50,99,67,187,38
32360,11,11,0,3,8,0,0,11,0,0,0,0,0,0,0,0,0
32361,184,140,28,82,30,0,71,60,0,9,44,12,7,8,17,44,0
32399,0,0,0,0,0,0,0,0,0,0,0,0,0,0,0,0,0
32401,10394,6030,1399,2681,1464,486,1542,2437,1317,734,4364,895,1224,1408,837,3674,690
32403,648,640,400,240,0,0,503,82,55,0,8,8,0,0,0,0,8
32404,12950,9493,2060,4534,2478,421,3045,4130,1468,850,3457,880,1138,1087,352,2765,692
32405,10672,7246,1598,3164,2012,472,2261,3339,853,793,3426,784,1231,870,541,2818,608
32407,2607,1815,308,747,644,116,519,1019,135,142,792,172,355,171,94,642,150
32408,5837,3478,653,1607,1009,209,1054,1792,378,254,2359,613,863,648,235,1866,493
32409,2785,2152,469,1029,571,83,773,989,226,164,633,92,185,246,110,519,114
32410,76,41,2,15,18,6,5,29,2,5,35,0,14,6,15,31,4
32413,4197,2675,455,1095,947,178,693,1586,232,164,1522,260,474,570,218,1237,285
32420,698,516,97,198,168,53,180,242,48,46,182,14,47,86,35,144,38
32421,1425,1031,257,503,226,45,465,390,118,58,394,60,100,166,68,367,27
32422,15,15,0,0,15,0,0,15,0,0,0,0,0,0,0,0,0
32423,484,351,60,146,128,17,71,209,31,40,133,21,18,43,51,126,7
32424,2306,1603,318,647,472,166,484,666,224,229,703,123,180,207,193,629,74
32425,4198,3010,645,1201,940,224,989,1425,342,254,1188,212,265,397,314,1082,106
32426,443,306,70,136,76,24,91,114,54,47,137,12,37,38,50,127,10
32427,1138,746,139,305,247,55,211,334,92,109,392,25,116,165,86,343,49
32428,5511,4011,853,1647,1221,290,1275,1883,494,359,1500,185,473,516,326,1360,140
32430,427,294,38,145,80,31,75,147,32,40,133,20,23,68,22,131,2
32431,1786,1240,249,593,330,68,282,626,212,120,546,49,135,152,210,509,37
32432,40,33,12,21,0,0,13,8,12,0,7,0,0,0,7,7,0
32433,7240,5172,1028,2150,1616,378,1449,2488,747,488,2068,197,661,798,412,1857,211
32437,235,170,31,74,51,14,58,69,19,24,65,13,23,26,3,55,10
32438,1242,918,188,440,225,65,326,452,95,45,324,23,183,89,29,241,83
32439,2578,1760,351,839,488,82,617,808,228,107,818,84,229,328,177,678,140
32440,2177,1507,333,624,469,81,549,682,137,139,670,107,162,173,228,596,74
32442,1239,904,221,343,292,48,310,444,83,67,335,54,116,106,59,317,18
32443,1218,915,186,427,223,79,254,355,186,120,303,38,80,110,75,275,28
32444,6114,4612,724,2330,1282,276,1612,2189,511,300,1502,302,513,451,236,1262,240
32445,478,322,55,167,86,14,85,128,45,64,156,8,37,59,52,148,8
32446,3667,2565,507,1152,716,190,795,1208,360,202,1102,138,219,443,302,1007,95
32447,19,7,0,0,7,0,0,7,0,0,12,0,0,12,0,12,0
32448,3390,2386,573,992,611,210,651,1007,465,263,1004,86,292,365,261,923,81
32449,225,185,39,47,92,7,36,121,0,28,40,3,5,22,10,37,3
32455,1527,1028,211,485,263,69,375,457,109,87,499,55,129,213,102,407,92
32456,3270,2321,338,919,854,210,561,1220,267,273,949,88,261,352,248,864,85
32459,2674,1695,303,754,537,101,395,960,166,174,979,179,448,276,76,770,209
32460,1573,1078,270,419,313,76,311,542,143,82,495,90,138,147,120,437,58
32462,1174,823,148,354,251,70,268,404,76,75,351,22,81,123,125,304,47
32463,49,33,6,12,13,2,6,17,8,2,16,0,4,8,4,16,0
32464,1554,1112,246,461,298,107,368,571,86,87,442,62,134,146,100,404,38
32465,2095,1508,285,659,445,119,451,755,177,125,587,38,158,276,115,540,47
32466,2038,1527,337,836,343,11,586,701,177,63,511,98,184,195,34,402,109
32501,6419,3379,678,1347,963,391,578,1099,807,895,3040,549,1100,762,629,2534,506
32503,12888,7846,1327,3220,2286,1013,1794,3493,1241,1318,5042,1071,1698,1437,836,4291,751
32504,10146,6458,1136,3006,1720,596,1942,2891,982,643,3688,1186,1048,1016,438,3007,681
32505,10778,7494,1911,3221,1927,435,1454,2468,2117,1455,3284,502,1148,1069,565,2648,636
32506,12964,8837,2431,3590,2203,613,2892,3544,1596,805,4127,976,1470,1123,558,3263,864
32507,11589,7657,1843,3194,1907,713,2185,3399,1303,770,3932,709,1614,1007,602,3190,742
32508,385,385,247,138,0,0,276,49,60,0,0,0,0,0,0,0,0
32514,14375,8755,2235,3620,2325,575,2488,4271,1187,809,5620,1959,1716,1038,907,4357,1263
32526,11838,8820,1619,4422,2311,468,2688,3996,1344,792,3018,507,989,1032,490,2458,560
32531,1605,1278,288,569,373,48,554,562,101,61,327,11,115,111,90,304,23
32533,8631,7044,1157,3696,1881,310,2632,3014,832,566,1587,238,595,532,222,1390,197
32534,4854,3389,773,1392,1013,211,965,1457,455,512,1465,267,533,510,155,1234,231
32535,1936,1427,320,606,408,93,414,598,258,157,509,51,132,214,112,469,40
32536,4967,3842,893,1937,850,162,1491,1552,500,299,1125,154,360,406,205,1001,124
32539,6830,5217,1281,2559,1197,180,1971,2207,674,365,1613,301,473,643,196,1342,271
32541,7012,4516,599,1918,1638,361,1203,2697,406,210,2496,587,909,739,261,1947,549
32542,2544,2408,1707,701,0,0,1731,441,236,0,136,105,31,0,0,105,31
32544,709,694,425,265,4,0,505,123,66,0,15,15,0,0,0,15,0
32547,12279,7497,1900,3384,1805,408,2168,3446,1236,647,4782,1653,1601,1141,387,3648,1134
32548,9611,5971,1159,2658,1775,379,1544,2888,975,564,3640,925,1203,996,516,2835,805
32561,10560,7658,994,3999,2223,442,2688,3936,721,313,2902,477,1115,861,449,2359,543
32564,878,675,148,246,237,44,219,296,58,102,203,19,127,37,20,136,67
32565,1992,1523,280,686,461,96,475,770,150,128,469,54,95,189,131,452,17
32566,7836,6116,1228,3308,1345,235,2647,2740,514,215,1720,381,755,433,151,1317,403
32567,1506,1094,152,470,374,98,305,536,130,123,412,24,113,175,100,392,20
32568,1174,941,181,376,337,47,287,479,74,101,233,35,95,66,37,200,33
32569,4478,3169,687,1667,717,98,1207,1464,344,154,1309,409,501,316,83,1001,308
32570,9318,7021,1754,3010,1913,344,2289,3010,1093,629,2297,431,698,807,361,1968,329
32571,8608,6874,1390,3756,1475,253,2885,2818,854,317,1734,292,748,513,181,1328,406
32577,1716,1354,221,681,387,65,558,632,123,41,362,42,145,116,59,323,39
32578,10777,8326,1022,4461,2403,440,2936,4194,767,429,2451,517,701,871,362,2014,437
32579,4279,2912,353,1340,932,287,865,1547,278,222,1367,215,458,462,232,1131,236
32580,1687,1147,205,462,354,126,326,584,144,93,540,85,233,144,78,483,57
32583,6645,4974,1166,2240,1384,184,1809,2243,554,368,1671,176,671,591,233,1340,331
32601,7708,2252,858,935,360,99,423,804,439,586,5456,3801,901,467,287,3105,2351
32603,2422,786,479,249,19,39,275,380,59,72,1636,1393,106,94,43,981,655
32605,9356,6069,1086,3051,1422,510,2183,2800,634,452,3287,1000,1028,719,540,2402,885
32606,7351,4763,937,2477,1032,317,1852,2087,491,333,2588,888,694,595,411,2059,529
32607,11729,5134,1833,2219,916,166,1516,1964,959,695,6595,4797,1153,478,167,3974,2621
32608,16662,6820,2648,2739,1119,314,2089,2843,1056,832,9842,7490,1399,660,293,4921,4921
32609,6602,3854,1104,1801,707,242,903,1398,1027,526,2748,849,1057,557,285,2125,623
32615,4246,3160,473,1644,837,206,1116,1397,301,346,1086,190,468,270,158,875,211
32616,423,255,52,121,66,16,56,89,76,34,168,27,32,67,42,128,40
32617,1272,1014,160,508,298,48,350,444,99,121,258,25,91,102,40,197,61
32618,2631,1881,330,917,539,95,646,847,216,172,750,92,314,220,124,602,148
32619,1493,1129,195,545,304,85,355,547,143,84,364,39,102,159,64,312,52
32621,1178,907,215,365,223,104,283,384,164,76,271,23,59,124,65,246,25
32622,583,446,89,202,121,34,207,146,39,54,137,20,38,60,19,119,18
32625,711,489,38,208,192,51,117,283,59,30,222,27,58,115,22,178,44
32626,3192,2194,429,851,716,198,611,1072,336,175,998,126,229,382,261,833,165
32628,1507,1074,235,461,316,62,314,462,161,137,433,75,91,159,108,356,77
32639,139,102,7,35,44,16,18,71,5,8,37,0,0,29,8,37,0
32640,4156,2989,532,1265,931,261,806,1534,360,289,1167,142,438,344,243,944,223
32641,4749,3540,981,1475,902,182,643,950,1247,700,1209,133,477,420,179,970,239
32643,3388,2499,466,1260,644,129,954,1039,299,207,889,97,295,338,159,690,199
32648,147,113,11,53,42,7,50,52,3,8,34,0,9,24,1,27,7
32653,5214,3703,639,2054,814,196,1351,1575,418,359,1511,349,497,438,227,1205,306
32654,83,56,0,21,19,16,5,45,0,6,27,0,14,13,0,27,0
32656,4580,3400,550,1566,987,297,1137,1743,311,209,1180,86,315,463,316,990,190
32658,61,39,0,9,25,5,5,26,3,5,22,0,6,10,6,20,2
32662,29,29,0,4,25,0,0,16,4,9,0,0,0,0,0,0,0
32664,269,172,15,71,74,12,38,123,2,9,97,13,22,39,23,89,8
32666,2043,1359,115,508,605,131,266,728,116,249,684,78,252,169,185,602,82
32667,1345,893,58,430,335,70,167,542,90,94,452,39,235,105,73,360,92
32668,1535,1064,143,490,379,52,287,603,114,60,471,22,155,180,114,386,85
32669,2800,2046,366,1071,491,118,844,844,212,146,754,121,284,244,105,624,130
32680,3181,2242,239,1014,765,224,564,1176,285,217,939,65,235,485,154,756,183
32681,195,104,28,25,30,21,61,33,0,10,91,0,50,34,7,80,11
32683,67,42,9,9,16,8,8,21,0,13,25,0,0,18,7,25,0
32686,1913,1446,177,768,403,98,446,635,148,217,467,118,117,181,51,365,102
32692,270,137,0,11,102,24,0,127,0,10,133,9,40,63,21,112,21
32693,3318,2346,499,996,689,162,713,1116,332,185,972,107,316,341,208,806,166
32694,835,552,100,270,141,41,158,259,96,39,283,18,90,95,80,245,38
32696,4169,2878,550,1228,824,276,813,1292,392,381,1291,200,390,443,258,1012,279
32697,175,129,45,56,25,3,42,40,40,7,46,7,26,11,2,33,13
32701,10097,5619,1360,2358,1481,420,1673,2336,716,894,4478,1268,1622,967,621,3578,900
32702,1076,727,168,234,246,79,156,371,122,78,349,49,106,104,90,314,35
32703,15479,11125,2794,5654,2199,478,4047,4000,1809,1269,4354,1180,1603,1116,455,3354,1000
32706,58,28,23,5,0,0,22,6,0,0,30,0,25,5,0,30,0
32707,13497,8728,1668,4420,2061,579,2840,3856,1113,919,4769,1387,1674,1169,539,3642,1127
32708,14195,10848,1797,6151,2331,569,4455,4628,1054,711,3347,610,1269,964,504,2613,734
32709,817,561,67,292,183,19,179,233,94,55,256,22,102,110,22,189,67
32712,10436,8300,1646,4198,2091,365,3245,3586,816,653,2136,249,716,768,403,1705,431
32713,6839,4933,634,2077,1695,527,1412,2755,342,424,1906,139,490,678,599,1570,336
32714,14682,8723,2385,4151,1831,356,2869,3349,1526,979,5959,2577,1983,1040,359,4473,1486
32720,10477,6820,1141,2718,2193,768,1738,3261,876,945,3657,664,966,990,1037,2897,760
32724,10528,6883,1066,2739,2085,993,1864,3644,711,664,3645,433,757,1322,1133,3116,529
32725,14371,10957,1750,4663,3229,1315,3391,5348,1114,1104,3414,420,992,1072,930,2692,722
32726,7477,4923,907,1934,1383,699,1226,2631,730,336,2554,376,536,768,874,2174,380
32730,2606,1564,374,560,448,182,388,770,149,257,1042,192,257,354,239,848,194
32732,1835,1442,169,885,354,34,474,702,162,104,393,40,165,138,50,295,98
32735,1141,848,134,231,257,226,218,598,23,9,293,11,29,140,113,258,35
32736,2950,2402,267,1346,643,146,918,1174,155,155,548,26,267,200,55,429,119
32738,11619,9489,1916,4895,2231,447,3852,3736,1245,656,2130,378,889,604,259,1572,558
32744,1216,842,126,382,246,88,206,449,98,89,374,34,113,146,81,310,64
32746,11256,8207,1863,4403,1634,307,3476,3464,784,483,3049,896,1311,569,273,2359,690
32750,8767,6591,1084,3533,1609,365,2395,2875,710,611,2176,353,859,569,395,1618,558
32751,7250,5025,628,2480,1500,417,1789,2186,543,507,2225,383,826,613,403,1834,391
32754,3553,2612,355,1229,829,199,719,1328,394,171,941,118,269,313,241,745,196
32757,7862,5265,898,2051,1655,661,1356,2921,587,401,2597,332,594,815,856,2182,415
32759,1024,711,106,246,304,55,162,400,75,74,313,48,92,108,65,269,44
32763,6761,4259,702,1606,1298,653,1084,2298,506,371,2502,193,616,817,876,2149,353
32764,971,656,78,266,239,73,186,410,25,35,315,24,97,74,120,262,53
32765,14951,12020,2432,6913,2253,422,5907,4473,909,731,2931,1026,908,606,391,1962,969
32766,2409,2022,392,1173,380,77,995,744,160,123,387,80,197,90,20,293,94
32767,735,476,84,163,169,60,111,210,104,51,259,30,118,90,21,182,77
32771,11593,7811,1720,3624,1908,559,1978,3216,1432,1185,3782,666,1348,1118,650,3008,774
32773,8416,5712,1508,2887,1068,249,1976,2135,1017,584,2704,674,935,693,402,1981,723
32775,207,154,29,85,40,0,33,91,20,10,53,0,22,21,10,40,13
32776,2466,1881,340,994,464,83,716,921,183,61,585,109,164,194,118,410,175
32778,6552,4247,489,1216,1647,895,717,2755,403,372,2305,161,375,894,875,2032,273
32779,10843,8706,557,5283,2418,448,3718,3903,580,505,2137,370,791,588,388,1756,381
32780,13590,8883,1265,3604,3185,829,2078,4760,1172,873,4707,686,1390,1593,1038,4012,695
32784,3550,2638,508,1093,783,254,767,1338,251,282,912,93,214,350,255,766,146
32789,10375,5801,1050,2646,1541,564,1769,2784,622,626,4574,960,1550,1134,930,3724,850
32792,22264,12178,2738,5594,2857,989,3588,5133,2051,1406,10086,4689,2430,1489,1478,7114,2972
32796,8050,5603,968,2451,1698,486,1713,2656,781,453,2447,319,708,885,535,2022,425
32798,891,583,5,38,301,239,15,533,8,27,308,0,14,121,173,286,22
32801,4753,1236,322,388,244,282,180,711,178,167,3517,996,690,669,1162,3020,497
32803,10360,4716,1090,2037,1014,575,1249,2292,567,608,5644,2000,1926,1040,678,4111,1533
32804,8506,4508,946,2120,962,480,1366,2124,592,426,3998,1126,1678,616,578,3034,964
32805,8920,5556,1388,2477,1332,359,975,1288,1795,1498,3364,548,1374,986,456,2526,838
32806,11161,6734,1290,3231,1622,591,2017,3135,890,692,4427,1283,1757,804,583,3377,1050
32807,10793,7029,1672,3312,1655,390,2177,2615,1265,972,3764,1312,1144,868,440,2586,1178
32808,16389,11943,3673,5643,2198,429,3313,3515,3558,1557,4446,988,1680,1175,603,3486,960
32809,8056,5747,1217,2666,1516,348,1762,2189,929,867,2309,443,993,586,287,1747,562
32810,12135,8247,2089,4355,1470,333,2737,2778,1759,973,3888,1428,1504,636,320,2902,986
32811,12878,7505,2607,3191,1506,201,1731,2003,1962,1809,5373,2842,1629,711,191,3572,1801
32812,14468,9541,2210,4800,1897,634,3302,3866,1407,966,4927,1440,1887,1164,436,3772,1155
32817,10418,6811,1739,3573,1266,233,2665,2736,777,633,3607,2067,935,444,161,1833,1774
32818,11841,8990,1781,5012,1835,362,3302,3133,1564,991,2851,746,1039,753,313,2149,702
32819,8500,6637,838,3817,1682,300,2718,2624,771,524,1863,612,806,307,138,1388,475
32820,1049,824,182,418,191,33,274,364,125,61,225,66,61,88,10,154,71
32821,6452,3484,845,1206,944,489,806,2034,232,412,2968,1437,873,341,317,1949,1019
32822,20975,13324,3886,5984,2866,588,3997,5175,2430,1722,7651,2838,2547,1561,705,5640,2011
32824,5947,4961,996,2710,1106,149,2211,1766,527,457,986,187,509,232,58,650,336
32825,14512,10521,2831,5428,1882,380,4266,3703,1403,1149,3991,1764,1434,620,173,2467,1524
32826,8591,4394,1601,1764,744,285,1501,1713,633,547,4197,2833,704,348,312,1868,2329
32827,744,592,133,374,75,10,230,243,108,11,152,44,79,29,0,121,31
32828,7750,6117,1690,3446,829,152,2984,2156,535,442,1633,939,429,235,30,1010,623
32829,1144,967,135,591,231,10,395,368,108,96,177,41,71,56,9,103,74
32831,26,17,8,9,0,0,9,0,8,0,9,0,9,0,0,9,0
32832,718,539,59,311,163,6,197,293,42,7,179,35,98,46,0,128,51
32833,1825,1419,239,726,375,79,423,608,242,146,406,95,208,87,16,261,145
32835,12678,7769,2052,4391,1197,129,3073,2725,1157,814,4909,2678,1602,479,150,3389,1520
32836,4195,3377,483,2159,647,88,1675,1310,265,127,818,304,287,129,98,671,147
32837,11625,9090,2041,5355,1504,190,4040,3247,1167,636,2535,878,1044,421,192,1713,822
32839,13481,8797,3209,3914,1434,240,2709,2750,2228,1110,4684,1943,1784,769,188,3255,1429
32901,9693,5233,912,1757,1699,865,920,2654,866,793,4460,964,964,1114,1418,3779,681
32903,5638,3722,295,1709,1285,433,1072,2112,235,303,1916,401,614,435,466,1515,401
32904,7911,5161,557,2041,1763,800,1271,3080,398,412,2750,327,760,787,876,2338,412
32905,9877,5768,1354,2213,1577,624,1340,2607,1116,705,4109,910,1131,1269,799,3323,786
32907,12161,9659,1415,4930,2621,693,3626,4337,1027,669,2502,273,886,844,499,1968,534
32908,2019,1565,382,813,319,51,601,597,268,99,454,105,223,102,24,319,135
32909,6446,5067,867,2890,1097,213,2037,1995,615,420,1379,310,579,399,91,1017,362
32920,5305,2218,310,807,745,356,274,1393,336,215,3087,645,1171,986,285,2528,559
32922,6689,3900,930,1779,914,277,855,1310,1137,598,2789,628,915,801,445,2309,480
32925,543,526,278,248,0,0,379,83,58,6,17,6,11,0,0,17,0
32926,7475,5584,815,2612,1821,336,1592,2812,739,441,1891,255,681,658,297,1497,394
32927,8880,6747,1306,3713,1456,272,2776,2483,919,569,2133,325,989,608,211,1576,557
32931,7568,4125,233,1437,1586,869,728,2781,294,322,3443,423,1127,1145,748,2867,576
32934,5605,4151,441,2070,1287,353,1471,2167,260,253,1454,321,365,501,267,1181,273
32935,17848,10939,2171,4739,2976,1053,3245,5123,1396,1175,6909,1610,2474,1752,1073,5575,1334
32937,11492,8062,989,3446,2622,1005,2388,4307,761,606,3430,425,1021,1186,798,2907,523
32940,7932,5969,619,2212,2153,985,1721,3885,175,188,1963,254,467,694,548,1672,291
32948,1295,1060,335,427,256,42,484,392,104,80,235,32,88,89,26,176,59
32949,291,226,9,70,139,8,37,155,22,12,65,0,12,23,30,59,6
32950,1724,1339,112,671,461,95,383,716,104,136,385,51,140,161,33,304,81
32951,4883,3413,163,1337,1415,498,767,2290,144,212,1470,175,432,540,323,1180,290
32952,8360,5912,579,2869,1921,543,1804,3022,621,465,2448,232,780,822,614,2036,412
32953,9051,6115,850,2810,1987,468,1700,3043,847,525,2936,485,937,924,590,2406,530
32955,10436,7654,1075,3515,2426,638,2381,3941,718,614,2782,463,929,886,504,2299,483
32958,9014,6366,653,2199,2471,1043,1363,3964,569,470,2648,127,778,1024,719,2234,414
32960,9401,5080,923,1912,1534,711,1163,2523,715,679,4321,781,1111,1253,1176,3616,705
32962,8797,5997,1051,2178,1737,1031,1468,3263,767,499,2800,219,614,1084,883,2409,391
32963,6964,4945,82,1127,2413,1323,696,3969,98,182,2019,63,411,847,698,1760,259
32966,6367,3945,229,999,1419,1298,601,2945,148,251,2422,90,275,787,1270,2237,185
32967,4315,3038,620,1223,952,243,840,1320,531,347,1277,158,421,462,236,1003,274
32968,2999,2439,403,1232,673,131,978,1131,200,130,560,120,213,152,75,403,157
32970,44,31,0,10,15,6,0,7,10,14,13,0,13,0,0,13,0
32976,5310,3209,85,507,1610,1007,196,2723,90,200,2101,40,330,768,963,1817,284
33001,289,174,8,56,30,80,29,141,4,0,115,5,41,67,2,99,16
33004,6923,3668,720,1710,940,298,727,1596,805,540,3255,745,1064,922,524,2472,783
33009,17879,8677,1491,2591,2798,1797,1412,5099,1033,1133,9202,1054,2226,2857,3065,7994,1208
33010,14702,11123,1895,4872,3393,963,3227,4414,1537,1945,3579,347,910,1454,868,2861,718
33012,24363,19492,2902,7640,6947,2003,5771,8383,1946,3392,4871,425,1142,1931,1373,3954,917
33013,9792,8170,1161,3000,3189,820,2306,3871,680,1313,1622,145,411,707,359,1340,282
33014,13438,10164,2066,4946,2691,461,3502,3686,1541,1435,3274,697,1066,1048,463,2655,619
33015,16727,12859,3601,6635,2409,214,5139,3980,2213,1527,3868,1554,1420,689,205,2866,1002
33016,13112,11267,2632,5704,2574,357,4587,3388,1754,1538,1845,252,702,667,224,1343,502
33018,10553,9751,2194,5438,1890,229,4497,3043,1242,969,802,179,313,274,36,570,232
33019,9948,4556,445,1505,1483,1123,799,3190,200,367,5392,911,1512,1297,1672,4628,764
33020,18089,9193,2510,4401,1702,580,2341,3421,1990,1441,8896,1941,3566,2082,1307,7235,1661
33021,20318,12227,1905,5183,3596,1543,3274,6193,1464,1296,8091,1579,2156,1926,2430,6705,1386
33023,19705,15258,3447,8048,2951,812,5401,4399,3063,2395,4447,870,1506,1200,871,3567,880
33024,20797,15237,3151,8075,3145,866,5443,5186,2565,2043,5560,952,2148,1442,1018,4347,1213
33025,16870,12040,3355,6316,1689,680,4473,3744,2206,1617,4830,1389,1863,915,663,3780,1050
33026,11494,8315,1055,4828,1826,606,3372,3159,982,802,3179,466,1014,896,803,2696,483
33027,11922,7125,973,2479,2051,1622,2072,4108,293,652,4797,135,452,1598,2612,4438,359
33028,6899,5736,1440,3548,704,44,3085,1816,631,204,1163,480,504,139,40,823,340
33029,10751,9619,1890,6427,1215,87,5448,2846,935,390,1132,186,615,307,24,798,334
33030,8001,6149,2090,2780,1040,239,2179,1511,1534,925,1852,433,767,471,181,1262,590
33031,1853,1544,157,861,461,65,495,898,68,83,309,40,158,70,41,228,81
33032,5831,4888,1287,2685,770,146,1983,1152,1133,620,943,154,410,297,82,702,241
33033,9116,7173,2272,3308,1421,172,2703,1972,1671,827,1943,343,618,588,394,1526,417
33034,4209,2921,790,1409,597,125,982,661,838,440,1288,89,327,455,417,1140,148
33035,1167,688,214,285,162,27,191,314,111,72,479,118,221,121,19,352,127
33036,1760,976,67,404,422,83,183,734,27,32,784,111,423,209,41,612,172
33037,5787,3686,557,1633,1132,364,959,2069,341,317,2101,239,943,628,291,1560,541
33040,14561,7822,1672,3680,2048,422,2280,3525,1017,1000,6739,1482,3016,1634,607,4332,2407
33042,2710,1847,192,924,625,106,457,1179,133,78,863,89,432,278,64,588,275
33043,2332,1527,232,750,505,40,403,911,137,76,805,135,348,240,82,621,184
33050,5218,3153,458,1419,1037,239,812,1851,216,274,2065,340,891,541,293,1515,550
33054,8504,6447,1593,2808,1569,477,1293,1559,2054,1541,2057,240,704,702,411,1771,286
33055,12386,10724,1792,5290,3219,423,3340,3572,1752,2060,1662,153,736,646,127,1250,412
33056,9375,7923,1557,4021,2129,216,2223,2103,1964,1633,1452,225,561,591,75,1163,289
33060,12744,7695,1458,3683,1914,640,1899,3065,1535,1196,5049,945,1985,1120,999,3928,1121
33062,14643,6845,486,2172,2748,1439,955,4989,294,607,7798,954,2350,2391,2103,6600,1198
33063,22651,13822,2417,6029,3445,1931,4228,6665,1482,1447,8829,1604,1868,2311,3046,7458,1371
33064,20894,13024,2842,6116,3058,1008,4109,5296,1993,1626,7870,1502,2519,2097,1752,6127,1743
33065,17886,13219,2976,7571,2089,583,5333,3726,2585,1575,4667,1096,1527,1029,1015,3601,1066
33066,9212,4848,416,1173,1272,1987,757,3404,283,404,4364,328,471,1091,2474,3945,419
33067,7626,6267,808,4407,990,62,3429,1946,612,280,1359,499,592,227,41,988,371
33068,15766,11736,2898,6377,1879,582,4156,3490,2685,1405,4030,1233,1278,809,710,2954,1076
33069,11070,5599,811,1673,1824,1291,884,3220,649,846,5471,1246,1444,1048,1733,4475,996
33070,2407,1476,130,750,469,127,415,823,129,109,931,83,419,323,106,725,206
33071,12443,10323,1572,6651,1933,167,4859,3522,1284,658,2120,577,1070,321,152,1594,526
33073,7831,5458,1488,2765,1000,205,2257,2322,452,427,2373,830,867,525,151,1672,701
33076,6128,5420,987,3726,637,70,3235,1666,411,108,708,210,381,117,0,485,223
33109,204,118,7,38,73,0,19,99,0,0,86,11,13,42,20,73,13
33122,0,0,0,0,0,0,0,0,0,0,0,0,0,0,0,0,0
33125,16982,11581,2324,4835,3175,1247,3172,4352,1920,2137,5401,534,1062,2293,1512,4483,918
33126,15399,11499,2374,5052,3113,960,3472,4488,1669,1870,3900,659,882,1493,866,3075,825
33127,8593,6158,1393,2649,1706,410,1294,1431,1810,1623,2435,360,800,953,322,2016,419
33128,2835,1379,311,729,249,90,415,407,323,234,1456,153,328,640,335,1288,168
33129,5542,2648,524,965,790,369,569,1386,255,438,2894,820,1098,547,429,2439,455
33130,8381,4737,1147,1931,1163,496,1334,1455,869,1079,3644,323,1022,1356,943,3054,590
33131,2883,1127,369,428,285,45,245,635,80,167,1756,854,547,251,104,1521,235
33132,1942,566,129,269,149,19,100,340,72,54,1376,411,516,304,145,1222,154
33133,13037,7190,1361,3054,2187,588,1640,3199,974,1377,5847,1674,2087,1400,686,4484,1363
33134,14583,8751,1341,3421,2745,1244,2120,4083,862,1686,5832,1482,1849,1399,1102,4759,1073
33135,13844,8804,1665,3549,2420,1170,2145,3461,1240,1958,5040,403,1101,2004,1532,4231,809
33136,5165,2814,892,1261,516,145,416,588,1092,718,2351,569,782,689,311,1925,426
33137,6462,3485,828,1739,760,158,1010,941,795,739,2977,732,1242,754,249,2155,822
33138,11853,6556,1278,3392,1491,395,2062,1959,1436,1099,5297,850,2423,1388,636,3980,1317
33139,23497,6557,1731,2464,1480,882,1187,3291,714,1365,16940,6320,5244,3002,2374,13835,3105
33140,9720,4927,770,2035,1484,638,1406,2597,476,448,4793,1048,1390,1218,1137,3959,834
33141,16516,8846,1889,4330,1847,780,2302,3398,1539,1607,7670,1988,2848,1725,1109,6066,1604
33142,16538,11496,2485,4894,3268,849,2442,2845,3153,3056,5042,455,1614,1963,1010,4257,785
33143,12345,7228,1147,3661,1877,543,2518,2928,822,960,5117,1571,1716,1181,649,4054,1063
33144,8470,6573,868,2235,2706,764,1622,3139,492,1320,1897,154,448,822,473,1558,339
33145,10319,7618,1085,2995,2421,1117,2056,3328,669,1565,2701,382,794,866,659,2140,561
33146,3938,2701,325,1302,824,250,940,1436,167,158,1237,340,353,313,231,964,273
33147,15086,11640,2487,5203,3387,563,2471,2772,3551,2846,3446,338,1175,1426,507,2801,645
33149,4277,2943,261,1422,914,346,1162,1264,248,269,1334,237,506,377,214,1189,145
33150,8593,6005,1222,2895,1625,263,1541,1321,1811,1332,2588,379,1058,813,338,2147,441
33154,6886,3510,595,1316,960,639,898,1884,293,435,3376,647,850,911,968,2906,470
33155,14985,11393,1620,4596,3960,1217,3304,5134,1015,1940,3592,682,1143,1075,692,2742,850
33156,10866,8502,978,4821,2223,480,4106,3233,550,613,2364,557,849,699,259,1846,518
33157,19947,15501,2551,8744,3653,553,5582,5186,2748,1985,4446,584,1404,1517,941,3651,795
33158,2094,1860,159,1101,528,72,893,807,131,29,234,16,42,140,36,188,46
33160,17899,8649,1542,3211,2618,1278,1798,4934,810,1107,9250,1565,2055,2330,3300,8026,1224
33161,17182,12066,2846,6480,2225,515,3927,2882,3025,2232,5116,1193,2062,1264,597,4142,974
33162,13941,10526,1977,5996,1944,609,4001,2543,2184,1798,3415,656,1159,991,609,2653,762
33165,17683,14389,1719,5812,5535,1323,4251,6810,991,2337,3294,661,585,1274,774,2505,789
33166,8131,5467,1236,2732,1174,325,2087,2050,629,701,2664,570,1171,633,290,2115,549
33167,5257,4125,744,2180,1025,176,1198,826,1089,1012,1132,180,432,351,169,925,207
33168,6606,5603,807,3252,1339,205,2035,1421,1178,969,1003,64,350,380,209,817,186
33169,11612,8678,2095,4367,1904,312,2501,2165,2400,1612,2934,709,988,939,298,2458,476
33170,2674,2206,445,968,623,170,493,569,605,539,468,49,187,212,20,374,94
33172,13883,10216,2187,5230,2252,547,3423,3671,1462,1660,3667,1005,1132,1130,400,2688,979
33173,11830,8717,1308,4437,2529,443,3089,3343,947,1338,3113,751,898,949,515,2385,728
33174,9938,7879,1027,3683,2452,717,2515,3045,833,1486,2059,278,404,839,538,1681,378
33175,15470,13619,1997,6921,3906,795,5222,5344,1293,1760,1851,166,609,773,303,1448,403
33176,18777,13775,2416,7111,3617,631,5224,4993,1514,2044,5002,1138,1730,1463,671,4134,868
33177,12301,11021,2658,6114,2009,240,5027,3197,1538,1259,1280,249,505,431,95,956,324
33178,5509,4139,1226,2147,710,56,1918,1716,242,263,1370,403,670,261,36,1093,277
33179,15225,9340,2165,4298,1972,905,2971,3319,1659,1391,5885,941,1723,1642,1579,5027,858
33180,10133,5732,862,2092,1774,1004,1344,3398,492,498,4401,774,1221,1236,1170,3708,693
33181,7795,4198,1186,2045,752,215,1222,1540,872,564,3597,1175,1190,851,381,2913,684
33182,3848,3542,793,2000,707,42,1742,1183,353,264,306,76,121,92,17,196,110
33183,11497,9455,1914,4868,2322,351,3617,3174,1284,1380,2042,407,697,611,327,1599,443
33184,6083,5366,772,2795,1467,332,1854,2085,689,738,717,54,266,296,101,576,141
33185,2940,2651,538,1432,627,54,1344,885,221,201,289,61,84,112,32,257,32
33186,20573,15712,3324,9048,2945,395,6923,4913,2097,1779,4861,1450,1926,1199,286,3763,1098
33187,4140,3576,888,1984,608,96,1843,1220,309,204,564,86,234,201,43,341,223
33189,6710,5160,1341,2748,935,136,1927,1562,1108,563,1550,238,469,526,317,1295,255
33190,1641,1224,363,725,129,7,535,234,321,134,417,148,107,134,28,321,96
33193,12381,10522,3137,5451,1593,341,4687,2953,1667,1215,1859,545,733,492,89,1333,526
33194,0,0,0,0,0,0,0,0,0,0,0,0,0,0,0,0,0
33196,10808,8935,2355,5089,1280,211,4391,2430,1170,944,1873,727,623,403,120,1356,517
33301,5655,2093,300,904,685,204,547,1167,134,245,3562,948,1633,712,269,2798,764
33304,9665,3307,789,1508,688,322,775,1393,651,488,6358,1656,2692,1317,693,4936,1422
33305,6039,2375,303,1249,645,178,693,1128,249,305,3664,836,1773,721,334,2660,1004
33306,2121,907,101,375,305,126,254,533,51,69,1214,233,507,302,172,1000,214
33308,16141,7190,517,2443,2763,1467,1388,4768,366,668,8951,1344,2839,2627,2141,7676,1275
33309,12681,7584,1851,4049,1409,275,2406,2731,1497,950,5097,1092,2132,1026,847,3695,1402
33311,21629,15034,3530,7021,3718,765,3227,3520,4624,3663,6595,1037,2459,2143,956,5063,1532
33312,16966,10854,2166,5406,2766,516,3310,4285,1726,1533,6112,1102,2843,1437,730,4539,1573
33313,21201,13892,3855,6706,2382,949,3561,3796,4313,2222,7309,1604,2307,1793,1605,5941,1368
33314,9688,5717,1480,2875,1123,239,1695,1899,1154,969,3971,1209,1462,945,355,2719,1252
33315,6246,2983,582,1522,677,202,748,1321,523,391,3263,765,1451,657,390,2309,954
33316,5870,2499,365,859,956,319,472,1608,223,196,3371,865,1213,812,481,2785,586
33317,12238,9258,1546,4626,2477,609,3194,3923,1121,1020,2980,453,1108,877,542,2263,717
33319,19919,11189,2087,3898,2817,2387,2276,5662,1748,1503,8730,1297,1732,2145,3556,7390,1340
33321,19411,11558,1695,3422,3565,2876,2209,7172,952,1225,7853,930,1450,2292,3181,6774,1079
33322,18913,11131,1350,4386,2908,2487,3115,6046,781,1189,7782,844,1108,1992,3838,6815,967
33323,5894,4828,817,3180,724,107,2260,1750,534,284,1066,376,461,165,64,737,329
33324,19221,11448,1910,5566,2983,989,3493,5235,1391,1329,7773,2416,2494,1751,1112,6153,1620
33325,9385,7251,1426,4232,1350,243,3206,2310,1003,732,2134,459,932,567,176,1521,613
33326,10767,8402,1327,5213,1480,382,4153,2837,840,572,2365,564,859,584,358,1908,457
33327,3935,3585,737,2279,513,56,2161,1151,187,86,350,125,190,35,0,250,100
33328,7611,5703,852,3291,1272,288,2468,2327,512,396,1908,423,589,615,281,1405,503
33330,3575,3124,302,2083,653,86,1636,1107,228,153,451,67,234,109,41,319,132
33331,6468,5804,862,3786,1110,46,3271,2053,328,152,664,140,320,165,39,517,147
33332,1029,904,39,634,201,30,413,400,51,40,125,18,83,24,0,91,34
33334,12874,7203,1717,3577,1402,507,2302,2460,1278,1163,5671,1465,2618,1126,462,4176,1495
33351,11828,8270,2119,4902,995,254,3325,2472,1643,830,3558,1117,1408,577,456,2682,876
33388,0,0,0,0,0,0,0,0,0,0,0,0,0,0,0,0,0
33394,0,0,0,0,0,0,0,0,0,0,0,0,0,0,0,0,0
33401,9249,4045,828,1680,995,542,809,1511,941,784,5204,1076,1538,1184,1406,4419,785
33403,5125,3055,748,1444,605,258,953,1007,616,479,2070,438,711,553,368,1583,487
33404,11718,7581,1487,2851,2387,856,1361,2996,1875,1349,4137,495,1251,1471,920,3502,635
33405,7870,4947,1101,2139,1238,469,1690,2121,459,677,2923,483,1146,822,472,2378,545
33406,9165,6417,1532,2791,1693,401,1912,2717,910,878,2748,698,1101,657,292,2069,679
33407,10731,6436,1740,3084,1285,327,1621,1807,1797,1211,4295,897,1721,1253,424,3272,1023
33408,8709,4825,368,1679,1908,870,996,3231,257,341,3884,440,1120,1204,1120,3330,554
33409,9609,4975,1271,2375,1035,294,1331,2144,868,632,4634,2074,1420,802,338,3543,1091
33410,11714,7532,1284,3372,2199,677,2166,3880,942,544,4182,821,1557,1134,670,3336,846
33411,15160,11331,1815,5985,2501,1030,4453,4892,1097,889,3829,527,1099,985,1218,3106,723
33412,2963,2647,423,1578,600,46,1276,1135,142,94,316,64,132,80,40,220,96
33413,3607,2607,497,1145,770,195,710,1236,408,253,1000,269,403,184,144,702,298
33414,12582,10394,1368,6422,2042,562,4916,3959,1027,492,2188,362,968,591,267,1674,514
33415,16010,10046,2355,4804,2016,871,3045,3756,2008,1237,5964,918,1901,1793,1352,4794,1170
33417,14047,6767,1128,2163,1765,1711,1340,3729,927,771,7280,804,1343,2016,3117,6365,915
33418,11336,8180,739,3807,2637,997,2506,4664,558,452,3156,336,1112,1134,574,2501,655
33426,7344,4257,633,1407,1285,932,1006,2479,318,454,3087,346,663,748,1330,2641,446
33428,14082,10480,1594,5566,2128,1192,4628,4178,1013,661,3602,636,1078,1194,694,2875,727
33430,6393,4662,1262,2265,911,224,1448,1078,1356,780,1731,216,666,649,200,1443,288
33431,6851,4272,360,2033,1318,561,1218,2342,368,344,2579,555,681,787,556,2076,503
33432,9087,4832,593,1830,1594,815,979,2888,424,541,4255,941,1162,1123,1029,3445,810
33433,19443,11368,1281,4200,3690,2197,2819,6994,828,727,8075,1550,2063,2042,2420,6826,1249
33434,10280,6067,334,1989,1933,1811,1435,4166,255,211,4213,164,320,1105,2624,3804,409
33435,12546,7455,1315,3165,1999,976,2062,3321,1014,1058,5091,550,1182,1638,1721,4343,748
33436,16537,10549,1809,3340,3249,2151,2513,6431,947,658,5988,1091,1397,1757,1743,4852,1136
33437,18274,13876,859,2783,6837,3397,2124,10702,480,570,4398,419,826,1891,1262,3635,763
33438,284,215,81,73,35,26,93,71,10,41,69,0,10,46,13,69,0
33440,5792,4507,1329,1942,1023,213,1556,1537,891,523,1285,240,334,514,197,1031,254
33441,11799,6455,1360,2809,1620,666,1580,2923,1056,896,5344,1296,1606,1305,1137,4156,1188
33442,15529,7503,1165,2358,2068,1912,1377,4942,448,736,8026,929,1154,1728,4215,7008,1018
33444,7826,4867,1001,2413,1198,255,1239,1625,1147,856,2959,621,992,812,534,2141,818
33445,13230,7569,727,2798,2115,1929,1729,4611,559,670,5661,629,1154,1584,2294,4813,848
33446,8834,5000,16,460,2174,2350,236,4560,25,179,3834,20,159,1085,2570,3542,292
33455,7506,4952,345,1544,2062,1001,995,3376,265,316,2554,199,736,900,719,2097,457
33458,12896,9202,1508,5099,2114,481,3519,4016,1020,647,3694,756,1467,977,494,2854,840
33460,12181,7005,2090,3237,1235,443,2273,2254,1371,1107,5176,1207,2169,919,881,3933,1243
33461,14084,8488,2363,3562,1777,786,2328,3186,1779,1195,5596,979,1793,1552,1272,4334,1262
33462,11068,6886,1255,2859,1896,876,1822,3473,885,706,4182,577,1380,1059,1166,3416,766
33463,15245,10861,2375,5109,2327,1050,3824,4297,1625,1115,4384,544,1175,1664,1001,3372,1012
33467,16998,12395,1444,5281,3277,2393,4154,7118,546,577,4603,279,813,1280,2231,3913,690
33469,6588,4473,354,1632,1747,740,1091,2862,223,297,2115,91,501,714,809,1895,220
33470,5969,5047,904,3273,813,57,2592,1711,439,305,922,183,509,189,41,596,326
33471,1954,1369,312,487,481,89,396,731,149,93,585,29,189,237,130,510,75
33476,2446,1844,545,907,338,54,479,390,664,311,602,72,197,215,118,512,90
33477,6323,3961,153,981,2065,762,479,3106,131,245,2362,120,809,888,545,2014,348
33478,3735,3244,231,2255,706,52,1622,1312,171,139,491,32,333,95,31,322,169
33480,6237,3178,95,573,1270,1240,339,2583,101,155,3059,185,558,1072,1244,2711,348
33483,6704,3317,333,1152,1240,592,566,2253,207,291,3387,429,1143,829,986,2840,547
33484,13774,7805,205,810,2973,3817,535,6673,73,524,5969,273,463,1422,3811,5491,478
33486,9024,6150,853,3241,1617,439,2381,2549,517,703,2874,807,1084,706,277,2231,643
33487,7849,4788,272,1642,1817,1057,975,3330,227,256,3061,390,826,1073,772,2567,494
33493,783,635,201,231,171,32,171,198,174,92,148,31,37,65,15,133,15
33496,9037,6745,417,2338,2818,1172,1839,4386,295,225,2292,336,703,759,494,1958,334
33498,5232,4524,423,2218,1289,594,1870,2282,174,198,708,53,155,329,171,573,135
33510,8203,6239,1325,3357,1374,183,2463,2521,777,478,1964,558,708,414,284,1520,444
33511,16891,12223,3212,6231,2385,395,4816,4837,1579,991,4668,1810,1725,803,330,3543,1125
33513,3638,2470,373,991,909,197,629,1405,256,180,1168,84,282,474,328,998,170
33514,548,402,102,151,118,31,140,182,49,31,146,17,72,32,25,115,31
33521,180,147,24,71,37,15,28,51,36,32,33,0,7,12,14,33,0
33523,6237,4606,853,2015,1318,420,1324,2033,741,508,1631,257,430,497,447,1344,287
33525,5345,3757,708,1530,1215,304,1127,1942,393,295,1588,182,441,565,400,1333,255
33527,3687,2987,550,1503,799,135,1167,1162,376,282,700,86,228,226,160,616,84
33534,2497,1852,559,837,347,109,695,540,373,244,645,134,212,207,92,414,231
33538,2147,1428,241,464,554,169,307,902,101,118,719,52,113,287,267,642,77
33540,8095,5445,926,1786,1913,820,1296,3155,589,405,2650,293,505,854,998,2256,394
33541,11159,7272,673,1603,3074,1922,991,5350,490,441,3887,256,655,1425,1551,3392,495
33543,4619,3597,824,1711,866,196,1374,1705,266,252,1022,139,409,275,199,792,230
33544,2578,2074,336,1162,497,79,817,898,194,165,504,60,298,124,22,337,167
33547,3026,2384,374,1289,569,152,794,1181,249,160,642,131,226,152,133,539,103
33549,17509,12238,2210,6759,2771,498,4812,5440,1223,763,5271,1444,2067,1206,554,3973,1298
33556,5090,4261,506,2597,1066,92,1779,2118,242,122,829,73,340,308,108,656,173
33565,6120,4707,832,2036,1464,375,1609,2444,384,270,1413,182,359,541,331,1140,273
33566,7821,5559,1423,2491,1286,359,1805,1994,1025,735,2262,536,596,660,470,1915,347
33567,8640,6756,1384,3264,1752,356,2549,2762,892,553,1884,428,621,615,220,1451,433
33569,13252,9856,2221,4915,2274,446,3620,4232,1235,769,3396,784,1210,1010,392,2603,793
33570,4955,3619,798,1173,1215,433,959,1862,489,309,1336,150,352,520,314,1124,212
33572,3144,2349,204,1047,849,249,589,1507,142,111,795,88,272,228,207,606,189
33573,9118,5379,41,143,2644,2551,43,5147,33,156,3739,7,56,1394,2282,3537,202
33576,923,650,80,238,262,70,190,384,54,22,273,38,71,124,40,218,55
33584,7379,5629,1119,2978,1272,260,1929,2224,872,604,1750,236,664,594,256,1408,342
33585,327,230,15,105,90,20,44,132,35,19,97,20,11,36,30,85,12
33592,3735,2699,644,1149,733,173,876,1062,403,358,1036,175,414,278,169,756,280
33594,16601,13878,2336,7999,3016,527,6388,5794,941,755,2723,425,889,742,667,2297,426
33597,2725,2116,384,844,719,169,683,1013,254,166,609,63,135,243,168,512,97
33598,2008,1676,440,806,396,34,707,597,207,165,332,56,154,77,45,242,90
33602,3718,1835,445,833,398,159,259,643,541,392,1883,440,723,425,295,1502,381
33603,8195,4927,1265,2134,1139,389,1245,1586,1145,951,3268,837,1164,680,587,2491,777
33604,14841,8786,2418,4189,1740,439,2348,2959,2336,1143,6055,1251,2373,1533,898,4694,1361
33605,6156,3865,741,1711,1065,348,792,998,1041,1034,2291,269,630,882,510,1861,430
33606,7300,2861,562,1442,628,229,907,1364,321,269,4439,1902,1463,686,388,3553,886
33607,9328,5636,1370,1999,1566,701,1128,2142,1180,1186,3692,796,1022,1032,842,3074,618
33609,7483,3861,641,1829,956,435,1207,1642,502,510,3622,986,1208,756,672,2913,709
33610,12054,8099,1962,3416,2104,617,1848,2249,2165,1837,3955,545,1501,1308,601,3242,713
33611,14570,7441,1670,3475,1731,565,2154,3410,1042,835,7129,2039,2391,1612,1087,5844,1285
33612,17587,10219,3350,4528,1726,615,2777,3163,2958,1321,7368,2364,2475,1414,1115,5901,1467
33613,13433,6257,2358,2511,995,393,1503,2177,1646,931,7176,3396,2145,805,830,5238,1938
33614,17995,10655,3278,4416,2401,560,3309,3839,2000,1507,7340,2682,2655,1404,599,5708,1632
33615,16776,10564,2461,5103,2598,402,3361,4389,1579,1235,6212,1993,2205,1309,705,4768,1444
33616,4804,2930,757,1514,533,126,920,960,659,391,1874,702,679,414,79,1395,479
33617,17242,10526,3129,4955,1967,475,3349,3698,2217,1262,6716,2625,1967,1505,619,4972,1744
33618,8293,5545,1027,2941,1296,281,2109,2353,630,453,2748,950,947,526,325,2183,565
33619,8720,6284,1300,3037,1640,307,1685,2134,1461,1004,2436,333,927,918,258,1836,600
33620,0,0,0,0,0,0,0,0,0,0,0,0,0,0,0,0,0
33621,613,613,291,313,9,0,464,71,78,0,0,0,0,0,0,0,0
33624,17836,12289,2288,6863,2682,456,4772,4932,1492,1093,5547,1846,2273,1048,380,4287,1260
33625,7208,5596,1202,3225,1085,84,2388,2099,668,441,1612,386,773,360,93,1115,497
33626,4185,3211,875,1790,488,58,1615,1264,164,168,974,338,330,221,85,704,270
33629,10625,6129,826,3294,1317,692,2200,2808,600,521,4496,1210,1555,910,821,3813,683
33634,7257,5019,1182,2483,1218,136,1584,2138,754,543,2238,641,858,615,124,1622,616
33635,5030,3325,879,1597,731,118,1282,1386,363,294,1705,337,701,499,168,1330,375
33637,5322,3082,1032,1516,444,90,1060,961,643,418,2240,954,648,438,200,1630,610
33647,10250,6829,1687,4047,942,153,3325,2504,610,390,3421,1868,980,500,73,2289,1132
33701,8221,2373,592,1014,509,258,444,1077,576,276,5848,1163,2016,1308,1361,5016,832
33702,14185,8011,1319,3441,2344,907,2137,3976,924,974,6174,1118,1983,1670,1403,5048,1126
33703,11150,6935,1113,3281,1872,669,2318,3366,702,549,4215,617,1564,987,1047,3454,761
33704,7809,4285,734,2221,980,350,1346,2035,565,339,3524,787,1584,625,528,2859,665
33705,11758,6548,1418,3024,1530,576,1589,2155,1493,1311,5210,775,1877,1518,1040,4459,751
33706,9402,4786,273,1733,1947,833,691,3414,275,406,4616,459,1717,1404,1036,3899,717
33707,13424,6829,667,2510,2329,1323,1323,4026,676,804,6595,771,1497,2067,2260,5579,1016
33708,9290,4777,298,1579,1895,1005,625,3405,301,446,4513,388,1409,1553,1163,3758,755
33709,12186,6842,1117,2491,1980,1254,1497,3533,970,842,5344,464,1419,1769,1692,4596,748
33710,14686,9135,1491,4363,2293,988,2623,4145,1126,1241,5551,930,1596,1664,1361,4572,979
33711,7403,4910,1028,2155,1327,400,788,1787,1355,980,2493,221,825,787,660,2060,433
33712,10547,6717,1595,2816,1767,539,1450,2226,1799,1242,3830,1010,1245,1050,525,3046,784
33713,13271,7846,1974,3690,1587,595,2156,3254,1480,956,5425,908,2283,1200,1034,4308,1117
33714,7989,4436,1063,1877,1092,404,1038,2017,897,484,3553,470,1157,1109,817,2902,651
33715,3899,2415,126,756,1162,371,289,1910,69,147,1484,187,412,607,278,1194,290
33716,5636,1829,904,599,243,83,390,915,307,217,3807,2068,1172,482,85,2856,951
33755,10276,6280,1555,2829,1365,531,1564,2342,1374,1000,3996,863,1582,1067,484,3150,846
33756,12965,7304,1434,2970,1913,987,1993,3551,1055,705,5661,669,1584,1690,1718,4868,793
33759,8530,4833,1063,2158,1045,567,1231,2222,957,423,3697,876,1021,826,974,2941,756
33760,6028,3544,931,1664,697,252,850,1554,784,356,2484,659,1043,528,254,1881,603
33761,9358,5798,575,2355,1988,880,1481,3471,467,379,3560,306,842,1281,1131,3170,390
33762,3916,1980,384,761,617,218,403,1306,104,167,1936,603,611,482,240,1600,336
33763,9542,5083,551,1352,1722,1458,921,3316,226,620,4459,409,719,1318,2013,3977,482
33764,10931,6578,716,2516,2300,1046,1569,3884,615,510,4353,793,1084,1256,1220,3542,811
33765,6233,3412,774,1496,784,358,894,1635,504,379,2821,720,804,764,533,2265,556
33767,5404,3019,111,854,1493,561,283,2474,85,177,2385,210,670,917,588,2002,383
33770,12185,6457,982,2507,1936,1032,1474,3550,712,721,5728,923,1663,1573,1569,4797,931
33771,14158,7693,1240,2489,2538,1426,1291,4624,953,825,6465,1021,1667,2016,1761,5418,1047
33772,10822,6458,825,2782,1935,916,1694,3637,692,435,4364,509,955,1166,1734,3692,672
33773,7067,4609,856,2213,1056,484,1397,2158,558,496,2458,291,679,827,661,1995,463
33774,8435,5139,687,1999,1656,797,1253,2896,568,422,3296,482,764,1069,981,2831,465
33776,5226,3871,236,2007,1187,441,1367,1973,240,291,1355,97,365,498,395,1139,216
33777,6912,4881,700,2397,1369,415,1567,2332,586,396,2031,242,587,703,499,1638,393
33778,5802,3815,509,1580,1228,498,956,1917,437,505,1987,311,477,686,513,1630,357
33781,10412,6496,1579,3125,1399,393,2021,2483,1255,737,3916,754,1276,1097,789,3116,800
33782,8245,5334,767,2165,1634,768,1530,2758,455,591,2911,322,800,908,881,2457,454
33785,3198,1601,171,652,625,153,262,1116,76,147,1597,189,690,517,201,1227,370
33786,754,498,17,199,217,65,121,358,0,19,256,14,88,106,48,242,14
33801,13489,8123,2195,3169,1962,797,2157,3556,1454,956,5366,1251,1685,1418,1012,4304,1062
33803,11778,6931,1463,2579,1992,897,1738,3608,964,621,4847,988,1369,1275,1215,4121,726
33805,7563,5096,1125,2157,1312,502,1088,1780,1323,905,2467,367,716,899,485,2036,431
33809,11292,8152,1225,3412,2636,879,2310,4724,756,362,3140,643,629,1052,816,2590,550
33810,10629,8234,1767,3599,2367,501,2766,3842,944,682,2395,438,740,860,357,1866,529
33811,6173,4508,914,2331,1007,256,1659,2152,474,223,1665,477,561,372,255,1335,330
33813,12895,10594,1596,5515,2876,607,4102,4920,941,631,2301,351,809,742,399,1878,423
33815,5562,3549,898,1321,838,492,782,1408,764,595,2013,209,607,685,512,1657,356
33823,10019,7590,1509,3354,2149,578,2268,3443,1076,803,2429,343,663,1008,415,2017,412
33825,8799,6387,994,1875,2433,1085,1348,3871,715,453,2412,186,487,1053,686,2071,341
33827,796,583,89,274,171,49,212,267,77,27,213,13,78,86,36,178,35
33830,9089,6545,1374,3030,1636,505,1957,2724,1048,816,2544,343,715,845,641,2116,428
33834,1979,1567,326,545,496,200,446,722,190,209,412,43,122,134,113,296,116
33835,0,0,0,0,0,0,0,0,0,0,0,0,0,0,0,0,0
33837,8566,6629,1114,2280,2660,575,1471,4325,371,462,1937,350,615,664,308,1495,442
33838,1082,774,176,271,193,134,252,325,113,84,308,13,94,136,65,271,37
33839,556,406,90,182,100,34,111,169,81,45,150,21,49,37,43,131,19
33841,2760,2120,469,800,656,195,662,937,260,261,640,28,153,253,206,573,67
33843,3655,2728,402,999,997,330,721,1468,326,213,927,131,153,297,346,843,84
33844,9857,7204,1420,2475,2494,815,1862,3600,903,839,2653,279,661,1003,710,2258,395
33847,63,63,0,13,31,19,13,38,0,12,0,0,0,0,0,0,0
33848,175,134,21,52,61,0,51,73,0,10,41,11,22,0,8,19,22
33849,138,109,20,42,47,0,47,36,18,8,29,0,6,15,8,23,6
33850,1613,1176,234,477,365,100,336,597,202,41,437,97,117,157,66,358,79
33851,312,257,46,95,94,22,66,166,15,10,55,5,20,13,17,47,8
33852,8337,5874,895,1575,2325,1079,1383,3642,467,382,2463,156,495,955,857,2097,366
33853,14379,10005,1620,3464,3584,1337,2278,5618,1106,1003,4374,514,815,1688,1357,3734,640
33857,740,445,33,148,213,51,118,249,51,27,295,36,85,130,44,216,79
33860,6014,4669,1017,1969,1331,352,1570,2183,542,374,1345,188,541,349,267,1127,218
33865,266,196,14,90,84,8,52,120,7,17,70,11,33,8,18,53,17
33868,3400,2751,527,1164,930,130,840,1380,337,194,649,100,229,178,142,509,140
33870,9677,6285,856,1807,2407,1215,1221,3745,797,522,3392,233,740,1164,1255,2927,465
33872,9574,6759,584,1778,2817,1580,1215,4815,420,309,2815,208,576,933,1098,2392,423
33873,4512,3471,782,1506,887,296,1335,1343,373,420,1041,140,247,408,246,882,159
33877,180,148,7,98,43,0,41,37,21,49,32,8,8,16,0,32,0
33880,13211,9037,2366,3746,2186,739,2919,3805,1368,945,4174,777,1173,1212,1012,3431,743
33881,12115,7727,1123,2568,2753,1283,1630,4176,928,993,4388,530,883,1504,1471,3774,614
33884,8245,5939,843,2140,2114,842,1765,3511,296,367,2306,230,577,857,642,2007,299
33890,1606,1308,295,492,401,120,474,612,145,77,298,42,59,107,90,252,46
33901,9032,4724,1203,2018,1022,481,1245,1776,1026,677,4308,723,1537,932,1116,3523,785
33903,11205,7109,689,1695,3162,1563,961,5033,547,568,4096,266,828,1540,1462,3438,658
33904,14940,10016,1016,3294,3890,1816,2034,6394,700,888,4924,486,1414,1734,1290,4028,896
33905,9206,6464,1342,2665,1890,567,1741,3086,1019,618,2742,373,783,999,587,2151,591
33907,9842,5064,1507,1590,1207,760,1071,2308,1003,682,4778,1482,1461,981,854,3665,1113
33908,12285,7839,626,1925,3685,1603,1106,5846,476,411,4446,464,1017,1380,1585,3777,669
33909,2981,2354,540,1262,459,93,940,835,403,176,627,138,248,114,127,480,147
33912,13383,10162,1662,4367,3186,947,3546,5228,798,590,3221,553,1203,954,511,2442,779
33913,1475,1248,151,630,402,65,433,658,77,80,227,27,86,98,16,169,58
33914,9930,7798,1199,3602,2412,585,2679,3970,652,497,2132,410,752,675,295,1565,567
33916,7020,4682,1586,1843,1004,249,974,1240,1668,800,2338,667,796,668,207,1802,536
33917,13039,8603,957,2561,3563,1522,1466,5767,786,584,4436,330,987,1728,1391,3633,803
33919,12828,7937,826,2614,3004,1493,1659,5149,559,570,4891,519,1244,1596,1532,4174,717
33920,1794,1366,185,616,420,145,397,737,143,89,428,75,142,114,97,345,83
33921,811,605,18,90,374,123,57,548,0,0,206,22,52,63,69,185,21
33922,1926,1313,169,382,618,144,280,924,49,60,613,65,220,166,162,474,139
33924,216,117,0,37,67,13,4,113,0,0,99,0,22,24,53,70,29
33928,4334,3221,181,715,1721,604,430,2532,116,143,1113,101,245,502,265,956,157
33930,191,148,51,77,15,5,81,41,26,0,43,0,15,13,15,37,6
33931,5643,3418,128,662,1931,697,240,2915,95,168,2225,144,636,827,618,1799,426
33935,5411,4121,1103,1749,1022,247,1611,1669,504,337,1290,269,276,481,264,959,331
33936,6607,4537,870,1595,1401,671,1381,2283,450,423,2070,130,386,799,755,1818,252
33944,145,127,29,53,10,35,46,59,12,10,18,0,8,10,0,10,8
33945,44,24,0,4,20,0,4,20,0,0,20,0,6,14,0,14,6
33946,480,389,0,54,308,27,31,346,0,12,91,0,6,44,41,91,0
33947,2357,1832,146,359,912,415,292,1350,90,100,525,48,97,217,163,412,113
33948,6095,4387,492,1663,1642,590,1113,2589,373,312,1708,176,459,575,498,1369,339
33950,9606,6638,245,1278,3673,1442,538,5307,347,446,2968,149,540,1185,1094,2596,372
33952,13827,8856,1203,2809,3095,1749,1819,5392,976,669,4971,302,928,1758,1983,4239,732
33953,1532,1123,72,296,596,159,193,839,18,73,409,15,123,192,79,318,91
33954,2836,2315,321,1029,755,210,730,1274,187,124,521,64,179,160,118,388,133
33955,2837,2174,179,558,1170,267,376,1615,63,120,663,36,136,322,169,518,145
33956,2143,1422,33,286,824,279,118,1235,16,53,721,35,120,314,252,613,108
33957,2993,2134,97,464,1170,403,251,1717,104,62,859,35,212,391,221,743,116
33960,259,229,45,60,104,20,60,127,6,36,30,0,21,0,9,23,7
33971,2710,2241,711,1084,409,37,1002,784,347,108,469,111,258,79,21,303,166
33972,3132,2336,255,1016,735,330,633,1379,198,126,796,89,186,260,261,637,159
33975,0,0,0,0,0,0,0,0,0,0,0,0,0,0,0,0,0
33980,4461,2452,173,547,968,764,300,1781,180,191,2009,146,257,553,1053,1805,204
33981,3120,2330,331,796,907,296,547,1481,168,134,790,59,139,346,246,625,165
33982,3705,2589,313,843,1004,429,567,1643,200,179,1116,90,254,419,353,921,195
33983,4564,3582,244,1241,1611,486,862,2328,207,185,982,83,252,389,258,758,224
33990,8813,6915,1351,2762,2113,689,2182,3267,839,627,1898,334,647,615,302,1396,502
33991,3162,2481,455,1215,639,172,925,1119,304,133,681,116,178,215,172,503,178
33993,1566,1211,212,586,286,127,434,639,85,53,355,25,176,110,44,284,71
34102,5956,3367,248,1158,1257,704,578,2355,226,208,2589,255,608,1057,669,2233,356
34103,6611,4198,270,995,1961,972,559,3141,253,245,2413,165,488,909,851,2060,353
34104,8457,5731,1009,1844,2223,655,1183,3524,628,396,2726,500,825,1027,374,2113,613
34105,4734,2956,304,870,1211,571,608,1975,196,177,1778,228,375,604,571,1492,286
34108,7723,5316,354,1443,2638,881,824,3895,305,292,2407,316,671,881,539,1958,449
34109,7752,5411,603,2313,2008,487,1524,3134,465,288,2341,406,725,717,493,1915,426
34110,7363,4916,451,1403,2101,961,891,3547,234,244,2447,181,405,976,885,2051,396
34112,11990,7590,930,2041,3136,1483,1187,5083,683,637,4400,516,1133,1725,1026,3578,822
34113,5700,3862,610,1088,1612,552,872,2390,332,268,1838,162,542,560,574,1486,352
34114,3493,2374,327,545,1155,347,363,1646,197,168,1119,108,251,472,288,895,224
34116,8089,6158,1849,2946,1071,292,2418,2096,989,655,1931,511,936,353,131,1236,695
34117,3119,2705,578,1569,486,72,1276,1066,209,154,414,67,238,102,7,293,121
34119,3938,3200,230,1212,1389,369,864,2078,160,98,738,34,271,370,63,624,114
34120,3947,3284,649,1861,704,70,1493,1319,345,127,663,121,382,136,24,397,266
34134,5901,4191,102,968,2555,566,396,3570,80,145,1710,98,417,801,394,1438,272
34135,10523,7351,1129,2074,3104,1044,1483,4735,514,619,3172,478,841,1093,760,2457,715
34137,137,92,4,47,16,25,31,16,32,13,45,10,28,0,7,34,11
34138,197,166,27,65,60,14,53,98,15,0,31,0,17,8,6,31,0
34139,307,213,27,72,84,30,49,125,19,20,94,11,42,33,8,68,26
34141,39,16,5,2,9,0,2,14,0,0,23,0,17,0,6,23,0
34142,5366,4332,1363,2118,773,78,1734,893,1050,655,1034,222,330,330,152,706,328
34145,7362,5346,299,1132,2913,1002,645,4280,200,221,2016,143,452,937,484,1746,270
34201,1031,711,8,137,462,104,60,614,0,37,320,53,81,148,38,291,29
34202,5520,4693,613,2534,1363,183,2044,2279,191,179,827,158,288,269,112,649,178
34203,10436,7420,1301,2346,2498,1275,1697,4425,754,544,3016,324,690,1030,972,2519,497
34205,13891,7859,1822,3215,1806,1016,2140,3453,1308,958,6032,824,1711,1695,1802,5082,950
34207,14715,8080,1790,2606,2433,1251,1546,4375,1325,834,6635,949,1410,2403,1873,5488,1147
34208,11062,8048,1971,3513,1889,675,2320,3249,1593,886,3014,610,946,831,627,2444,570
34209,14587,9902,923,4106,3161,1712,2513,5903,748,738,4685,458,820,1611,1796,4055,630
34210,7339,4280,590,1064,1742,884,563,3119,337,261,3059,546,705,888,920,2543,516
34215,312,185,0,52,106,27,18,148,19,0,127,0,23,84,20,89,38
34216,871,570,7,271,212,80,120,365,30,55,301,7,63,132,99,259,42
34217,3369,1861,135,616,762,348,237,1289,153,182,1508,152,480,480,396,1198,310
34219,2268,1830,183,684,773,190,427,1248,78,77,438,18,124,214,82,340,98
34221,11904,8431,1430,3117,2739,1145,2113,4408,1001,909,3473,262,824,1373,1014,2938,535
34222,4579,2810,196,453,1285,876,325,2183,141,161,1769,74,197,649,849,1600,169
34223,9026,5948,284,1442,2629,1593,746,4576,331,295,3078,167,624,1157,1130,2648,430
34224,7263,4810,391,1274,2059,1086,848,3394,262,306,2453,164,453,1048,788,2093,360
34228,4196,2829,41,342,1640,806,150,2609,7,63,1367,9,203,489,666,1241,126
34229,2300,1581,69,511,771,230,311,1166,50,54,719,91,110,258,260,604,115
34231,15358,8592,959,3530,2643,1460,1888,5034,946,724,6766,973,2033,2039,1721,5503,1263
34232,13269,8836,1476,4238,2148,974,2863,4159,945,869,4433,649,1395,1226,1163,3586,847
34233,6606,4299,402,1695,1436,766,1230,2475,306,288,2307,149,469,878,811,1930,377
34234,8324,4810,1104,1928,1223,555,867,2170,1109,664,3514,565,1166,1049,734,2666,848
34235,6119,4000,402,1393,1369,836,845,2686,250,219,2119,181,583,717,638,1748,371
34236,6328,2572,352,764,883,573,431,1640,251,250,3756,576,940,1017,1223,3318,438
34237,7169,3947,991,1580,961,415,1030,1652,655,610,3222,700,1142,809,571,2467,755
34238,6848,4493,258,1247,2070,918,875,3198,174,246,2355,272,473,837,773,2058,297
34239,7376,4182,630,1682,1281,589,1009,2239,512,422,3194,381,1100,1103,610,2587,607
34240,2382,1996,141,1157,637,61,776,1010,91,119,386,36,195,114,41,251,135
34241,4627,3763,305,1684,1451,323,1258,2018,283,204,864,106,207,356,195,672,192
34242,5030,3074,95,749,1538,692,424,2386,85,179,1956,169,462,790,535,1666,290
34243,8974,6139,823,2332,2145,839,1382,4051,395,311,2835,550,974,833,478,2128,707
34250,184,134,15,78,27,14,44,76,6,8,50,7,27,8,8,30,20
34251,1220,997,163,579,231,24,456,474,37,30,223,44,90,61,28,146,77
34266,10711,7740,1544,2604,2609,983,1996,4169,874,701,2971,527,700,1079,665,2260,711
34268,73,64,0,25,39,0,38,26,0,0,9,0,0,9,0,0,9
34275,7161,4846,293,1402,2047,1104,806,3402,312,326,2315,158,624,724,809,1921,394
34285,4541,2173,70,506,914,683,241,1764,89,79,2368,80,366,683,1239,2176,192
34286,2959,2480,640,1190,588,62,1030,1056,232,162,479,58,223,155,43,324,155
34287,8992,5962,680,1372,2436,1474,1010,4046,462,444,3030,153,408,1294,1175,2603,427
34292,9019,5707,243,979,2801,1684,519,4696,212,280,3312,164,448,1196,1504,2913,399
34293,14149,10035,946,2850,4067,2172,1788,6882,697,668,4114,312,969,1462,1371,3403,711
34420,5877,4016,719,1632,1229,436,1078,1923,615,400,1861,214,573,594,480,1463,398
34428,3829,2645,385,1106,908,246,772,1403,274,196,1184,145,395,402,242,938,246
34429,3823,2588,172,970,1099,347,504,1623,223,238,1235,146,226,585,278,1087,148
34431,2793,1975,130,666,799,380,370,1298,178,129,818,18,108,351,341,760,58
34432,4298,3187,272,906,1643,366,533,2270,169,215,1111,125,269,460,257,873,238
34433,1571,1189,149,448,506,86,306,691,113,79,382,17,107,137,121,303,79
34434,1945,1409,141,409,575,284,265,888,154,102,536,21,87,215,213,470,66
34436,3795,2547,211,849,1068,419,558,1611,258,120,1248,112,313,480,343,1073,175
34442,4681,3319,385,870,1710,354,677,2225,215,202,1362,63,404,535,360,1098,264
34446,5634,4108,313,1071,1946,778,640,2982,286,200,1526,88,288,734,416,1211,315
34448,4578,3047,421,933,1212,481,614,1999,272,162,1531,120,360,702,349,1196,335
34449,1556,1029,113,379,398,139,195,634,119,81,527,44,127,220,136,432,95
34450,4894,3191,251,1015,1448,477,598,2125,251,217,1703,94,239,621,749,1521,182
34452,4470,3094,356,1011,1150,577,694,1865,307,228,1376,121,314,450,491,1188,188
34453,3525,2450,282,753,1051,364,495,1525,258,172,1075,69,280,370,356,892,183
34461,3131,2256,200,853,924,279,491,1434,138,193,875,52,201,352,270,774,101
34465,6519,4381,315,923,2020,1123,624,3221,291,245,2138,111,262,760,1005,1890,248
34470,6931,4209,926,1614,1122,547,996,2001,783,429,2722,385,658,970,709,2297,425
34471,8552,5973,881,2913,1656,523,2166,2693,626,488,2579,530,654,732,663,2195,384
34472,7801,5591,1021,1981,1741,848,1673,2854,509,555,2210,275,420,788,727,1837,373
34473,2945,2219,296,794,770,359,619,1165,217,218,726,61,197,283,185,621,105
34474,6750,4165,975,1573,1201,416,1173,1920,640,432,2585,694,566,756,569,2116,469
34475,3902,2561,674,1036,652,199,581,839,751,390,1341,188,459,390,304,1143,198
34476,5719,4290,323,835,2372,760,532,3324,173,261,1429,89,248,692,400,1200,229
34479,5206,3710,631,1671,1026,382,1076,1721,490,423,1496,251,413,485,347,1276,220
34480,3572,2762,511,1282,740,229,1085,1139,332,206,810,132,215,311,152,682,128
34481,7309,4930,206,633,2280,1811,440,4140,116,234,2379,43,291,1009,1036,2176,203
34482,6201,4568,796,1648,1657,467,1082,2421,646,419,1633,196,479,613,345,1377,256
34484,893,676,138,268,221,49,236,339,45,56,217,66,47,64,40,167,50
34488,4236,2815,411,884,1160,360,666,1628,270,251,1421,163,330,546,382,1174,247
34491,7996,6139,699,2005,2577,858,1320,3975,426,418,1857,145,305,866,541,1526,331
34498,281,172,19,68,58,27,20,124,21,7,109,1,51,34,23,90,19
34601,8752,5750,1106,2294,1615,735,1471,2907,854,518,3002,378,755,1002,867,2560,442
34602,2277,1786,307,714,580,185,479,903,238,166,491,34,138,165,154,390,101
34606,11120,7812,844,1736,3316,1916,1257,5413,663,479,3308,315,445,1130,1418,2826,482
34607,3160,2369,125,755,1135,354,440,1700,101,128,791,63,195,357,176,663,128
34608,9644,7160,890,2219,2679,1372,1675,4409,490,586,2484,173,434,1025,852,2082,402
34609,10877,8519,1123,3056,3296,1044,2497,4854,554,614,2358,207,586,938,627,1935,423
34610,3763,2835,436,1421,858,120,947,1286,315,287,928,136,278,359,155,671,257
34613,6623,4600,240,1084,2183,1093,603,3514,245,238,2023,101,221,836,865,1793,230
34614,970,761,114,399,214,34,275,322,90,74,209,15,80,76,38,188,21
34639,6824,5511,971,3032,1202,306,2217,2375,527,392,1313,171,623,384,135,993,320
34652,11938,6731,1017,2329,2244,1141,1361,3885,798,687,5207,542,1039,1657,1969,4473,734
34653,13718,8616,1467,2998,2526,1625,1952,4817,1127,720,5102,758,1168,1632,1544,4260,842
34654,6417,4652,632,1997,1385,638,1355,2486,464,347,1765,185,460,693,427,1354,411
34655,10463,7788,807,2768,2923,1290,1979,4880,373,556,2675,246,465,1038,926,2272,403
34661,51,33,8,16,9,0,15,9,9,0,18,0,0,10,8,8,10
34667,13821,8923,773,2645,3522,1983,1557,5860,683,823,4898,469,1087,1603,1739,4105,793
34668,19649,12119,1955,3683,3796,2685,2373,7144,1360,1242,7530,776,1342,2411,3001,6441,1089
34669,4110,3029,422,1217,1088,302,895,1682,244,208,1081,183,335,385,178,807,274
34677,7873,5605,893,2718,1557,437,1985,2598,606,416,2268,454,709,685,420,1781,487
34679,139,100,48,34,18,0,23,53,17,7,39,6,19,7,7,32,7
34681,511,359,11,229,89,30,122,136,79,22,152,26,40,43,43,133,19
34683,13608,9829,1027,5513,2534,755,3626,4612,952,639,3779,759,1247,1064,709,2982,797
34684,12608,7817,1135,2962,2332,1388,2025,4527,684,581,4791,616,945,1219,2011,4232,559
34685,6908,5322,543,2936,1415,428,2066,2668,401,187,1586,407,492,430,257,1324,262
34689,12322,8329,886,3513,2898,1032,2211,4829,647,642,3993,442,1075,1392,1084,3383,610
34690,6032,3678,611,1295,1017,755,841,2174,352,311,2354,182,402,868,902,1970,384
34691,8585,5446,990,1639,1827,990,1251,3148,574,473,3139,333,698,994,1114,2661,478
34695,7554,5100,554,2628,1494,424,1690,2513,468,429,2454,303,886,712,553,1997,457
34698,16560,9183,1101,3522,2909,1651,1968,5351,954,910,7377,836,1956,2327,2258,6280,1097
34705,795,606,130,262,183,31,212,299,58,37,189,30,38,99,22,145,44
34711,14312,10911,2231,5032,3015,633,4033,5520,782,576,3401,786,1180,950,485,2636,765
34731,4122,3020,327,1067,1211,415,757,1891,130,242,1102,87,251,403,361,955,147
34734,946,714,172,418,111,13,343,245,90,36,232,26,129,62,15,181,51
34736,2812,2255,337,1175,603,140,710,1040,291,214,557,70,158,179,150,484,73
34737,716,573,75,292,149,57,207,302,30,34,143,16,52,47,28,119,24
34739,313,205,27,94,66,18,86,94,5,20,108,23,12,46,27,94,14
34741,13292,8585,3048,3884,1391,262,2632,2682,2040,1231,4707,1760,1595,1047,305,3216,1491
34743,8243,6878,1492,3419,1588,379,2673,2427,975,803,1365,236,495,463,171,1000,365
34744,9529,7490,1220,4016,1905,349,2643,3227,967,653,2039,294,812,708,225,1588,451
34746,6934,4780,838,2200,1188,554,1573,2392,455,360,2154,446,635,438,635,1622,532
34747,2001,1369,164,758,416,31,548,616,132,73,632,280,178,107,67,468,164
34748,13960,9502,1281,2162,4370,1689,1392,6273,1065,772,4458,517,784,1666,1491,3836,622
34753,871,697,221,294,159,23,282,253,86,76,174,54,66,31,23,138,36
34756,880,723,89,377,188,69,235,382,53,53,157,8,88,28,33,138,19
34758,4179,3484,681,1604,1015,184,1284,1321,538,341,695,91,194,296,114,542,153
34759,2583,2080,457,968,608,47,799,939,229,113,503,86,207,131,79,381,122
34760,231,175,20,95,46,14,56,68,24,27,56,4,20,15,17,50,6
34761,9411,7532,1779,4128,1389,236,3268,2908,739,617,1879,624,693,383,179,1391,488
34762,154,94,18,67,9,0,14,25,37,18,60,0,22,30,8,60,0
34769,7110,4916,1079,2210,1129,498,1598,2190,730,398,2194,323,486,799,586,1804,390
34771,3721,2892,510,1395,811,176,1074,1473,202,143,829,98,364,204,163,617,212
34772,3878,3180,645,1682,718,135,1313,1369,372,126,698,178,191,208,121,530,168
34773,555,428,88,212,100,28,129,200,44,55,127,31,38,31,27,93,34
34785,4838,3296,455,1072,1127,642,643,1895,461,297,1542,92,318,699,433,1370,172
34786,2786,2384,177,1511,625,71,1122,1024,118,120,402,49,170,113,70,302,100
34787,8352,6035,1359,2819,1456,401,2050,2446,810,729,2317,376,947,652,342,1845,472
34788,7344,4974,352,1271,2285,1066,703,3672,341,258,2370,176,316,928,950,2060,310
34797,461,317,18,125,133,41,46,234,21,16,144,13,42,38,51,122,22
34945,1273,907,73,406,322,106,273,540,38,56,366,82,71,137,76,264,102
34946,2653,1783,263,775,599,146,353,862,357,211,870,88,327,292,163,685,185
34947,3264,2464,743,955,657,109,663,674,703,424,800,104,345,270,81,623,177
34949,3541,2148,122,439,1145,442,258,1770,37,83,1393,93,438,520,342,1151,242
34950,6333,3910,1073,1602,887,348,933,1163,1003,811,2423,353,842,781,447,1923,500
34951,5769,4067,490,1211,1601,765,868,2650,275,274,1702,94,374,648,586,1465,237
34952,13788,9009,1062,3095,3114,1738,1775,5433,992,809,4779,497,910,1724,1648,3991,788
34953,9007,7273,1551,3771,1611,340,3070,3069,627,507,1734,211,813,537,173,1226,508
34956,2306,1831,492,670,518,151,583,711,285,252,475,59,88,225,103,357,118
34957,9651,5883,445,1947,2413,1078,1249,3793,397,444,3768,363,863,1330,1212,3266,502
34972,5219,3987,958,1876,908,245,1465,1510,552,460,1232,228,370,386,248,955,277
34974,8948,6245,1001,2123,2284,837,1491,3636,694,424,2703,290,564,1217,632,2113,590
34981,1141,772,188,389,195,0,307,310,67,88,369,149,158,38,24,240,129
34982,9337,6321,1176,2620,1773,752,1750,3133,902,536,3016,397,706,1035,878,2488,528
34983,10297,7823,1065,3644,2156,958,2453,3845,778,747,2474,327,693,926,528,1864,610
34984,3518,2827,359,1548,730,190,1020,1300,309,198,691,95,197,305,94,499,192
34986,2829,2177,93,421,1224,439,271,1838,19,49,652,34,71,370,177,562,90
34987,387,353,84,196,73,0,157,123,53,20,34,0,20,14,0,7,27
34990,9956,7618,427,3186,2908,1097,2035,4757,565,261,2338,212,654,901,571,1955,383
34994,7055,3601,553,1273,1102,673,837,1961,424,379,3454,486,962,1140,866,3056,398
34996,5275,3120,209,881,1365,665,510,2144,217,249,2155,126,296,769,964,1928,227
34997,14581,9934,1216,3744,3226,1748,2451,6095,964,424,4647,458,1469,1470,1250,3781,866
35004,2626,1991,543,947,429,72,763,827,231,170,635,145,253,138,99,558,77
35005,3420,2608,518,1148,766,176,931,1311,178,188,812,133,263,231,185,733,79
35006,1131,859,150,449,224,36,371,316,87,85,272,26,142,66,38,238,34
35007,7306,5650,1690,2954,854,152,2610,2245,405,390,1656,464,602,417,173,1430,226
35010,8615,6038,1304,2686,1510,538,1807,2562,893,776,2577,290,822,783,682,2382,195
35014,1425,1121,244,542,305,30,327,480,187,127,304,45,92,101,66,266,38
35016,6343,4698,975,2109,1327,287,1636,2240,455,367,1645,252,470,520,403,1566,79
35019,777,598,147,256,145,50,244,278,41,35,179,24,78,43,34,175,4
35020,12200,8378,1808,3527,2231,812,1781,2298,1986,2313,3822,390,1131,1278,1023,3553,269
35022,5537,4206,1033,1801,1066,306,1149,1914,790,353,1331,230,372,492,237,1233,98
35023,9268,6876,1251,3118,1935,572,2151,3457,584,684,2392,388,657,696,651,2137,255
35031,2968,2260,515,1015,581,149,825,1089,175,171,708,98,193,230,187,642,66
35033,1293,1064,264,486,250,64,423,468,94,79,229,35,67,94,33,178,51
35034,1670,1217,261,502,403,51,382,433,200,202,453,146,88,114,105,417,36
35035,534,440,57,288,66,29,155,213,34,38,94,15,31,29,19,82,12
35036,149,107,23,48,26,10,30,39,21,17,42,5,11,14,12,42,0
35040,2697,2085,557,963,475,90,848,797,248,192,612,97,198,194,123,566,46
35042,1922,1388,309,550,429,100,463,649,139,137,534,77,115,246,96,511,23
35043,1534,1303,244,753,255,51,566,581,83,73,231,62,82,76,11,219,12
35044,3128,2300,599,891,683,127,704,895,350,351,828,138,241,316,133,790,38
35045,5220,3699,919,1552,942,286,1219,1674,502,304,1521,213,353,572,383,1376,145
35046,1827,1331,272,666,323,70,489,682,105,55,496,63,96,205,132,434,62
35049,1187,948,182,459,247,60,372,425,77,74,239,34,56,107,42,210,29
35051,2815,2035,539,903,517,76,695,860,257,223,780,111,248,208,213,708,72
35052,59,51,0,21,30,0,13,38,0,0,8,0,8,0,0,0,8
35053,981,820,162,373,256,29,242,489,43,46,161,20,29,69,43,138,23
35054,1602,1312,235,538,448,91,499,674,47,92,290,62,80,109,39,271,19
35055,7935,5055,1286,2063,1292,414,1654,2299,620,482,2880,465,744,970,701,2658,222
35057,4425,3444,750,1564,917,213,1269,1666,246,263,981,140,353,321,167,874,107
35058,3784,2925,568,1374,802,181,1127,1553,102,143,859,191,247,261,160,750,109
35060,299,186,31,79,42,34,28,22,32,104,113,15,46,38,14,113,0
35061,457,390,30,201,94,65,110,130,45,105,67,8,19,30,10,55,12
35062,2997,2303,495,997,649,162,869,1097,132,205,694,51,235,228,180,639,55
35063,1328,1001,239,441,296,25,308,468,111,114,327,88,66,105,68,308,19
35064,4806,3306,693,1741,623,249,931,873,802,700,1500,185,504,478,333,1414,86
35068,2202,1619,377,673,426,143,428,785,206,200,583,78,186,202,117,535,48
35070,118,90,9,33,42,6,25,48,2,15,28,6,7,8,7,27,1
35071,5533,4122,653,1972,1195,302,1308,2169,325,320,1411,197,344,483,387,1328,83
35072,1979,1417,240,664,392,121,369,640,217,191,562,78,184,209,91,516,46
35073,1051,780,128,325,249,78,227,362,80,111,271,12,80,96,83,250,21
35074,60,53,10,20,15,8,12,20,7,14,7,0,0,0,7,7,0
35077,4994,3670,851,1553,1062,204,1262,1776,313,319,1324,303,326,436,259,1170,154
35078,1008,768,179,315,227,47,288,328,48,104,240,39,101,85,15,207,33
35079,2649,1969,382,1018,466,103,816,930,158,65,680,104,210,218,148,629,51
35080,4349,3462,1191,1682,526,63,1679,1413,242,128,887,296,346,159,86,752,135
35082,7,7,0,7,0,0,0,7,0,0,0,0,0,0,0,0,0
35083,1128,884,260,359,210,55,389,395,73,27,244,19,59,106,60,218,26
35085,3143,2384,641,1045,579,119,956,1039,204,185,759,131,241,221,166,679,80
35087,828,605,145,304,124,32,212,298,42,53,223,42,57,79,45,201,22
35089,950,721,162,352,190,17,208,305,101,107,229,36,67,82,44,191,38
35091,422,338,87,161,73,17,140,130,42,26,84,12,16,42,14,76,8
35094,5247,3737,873,1767,892,205,1175,1695,513,354,1510,182,456,567,305,1311,199
35096,2640,1997,452,907,566,72,600,980,235,182,643,78,234,207,124,591,52
35097,693,537,133,273,106,25,234,246,38,19,156,39,30,42,45,150,6
35098,557,393,94,212,81,6,184,153,45,11,164,7,37,74,46,139,25
35111,3753,3253,644,1587,849,173,1165,1612,238,238,500,82,194,155,69,412,88
35112,172,131,43,65,21,2,45,37,31,18,41,12,14,10,5,38,3
35114,1489,1197,356,599,206,36,549,458,120,70,292,85,113,75,19,232,60
35115,5458,3995,1074,1852,889,180,1431,1795,428,341,1463,538,342,355,228,1123,340
35116,1423,1125,275,483,298,69,447,468,121,89,298,28,73,161,36,275,23
35117,1903,1528,274,693,451,110,579,795,72,82,375,31,105,146,93,344,31
35118,1359,1021,171,419,318,113,352,469,53,147,338,25,85,134,94,310,28
35119,44,24,0,10,5,9,10,9,0,5,20,0,0,20,0,5,15
35120,2731,2202,649,958,502,93,917,932,199,154,529,89,168,178,94,483,46
35121,5355,3939,1049,1731,995,164,1429,1832,378,300,1416,204,343,441,428,1328,88
35124,6471,4698,1105,2304,1145,144,1948,2063,337,350,1773,392,742,453,186,1556,217
35125,3608,2659,734,1132,628,165,956,1176,301,226,949,231,190,363,165,838,111
35126,6926,5773,1084,3256,1163,270,2604,2355,409,405,1153,156,492,360,145,1052,101
35127,3648,3005,354,1683,780,188,1195,1380,188,242,643,105,96,206,236,620,23
35128,2868,2153,361,1015,603,174,750,1117,179,107,715,89,272,230,124,654,61
35130,1664,1213,227,551,340,95,388,595,111,119,451,36,151,179,85,396,55
35131,1563,1155,275,529,294,57,444,492,138,81,408,14,99,185,110,401,7
35133,1579,1299,218,659,393,29,445,651,67,136,280,50,86,90,54,246,34
35135,598,388,67,178,130,13,118,206,42,22,210,43,58,82,27,182,28
35136,649,463,68,218,126,51,123,237,62,41,186,22,45,63,56,182,4
35139,33,21,10,5,6,0,10,11,0,0,12,0,0,6,6,12,0
35143,1331,1032,239,457,302,34,288,603,78,63,299,37,145,99,18,262,37
35146,2591,2067,383,1039,568,77,819,974,160,114,524,35,190,201,98,486,38
35147,1210,905,134,466,259,46,323,433,60,89,305,19,86,135,65,282,23
35148,1249,959,174,421,315,49,316,481,69,93,290,39,59,117,75,276,14
35149,265,196,46,82,62,6,35,106,35,20,69,0,26,25,18,62,7
35150,7460,4999,1102,2329,1267,301,1488,2175,854,482,2461,304,607,871,679,2270,191
35151,3292,2497,450,1123,786,138,903,1232,154,208,795,147,259,252,137,716,79
35160,10175,7084,1479,3237,1853,515,1994,3172,1036,882,3091,338,963,1139,651,2841,250
35171,1053,836,199,394,196,47,354,390,41,51,217,30,68,60,59,198,19
35172,829,629,161,252,189,27,213,308,45,63,200,27,66,78,29,184,16
35173,7011,5717,880,3160,1416,261,2553,2543,323,298,1294,172,481,334,307,1177,117
35175,1967,1560,376,607,508,69,524,839,61,136,407,80,110,138,79,358,49
35176,360,308,128,111,63,6,79,160,33,36,52,7,7,24,14,38,14
35178,1318,1018,240,426,274,78,348,439,117,114,300,39,147,71,43,262,38
35179,3551,2770,630,1231,696,213,1102,1281,211,176,781,125,286,240,130,704,77
35180,4900,4004,916,1797,1126,165,1438,1903,338,325,896,151,209,312,224,831,65
35183,186,138,48,42,27,21,66,59,0,13,48,6,16,17,9,48,0
35184,2056,1581,427,654,408,92,520,756,180,125,475,99,149,166,61,418,57
35186,1520,1199,265,527,336,71,413,607,101,78,321,27,102,103,89,301,20
35188,821,608,160,284,141,23,221,302,38,47,213,33,37,117,26,191,22
35203,1207,413,204,100,78,31,18,84,193,118,794,116,281,197,200,722,72
35204,6033,3609,732,1438,919,520,516,924,966,1203,2424,266,849,801,508,2211,213
35205,11198,3441,1338,1256,572,275,726,1304,738,673,7757,3738,2306,1071,642,6483,1274
35206,8316,5535,1219,2738,1118,460,1456,1669,1259,1151,2781,404,1002,800,575,2456,325
35207,4255,2949,571,1259,957,162,395,878,928,748,1306,108,435,482,281,1228,78
35208,6499,4573,842,2466,957,308,1132,1088,1262,1091,1926,228,882,593,223,1752,174
35209,14101,6839,2637,2727,1019,456,2216,2661,1085,877,7262,3530,1933,943,856,5858,1404
35210,5453,3561,669,1725,946,221,1147,1588,397,429,1892,329,599,592,372,1646,246
35211,11804,8144,1928,3465,2130,621,1361,2108,2532,2143,3660,392,1272,1199,797,3410,250
35212,6074,3915,1254,1628,743,290,787,936,1254,938,2159,379,947,564,269,1772,387
35213,6123,3961,652,1712,1079,518,1474,2030,266,191,2162,601,506,500,555,1937,225
35214,8470,6123,1125,2833,1646,519,1576,2296,1125,1126,2347,257,746,742,602,2162,185
35215,18109,12916,3442,5981,2684,809,4188,4762,2531,1435,5193,1204,1837,1423,729,4529,664
35216,14119,8284,1897,3916,1777,694,3043,3529,903,809,5835,2058,1626,1109,1042,4988,847
35217,6051,4149,898,1876,936,439,1154,1491,687,817,1902,201,585,721,395,1696,206
35218,3847,2647,723,1289,441,194,505,581,909,652,1200,211,504,309,176,1146,54
35221,2409,1660,258,601,547,254,362,398,343,557,749,53,279,297,120,698,51
35222,4052,2062,636,776,482,168,461,846,394,361,1990,511,843,337,299,1556,434
35223,4340,3249,226,1792,953,278,1359,1598,170,122,1091,368,238,242,243,975,116
35224,2720,1967,437,758,566,206,516,672,340,439,753,142,183,233,195,669,84
35226,10548,8019,1273,4008,2161,577,3001,4039,498,481,2529,653,713,721,442,2160,369
35228,4312,3039,660,1519,614,246,884,837,696,622,1273,93,445,447,288,1173,100
35233,81,0,0,0,0,0,0,0,0,0,81,62,4,15,0,67,14
35234,2727,1717,394,713,474,136,309,376,473,559,1010,127,453,318,112,905,105
35235,7394,5512,1346,2437,1358,371,2039,2553,422,498,1882,267,667,542,406,1712,170
35242,12669,8811,1641,5213,1793,164,4198,3753,484,376,3858,1884,1331,501,142,3295,563
35243,6991,4415,705,2235,1177,298,1610,2141,270,394,2576,1155,706,439,276,2058,518
35244,10515,7511,1490,4300,1461,260,3450,3300,404,357,3004,1332,874,506,292,2594,410
35401,14328,6524,1727,2577,1561,659,1126,2319,1544,1535,7804,3981,1584,1306,933,5982,1822
35403,0,0,0,0,0,0,0,0,0,0,0,0,0,0,0,0,0
35404,7849,4774,1144,2082,1211,337,1332,1993,801,648,3075,1448,683,636,308,2317,758
35405,12573,8734,2512,4154,1644,424,2880,3322,1624,908,3839,1552,1049,749,489,3250,589
35406,4514,3010,453,1480,897,180,1186,1499,190,135,1504,527,456,304,217,1261,243
35441,613,420,121,146,128,25,105,187,76,52,193,4,94,67,28,168,25
35442,2201,1504,295,664,434,111,403,442,364,295,697,64,204,258,171,664,33
35443,908,571,91,263,140,77,138,107,129,197,337,40,104,115,78,312,25
35444,1153,897,266,398,181,52,333,391,74,99,256,23,74,121,38,234,22
35446,649,525,122,237,132,34,145,266,79,35,124,11,23,70,20,124,0
35447,1344,1003,217,470,260,56,273,372,244,114,341,41,102,116,82,315,26
35452,1122,868,122,473,214,59,353,407,65,43,254,43,70,116,25,236,18
35453,3338,2517,533,1363,472,149,904,1157,261,195,821,116,280,287,138,714,107
35456,1446,1105,316,474,268,47,572,376,86,71,341,38,93,162,48,301,40
35457,22,22,0,5,17,0,0,17,0,5,0,0,0,0,0,0,0
35458,103,69,11,40,14,4,27,28,0,14,34,20,0,0,14,34,0
35459,351,248,64,92,67,25,88,79,36,45,103,8,43,32,20,85,18
35460,262,151,51,60,27,13,55,40,25,31,111,15,48,40,8,105,6
35461,826,619,92,305,180,42,196,297,62,64,207,20,92,57,38,198,9
35462,2313,1583,344,698,390,151,326,534,423,300,730,90,243,224,173,703,27
35463,498,387,53,226,64,44,158,161,42,26,111,8,24,45,34,103,8
35464,213,134,47,62,23,2,47,27,44,16,79,7,21,40,11,71,8
35466,2197,1649,305,732,509,103,575,774,145,155,548,69,118,198,163,530,18
35469,192,124,12,55,51,6,50,46,20,8,68,29,7,28,4,52,16
35470,2078,1267,375,484,261,147,345,351,314,257,811,353,139,159,160,649,162
35471,19,14,0,0,14,0,0,14,0,0,5,0,0,5,0,5,0
35473,5215,3777,774,1822,1030,151,1310,1733,355,379,1438,504,339,370,225,1264,174
35474,1967,1440,297,773,309,61,542,461,194,243,527,76,164,148,139,499,28
35475,4047,3317,753,1734,716,114,1433,1448,299,137,730,108,330,208,84,612,118
35476,3042,1860,661,667,421,111,402,591,519,348,1182,246,369,333,234,1043,139
35477,131,93,15,51,22,5,36,7,24,26,38,5,10,7,16,31,7
35480,382,312,108,127,58,19,79,114,79,40,70,0,42,20,8,62,8
35481,1527,1060,205,509,299,47,309,426,199,126,467,48,123,174,122,441,26
35490,1015,792,246,327,194,25,335,351,59,47,223,51,62,84,26,204,19
35501,4894,3219,759,1250,904,306,926,1423,392,478,1675,222,451,567,435,1568,107
35503,3483,2604,472,1256,704,172,834,1319,203,248,879,86,293,341,159,797,82
35504,5213,3876,802,1762,1100,212,1334,1860,369,313,1337,247,399,462,229,1173,164
35540,865,683,166,283,184,50,240,342,65,36,182,35,47,54,46,166,16
35541,1416,1037,272,453,261,51,344,546,103,44,379,22,105,158,94,351,28
35542,451,381,78,161,114,28,121,217,26,17,70,34,16,15,5,64,6
35543,417,299,77,121,77,24,116,143,25,15,118,22,20,48,28,103,15
35544,324,240,66,91,69,14,76,115,34,15,84,2,16,45,21,78,6
35545,73,52,11,25,14,2,21,26,4,1,21,0,2,15,4,21,0
35546,1591,1190,254,564,297,75,379,608,124,79,401,59,73,193,76,379,22
35548,758,541,157,174,173,37,179,264,45,53,217,38,55,71,53,187,30
35549,1857,1300,264,556,384,96,334,630,180,156,557,40,160,210,147,521,36
35550,2535,1754,416,804,419,115,562,723,242,227,781,115,200,257,209,730,51
35552,396,269,67,102,92,8,94,136,17,22,127,31,16,39,41,127,0
35553,1961,1450,377,590,419,64,523,695,117,115,511,66,172,150,123,486,25
35554,600,427,87,211,98,31,136,218,33,40,173,27,30,54,62,163,10
35555,4451,3046,649,1292,900,205,1037,1468,244,297,1405,148,340,464,453,1315,90
35559,30,26,8,17,1,0,6,12,3,5,4,0,0,1,3,4,0
35563,1928,1392,346,546,388,112,433,638,185,136,536,50,144,222,120,508,28
35564,1015,701,166,298,187,50,235,342,53,71,314,28,87,121,78,292,22
35565,5927,4313,982,1863,1239,229,1448,2007,472,386,1614,200,531,528,355,1550,64
35570,4448,3160,776,1201,940,243,949,1617,325,269,1288,133,347,458,350,1214,74
35571,418,309,71,118,99,21,124,141,16,28,109,6,48,28,27,105,4
35572,498,353,75,169,89,20,139,189,14,11,145,0,42,63,40,136,9
35574,686,526,111,222,145,48,182,252,37,55,160,25,46,42,47,149,11
35575,449,347,71,158,94,24,119,163,40,25,102,10,18,51,23,93,9
35576,1444,1043,218,411,323,91,322,545,80,96,401,50,129,125,97,387,14
35578,2321,1727,420,794,434,79,601,847,144,135,594,109,142,215,128,543,51
35579,1203,873,187,373,255,58,300,414,87,72,330,42,85,114,89,305,25
35580,1854,1436,284,654,372,126,478,622,145,191,418,46,122,156,94,379,39
35581,2349,1832,526,716,493,97,664,876,204,88,517,62,154,167,134,494,23
35582,1814,1299,275,527,394,103,412,638,124,125,515,61,160,174,120,478,37
35584,143,109,24,41,37,7,39,32,10,28,34,6,8,13,7,30,4
35585,575,442,124,212,71,35,177,201,39,25,133,9,39,51,34,129,4
35586,2053,1500,300,682,414,104,511,695,135,159,553,50,151,180,172,510,43
35587,420,290,46,163,61,20,120,126,29,15,130,24,26,31,49,115,15
35592,2015,1447,352,606,400,89,452,685,202,108,568,60,157,217,134,544,24
35593,846,630,179,204,188,59,199,319,52,60,216,38,37,68,73,186,30
35594,3064,2247,450,1048,589,160,777,1135,190,145,817,117,196,226,278,777,40
35601,13983,9224,1994,4078,2453,699,2721,3902,1511,1090,4759,962,1521,1394,882,4358,401
35603,10332,7619,1726,3816,1836,241,2843,3494,828,454,2713,717,948,680,368,2440,273
35610,887,654,129,318,171,36,235,338,41,40,233,11,63,66,93,227,6
35611,9446,6314,1555,2858,1504,397,2004,2706,878,726,3132,580,875,1026,651,2890,242
35613,4606,3846,649,2004,1061,132,1551,1859,205,231,760,113,291,228,128,715,45
35614,2662,2083,431,908,632,112,692,961,234,196,579,90,215,204,70,537,42
35616,1935,1502,292,606,487,117,469,738,119,176,433,52,96,171,114,431,2
35618,938,600,136,298,139,27,185,205,101,109,338,57,103,85,93,319,19
35619,1947,1564,431,717,357,59,630,705,131,98,383,89,78,137,79,344,39
35620,2649,2009,484,981,466,78,836,834,215,124,640,90,242,168,140,563,77
35621,770,616,183,283,132,18,304,254,46,12,154,43,21,66,24,148,6
35622,2615,2026,475,915,521,115,755,953,136,182,589,76,146,207,160,523,66
35630,13855,7847,1977,3000,2063,807,1822,3605,1469,951,6008,1912,1445,1372,1279,5189,819
35633,7591,6015,1203,2960,1568,284,2335,2750,477,453,1576,343,414,565,254,1433,143
35634,3600,2949,392,1442,965,150,1054,1510,168,217,651,91,173,209,178,547,104
35640,8363,6332,1308,3074,1600,350,2399,2955,513,465,2031,368,610,643,410,1855,176
35643,1241,957,201,451,244,61,348,407,102,100,284,20,98,118,48,260,24
35645,4878,3900,828,1872,971,229,1609,1784,266,241,978,187,300,332,159,876,102
35646,2045,1511,301,694,437,79,511,628,191,181,534,67,150,192,125,497,37
35647,380,329,72,186,71,0,161,133,23,12,51,14,1,15,21,50,1
35648,1532,1116,276,524,238,78,491,490,52,83,416,26,112,150,128,386,30
35649,23,17,0,9,8,0,7,10,0,0,6,0,1,3,2,6,0
35650,5381,4035,941,1835,1063,196,1486,1931,311,307,1346,194,366,472,314,1258,88
35651,464,354,106,173,61,14,170,129,20,35,110,14,29,36,31,107,3
35652,3224,2377,519,982,753,123,799,1225,201,152,847,83,188,335,241,775,72
35653,4495,3159,725,1283,961,190,1030,1518,341,270,1336,150,316,535,335,1220,116
35654,2537,1926,507,873,454,92,698,858,218,152,611,107,137,271,96,553,58
35660,4159,2651,616,1076,707,252,726,1064,482,379,1508,220,413,396,479,1360,148
35661,6356,4771,870,2393,1271,237,1807,2172,363,429,1585,226,523,591,245,1418,167
35670,2783,2166,469,1057,560,80,846,1005,153,162,617,103,207,231,76,553,64
35671,807,628,151,299,137,41,229,239,109,51,179,43,71,33,32,161,18
35672,2631,2040,399,905,566,170,692,894,210,244,591,54,125,242,170,574,17
35673,2874,2298,570,1140,499,89,884,1048,264,102,576,121,145,203,107,496,80
35674,7427,5241,1136,2177,1492,436,1656,2611,523,451,2186,342,606,666,572,2000,186
35677,758,578,126,224,190,38,172,319,65,22,180,44,21,65,50,175,5
35739,1538,1149,234,595,269,51,469,515,90,75,389,80,82,146,81,314,75
35740,1611,1116,262,482,279,93,314,509,177,116,495,85,132,172,106,452,43
35741,899,753,100,328,256,69,290,393,0,70,146,34,55,40,17,139,7
35742,0,0,0,0,0,0,0,0,0,0,0,0,0,0,0,0,0
35744,953,731,184,291,216,40,281,343,48,59,222,32,68,81,41,215,7
35745,162,94,7,25,51,11,19,60,0,15,68,0,14,25,29,68,0
35746,319,246,44,92,108,2,80,145,2,19,73,36,16,21,0,57,16
35747,2209,1674,439,676,463,96,591,785,184,114,535,91,200,151,93,505,30
35748,2080,1582,293,838,358,93,535,766,155,126,498,65,211,141,81,445,53
35749,4421,3664,970,1914,684,96,1578,1566,377,143,757,227,304,197,29,694,63
35750,4299,3482,878,1711,797,96,1520,1449,301,212,817,138,313,238,128,739,78
35751,122,82,13,39,30,0,39,37,6,0,40,8,18,5,9,40,0
35752,858,654,162,307,171,14,199,294,73,88,204,25,65,72,42,180,24
35754,1958,1452,282,703,370,97,516,652,161,123,506,124,185,178,19,440,66
35755,249,156,18,57,77,4,42,103,5,6,93,2,5,58,28,93,0
35756,1586,1177,258,613,238,68,349,502,179,147,409,74,160,129,46,353,56
35757,2724,2210,492,1250,431,37,1084,873,163,90,514,32,348,92,42,437,77
35758,11725,8504,1933,5072,1412,87,4033,3072,964,435,3221,1000,1403,560,258,2778,443
35759,1579,1368,171,762,388,47,565,682,81,40,211,40,95,67,9,196,15
35760,1952,1435,321,653,373,88,526,658,118,133,517,132,113,169,103,449,68
35761,3084,2432,631,1107,598,96,1025,908,272,227,652,85,219,222,126,614,38
35763,2555,2150,333,1261,466,90,1048,912,102,88,405,86,155,106,58,374,31
35764,205,168,14,130,14,10,81,63,10,14,37,14,6,3,14,32,5
35765,1531,1189,286,513,327,63,410,578,110,91,342,33,98,121,90,327,15
35766,30,24,0,14,6,4,6,18,0,0,6,6,0,0,0,6,0
35768,4672,3249,688,1380,977,204,1030,1421,375,423,1423,126,356,443,498,1301,122
35769,3896,2853,574,1290,865,124,844,1468,327,214,1043,217,312,393,121,939,104
35771,1431,1091,287,492,262,50,419,494,105,73,340,43,43,166,88,312,28
35772,2104,1511,346,706,355,104,474,711,154,172,593,76,174,243,100,577,16
35773,3414,2728,700,1372,562,94,1129,1134,247,218,686,101,303,208,74,617,69
35774,34,29,4,18,4,3,7,7,15,0,5,0,5,0,0,5,0
35775,235,157,0,97,60,0,52,96,0,9,78,6,8,38,26,78,0
35776,1583,1210,290,477,361,82,366,672,77,95,373,46,125,121,81,334,39
35801,10318,5891,1055,2317,1875,644,1570,2971,776,574,4427,1111,1297,1138,881,3968,459
35802,9530,6011,734,2437,2288,552,1720,3459,464,368,3519,1036,1051,944,488,3188,331
35803,9918,7521,1078,4297,1839,307,3186,3357,612,366,2397,508,943,714,232,2129,268
35805,9452,5121,1867,2002,996,256,948,1676,1743,754,4331,1187,1580,1130,434,3652,679
35806,4834,2876,718,1398,608,152,1125,1361,245,145,1958,705,739,398,116,1670,288
35808,498,445,222,223,0,0,335,48,62,0,53,20,33,0,0,53,0
35810,10840,7787,1326,3710,2298,453,2041,3085,1286,1375,3053,456,1065,1079,453,2756,297
35811,8609,6476,1289,3271,1544,372,2238,2958,752,528,2133,391,826,660,256,1818,315
35816,6748,3374,1163,1326,680,205,664,1246,940,524,3374,1448,929,637,360,2821,553
35824,1485,802,228,400,155,19,244,372,131,55,683,328,262,93,0,566,117
35901,8335,5401,1257,2236,1405,503,1365,2247,943,846,2934,396,656,1055,827,2706,228
35903,7757,5246,1262,2254,1220,510,1533,2288,680,745,2511,427,612,857,615,2259,252
35904,6315,4420,958,1678,1353,431,1160,2098,574,588,1895,162,497,678,558,1720,175
35905,2188,1713,339,728,540,106,611,862,123,117,475,52,190,106,127,421,54
35906,3792,2693,545,1190,776,182,859,1286,361,187,1099,215,361,333,190,1008,91
35907,2597,2131,391,1087,567,86,824,1124,111,72,466,61,121,173,111,432,34
35950,6946,5002,1484,2080,1184,254,1689,2153,642,518,1944,324,501,725,394,1728,216
35951,2558,1975,502,879,486,108,725,949,175,126,583,88,149,244,102,493,90
35952,2954,2313,517,962,685,149,799,1185,152,177,641,98,166,222,155,571,70
35953,2624,2050,443,960,527,120,748,1032,150,120,574,86,200,189,99,479,95
35954,5095,3739,956,1519,956,308,1200,1563,422,554,1356,111,335,589,321,1262,94
35956,3172,2425,582,1093,618,132,865,1169,223,168,747,91,237,278,141,652,95
35957,5958,4273,1154,1670,1211,238,1485,1980,470,338,1685,209,457,595,424,1555,130
35958,1259,993,182,505,267,39,356,515,45,77,266,29,107,85,45,227,39
35959,1786,1338,229,533,471,105,326,754,150,108,448,46,164,130,108,415,33
35960,3946,2828,570,1136,896,226,801,1540,226,261,1118,122,239,493,264,1035,83
35961,2280,1588,488,658,334,108,603,661,149,175,692,104,198,229,161,620,72
35962,2976,2294,595,1037,560,102,942,1009,221,122,682,113,160,252,157,613,69
35963,593,515,110,279,109,17,204,254,30,27,78,19,9,36,14,78,0
35966,1450,1108,337,385,302,84,447,458,94,109,342,52,88,108,94,302,40
35967,6676,4759,1155,2134,1101,369,1680,2089,534,456,1917,357,529,651,380,1704,213
35968,458,362,107,166,72,17,154,150,30,28,96,14,31,37,14,88,8
35971,1890,1416,378,586,387,65,498,661,139,118,474,70,104,170,130,451,23
35972,329,252,33,130,82,7,89,111,24,28,77,28,8,0,41,67,10
35973,1267,962,233,385,293,51,337,463,56,106,305,55,80,102,68,277,28
35974,661,443,129,162,103,49,175,180,55,33,218,7,48,84,79,214,4
35975,505,396,71,158,133,34,121,239,17,19,109,12,43,34,20,96,13
35976,6482,4559,885,2207,1165,302,1644,2089,438,388,1923,156,689,725,353,1805,118
35978,2185,1688,413,699,461,115,565,897,104,122,497,48,117,196,136,448,49
35979,436,362,138,103,115,6,107,177,50,28,74,18,26,19,11,74,0
35980,1700,1316,354,532,367,63,446,648,145,77,384,39,86,119,140,342,42
35981,868,640,121,270,191,58,172,352,54,62,228,43,69,84,32,215,13
35983,1230,939,165,373,353,48,296,496,73,74,291,66,72,95,58,283,8
35984,702,475,85,207,148,35,145,224,43,63,227,39,68,76,44,190,37
35986,3087,2268,558,975,595,140,864,1012,200,192,819,101,241,296,181,750,69
35987,1106,849,184,388,222,55,296,397,74,82,257,37,49,108,63,233,24
35988,674,510,122,242,118,28,182,231,49,48,164,12,59,51,42,159,5
35989,1357,1024,281,474,242,27,356,508,106,54,333,65,106,105,57,300,33
35990,17,17,4,6,4,3,3,10,4,0,0,0,0,0,0,0,0
36003,643,440,87,210,94,49,164,122,69,85,203,33,55,81,34,192,11
36005,722,496,103,192,147,54,141,255,64,36,226,41,71,62,52,201,25
36006,498,374,71,156,122,25,148,165,23,38,124,17,27,60,20,122,2
36009,1126,795,148,319,233,95,266,329,86,114,331,30,89,117,95,323,8
36010,1997,1326,234,613,366,113,305,560,232,229,671,97,145,274,155,618,53
36013,52,37,0,22,15,0,0,15,14,8,15,0,15,0,0,15,0
36016,1517,1086,245,477,289,75,293,417,238,138,431,52,127,160,92,403,28
36017,685,503,94,221,142,46,147,208,62,86,182,13,37,77,55,175,7
36020,355,290,54,134,80,22,103,137,23,27,65,9,14,29,13,56,9
36022,3444,2848,614,1507,630,97,1274,1201,242,131,596,121,200,201,74,535,61
36024,2065,1549,246,721,471,111,494,749,145,161,516,76,157,155,128,454,62
36025,901,753,162,351,173,67,311,316,42,84,148,9,43,69,27,133,15
36026,436,356,27,165,143,21,114,223,19,0,80,0,29,51,0,80,0
36027,6860,4876,1064,2383,1194,235,1471,1902,946,557,1984,286,536,677,485,1829,155
36028,829,559,127,263,141,28,166,282,64,47,270,59,63,72,76,244,26
36029,447,299,48,144,69,38,109,118,24,48,148,24,82,25,17,141,7
36030,205,162,35,48,55,24,53,73,23,13,43,5,5,27,6,43,0
36031,92,77,54,12,11,0,26,6,21,24,15,0,8,7,0,15,0
36032,975,692,160,321,151,60,225,219,156,92,283,36,79,99,69,262,21
36033,1898,1278,217,550,397,114,362,544,191,181,620,49,131,236,204,590,30
36034,304,196,74,45,54,23,65,100,15,16,108,26,28,35,19,108,0
36035,726,484,91,206,108,79,117,268,40,59,242,32,76,72,62,222,20
36036,948,739,106,365,185,83,221,351,92,75,209,13,51,67,78,189,20
36037,5433,3847,764,1907,843,333,1071,1399,835,542,1586,173,492,556,365,1448,138
36039,86,64,24,0,22,18,7,20,24,13,22,0,0,7,15,22,0
36040,1585,1107,206,567,233,101,237,274,341,255,478,53,144,164,117,426,52
36041,536,347,52,121,116,58,95,178,19,55,189,19,63,70,37,185,4
36042,522,397,73,216,81,27,129,200,30,38,125,29,26,60,10,110,15
36043,1494,1130,250,550,254,76,376,490,166,98,364,62,115,176,11,347,17
36046,619,492,85,250,157,0,159,231,45,57,127,19,30,55,23,93,34
36047,592,456,109,177,126,44,104,149,117,86,136,28,63,20,25,123,13
36048,743,573,112,211,184,66,127,254,70,122,170,13,36,65,56,149,21
36049,2171,1476,312,659,399,106,435,604,254,183,695,76,136,232,251,648,47
36051,668,491,103,232,117,39,195,200,54,42,177,43,62,29,43,143,34
36052,223,164,34,31,99,0,34,116,0,14,59,27,18,14,0,59,0
36053,1034,694,145,305,161,83,184,245,122,143,340,27,93,145,75,312,28
36054,3904,3130,934,1560,524,112,1348,1069,494,219,774,231,233,190,120,647,127
36064,1770,1457,211,847,379,20,559,579,171,148,313,19,146,92,56,313,0
36065,48,48,19,29,0,0,0,40,0,8,0,0,0,0,0,0,0
36066,4681,3726,725,1885,909,207,1522,1662,323,219,955,246,278,297,134,865,90
36067,8380,6427,1412,3192,1551,272,2298,2529,960,640,1953,332,504,706,411,1744,209
36069,935,611,107,271,147,86,171,261,93,86,324,30,41,172,81,312,12
36071,225,168,66,64,33,5,74,53,33,8,57,6,20,6,25,57,0
36075,750,543,110,268,127,38,151,154,133,105,207,39,54,52,62,178,29
36078,4826,3382,770,1512,811,289,1240,1360,395,387,1444,208,349,488,399,1320,124
36079,3037,2166,525,991,564,86,747,899,325,195,871,336,290,183,62,783,88
36080,872,665,123,258,226,58,231,354,41,39,207,48,85,45,29,170,37
36081,5738,3396,917,1482,754,243,998,1151,648,599,2342,922,443,547,430,1794,548
36083,4488,2740,654,1191,687,208,483,883,800,574,1748,319,501,609,319,1542,206
36088,1673,868,231,339,176,122,150,281,257,180,805,315,222,122,146,635,170
36089,2973,2022,501,877,437,207,356,594,698,374,951,136,284,337,194,854,97
36091,1285,972,202,444,252,74,377,431,88,76,313,44,95,99,75,293,20
36092,6155,4526,1056,2121,1083,266,1545,1859,677,445,1629,241,492,529,367,1529,100
36093,2432,2082,319,1101,614,48,832,1081,80,89,350,61,160,77,52,279,71
36104,5753,3214,1270,1082,553,309,645,600,1212,757,2539,624,846,724,345,2319,220
36105,5429,3861,811,1740,1107,203,783,1290,930,858,1568,184,673,428,283,1341,227
36106,5846,3543,599,1738,863,343,1348,1637,295,263,2303,660,633,578,432,2027,276
36107,4137,2253,736,955,422,140,560,873,493,327,1884,324,720,437,403,1600,284
36108,8987,6237,1365,2780,1608,484,1169,1877,1760,1431,2750,368,864,1097,421,2449,301
36109,10525,7165,1297,3239,1891,738,2292,3462,731,680,3360,438,1035,1123,764,3009,351
36110,4847,3467,759,1515,912,281,841,1226,735,665,1380,158,515,481,226,1266,114
36111,5280,3261,489,1532,869,371,936,1553,499,273,2019,492,444,470,613,1790,229
36113,187,155,121,26,8,0,104,17,26,8,32,10,14,0,8,22,10
36115,213,192,79,113,0,0,152,23,17,0,21,0,5,16,0,5,16
36116,14779,10108,3272,5175,1401,260,3421,2804,2745,1138,4671,1940,1557,740,434,3919,752
36117,15098,9751,2355,5121,1930,345,3688,4284,1021,758,5347,2074,1784,974,515,4519,828
36201,8911,5902,1292,2453,1672,485,1326,2139,1225,1212,3009,388,874,1047,700,2754,255
36203,6480,4802,1040,2373,1154,235,1780,2201,515,306,1678,356,509,488,325,1542,136
36205,9,4,0,4,0,0,4,0,0,0,5,5,0,0,0,5,0
36206,4834,3361,782,1417,961,201,996,1624,426,315,1473,283,514,428,248,1228,245
36207,7640,5013,913,2198,1436,466,1460,2475,544,534,2627,458,841,715,613,2373,254
36250,1608,1225,314,629,248,34,488,540,148,49,383,54,158,112,59,327,56
36251,2073,1487,321,617,459,90,506,698,165,118,586,63,194,230,99,542,44
36255,322,253,65,69,92,27,59,159,8,27,69,4,28,26,11,69,0
36256,409,290,59,145,79,7,122,115,23,30,119,35,28,25,31,101,18
36258,551,400,65,181,106,48,118,242,40,0,151,16,42,68,25,140,11
36260,1797,1396,244,762,322,68,536,615,114,131,401,64,112,147,78,341,60
36262,483,352,90,145,109,8,153,165,13,21,131,31,53,28,19,106,25
36263,213,162,43,61,47,11,49,75,17,21,51,21,6,12,12,45,6
36264,3498,2620,568,1163,749,140,880,1247,259,234,878,108,258,306,206,788,90
36265,6168,3852,880,1751,984,237,1344,1772,366,370,2316,1139,435,480,262,1756,560
36266,2331,1593,420,597,459,117,448,788,226,131,738,78,244,215,201,675,63
36267,22,22,0,22,0,0,14,8,0,0,0,0,0,0,0,0,0
36268,2042,1589,328,777,411,73,508,778,184,119,453,52,143,198,60,394,59
36269,485,366,118,129,108,11,154,178,5,29,119,6,53,45,15,119,0
36270,473,354,87,159,93,15,106,169,39,40,119,5,40,57,17,112,7
36271,2265,1727,357,897,419,54,684,792,167,84,538,52,161,231,94,506,32
36272,5631,4143,956,1806,1109,272,1373,2031,384,355,1488,214,470,488,316,1327,161
36273,1106,817,170,442,165,40,365,332,57,63,289,70,31,104,84,235,54
36274,4406,3128,734,1318,916,160,956,1367,478,327,1278,202,396,431,249,1165,113
36276,983,698,157,266,225,50,233,351,58,56,285,26,92,108,59,244,41
36277,2013,1560,313,733,419,95,511,734,163,152,453,92,101,194,66,398,55
36278,1366,973,165,430,308,70,308,467,113,85,393,49,102,143,99,371,22
36279,997,744,146,374,171,53,278,345,36,85,253,17,97,104,35,224,29
36280,1184,873,136,390,287,60,297,398,83,95,311,42,108,71,90,282,29
36301,13282,9212,2164,4244,2205,599,2911,3948,1452,901,4070,776,1259,1347,688,3548,522
36303,11090,7764,1749,3664,1810,541,2261,3115,1461,927,3326,671,1038,1088,529,3031,295
36305,4075,2718,631,1370,629,88,1075,1252,294,97,1357,421,378,331,227,1197,160
36310,2834,1990,324,819,691,156,510,951,257,272,844,60,234,318,232,789,55
36311,1233,911,196,423,231,61,373,341,110,87,322,67,62,80,113,282,40
36312,2262,1694,337,760,451,146,548,854,145,147,568,35,146,221,166,525,43
36313,90,49,19,18,5,7,7,12,11,19,41,0,0,16,25,41,0
36314,221,168,61,54,37,16,85,55,16,12,53,5,24,21,3,53,0
36316,754,617,112,252,199,54,229,328,24,36,137,34,41,41,21,120,17
36317,191,150,40,71,35,4,43,60,31,16,41,5,14,5,17,34,7
36318,493,353,41,140,159,13,96,191,27,39,140,11,52,45,32,123,17
36319,919,671,142,296,164,69,241,303,54,73,248,18,82,71,77,222,26
36320,1329,963,217,431,281,34,322,461,126,54,366,52,81,146,87,324,42
36322,3216,2124,487,1057,540,40,649,923,417,135,1092,246,379,330,137,946,146
36323,3386,2456,518,1031,750,157,731,1145,339,241,930,109,210,342,269,874,56
36330,11540,8208,1901,3820,2051,436,2720,3725,1189,574,3332,890,992,864,586,2845,487
36340,2244,1533,298,688,450,97,443,718,286,86,711,109,189,230,183,673,38
36343,618,437,66,212,140,19,98,246,56,37,181,26,23,85,47,167,14
36344,2121,1546,299,614,449,184,491,719,138,198,575,98,167,180,130,552,23
36345,2682,2043,383,1038,469,153,707,863,247,226,639,51,175,252,161,599,40
36346,777,631,99,327,180,25,243,293,32,63,146,12,10,75,49,141,5
36350,2163,1549,324,728,437,60,484,652,237,176,614,103,205,202,104,551,63
36351,1266,951,243,388,235,85,343,406,108,94,315,29,73,121,92,306,9
36352,1638,1324,247,631,336,110,483,637,118,86,314,19,91,117,87,287,27
36353,724,516,119,194,152,51,159,257,39,61,208,10,43,53,102,192,16
36360,8348,5879,1251,2669,1569,390,1810,2658,829,582,2469,474,667,865,463,2224,245
36362,1409,1357,956,396,5,0,964,226,162,5,52,39,8,3,2,46,6
36370,308,265,64,119,75,7,130,100,22,13,43,0,16,19,8,43,0
36371,293,212,38,95,65,14,61,112,17,22,81,5,36,18,22,77,4
36373,252,174,37,73,52,12,33,111,23,7,78,16,11,38,13,78,0
36374,417,266,56,117,78,15,81,122,37,26,151,24,50,56,21,147,4
36375,2919,2167,500,949,554,164,763,946,273,185,752,77,233,258,184,689,63
36376,1235,908,225,425,213,45,341,416,76,75,327,54,73,115,85,300,27
36401,3454,2313,423,1125,599,166,689,896,466,262,1141,179,323,367,272,1074,67
36420,8240,5717,1116,2547,1617,437,1953,2704,575,485,2523,285,597,871,770,2322,201
36425,464,367,50,173,86,58,89,88,99,91,97,3,26,28,40,95,2
36426,6442,4510,919,2089,1212,290,1499,1973,528,510,1932,247,492,722,471,1749,183
36432,1135,789,152,340,212,85,274,331,87,97,346,45,124,108,69,320,26
36435,319,201,41,97,56,7,56,69,44,32,118,0,88,18,12,118,0
36436,186,102,20,58,24,0,44,38,9,11,84,24,8,34,18,70,14
36441,1481,1079,204,475,342,58,321,512,110,136,402,50,93,169,90,347,55
36442,1462,946,139,389,332,86,291,441,83,131,516,68,146,188,114,471,45
36444,356,253,48,107,60,38,86,110,11,46,103,5,26,43,29,97,6
36445,2008,1515,457,654,328,76,619,602,201,93,493,61,163,143,126,461,32
36446,253,202,33,109,48,12,74,76,33,19,51,0,10,20,21,48,3
36451,2124,1612,274,716,504,118,540,704,192,176,512,63,138,159,152,495,17
36453,1081,752,124,365,204,59,269,319,59,105,329,13,77,151,88,307,22
36455,207,130,24,66,35,5,43,50,21,16,77,10,16,31,20,64,13
36456,856,620,101,252,166,101,165,322,56,77,236,9,67,91,69,219,17
36460,4571,3297,778,1461,866,192,1062,1389,508,338,1274,168,403,389,314,1164,110
36467,3979,2809,588,1210,783,228,781,1363,385,280,1170,132,301,390,347,1088,82
36470,84,46,5,24,0,17,7,17,13,9,38,0,9,21,8,38,0
36471,559,323,55,164,74,30,93,124,57,49,236,46,97,60,33,225,11
36473,34,27,0,5,14,8,0,27,0,0,7,7,0,0,0,7,0
36474,1217,897,124,416,296,61,344,424,95,34,320,34,85,98,103,312,8
36475,1094,751,162,322,214,53,261,299,91,100,343,32,131,93,87,337,6
36476,99,55,14,26,15,0,9,26,16,4,44,10,12,13,9,42,2
36477,1875,1353,296,576,391,90,422,635,156,140,522,55,128,168,171,500,22
36480,589,449,120,171,129,29,180,167,59,43,140,12,59,39,30,133,7
36481,175,131,13,61,35,22,24,39,46,22,44,7,9,15,13,43,1
36482,441,316,72,152,77,15,54,75,96,91,125,0,22,54,49,125,0
36483,165,130,29,54,39,8,71,54,0,5,35,8,7,13,7,35,0
36501,201,146,48,63,30,5,46,53,35,12,55,11,10,34,0,45,10
36502,6390,4529,1141,1886,1225,277,1324,1867,799,539,1861,255,667,602,337,1664,197
36505,370,309,78,141,69,21,129,131,30,19,61,5,22,19,15,59,2
36507,6943,5198,1226,2372,1322,278,1887,2152,673,486,1745,273,526,648,298,1544,201
36509,851,667,151,299,154,63,205,242,118,102,184,41,46,45,52,145,39
36511,121,115,13,58,33,11,42,58,6,9,6,0,6,0,0,6,0
36513,157,111,35,56,16,4,52,28,16,15,46,6,0,21,19,40,6
36515,125,91,17,38,25,11,36,44,11,0,34,7,5,22,0,34,0
36518,1133,848,211,361,223,53,326,376,104,42,285,51,49,100,85,274,11
36521,1688,1394,261,706,380,47,545,628,132,89,294,35,82,101,76,276,18
36522,2336,1857,482,847,429,99,765,665,254,173,479,62,112,212,93,446,33
36523,1198,912,171,380,294,67,282,511,48,71,286,25,98,120,43,246,40
36524,565,390,76,140,150,24,93,182,64,51,175,21,19,63,72,164,11
36525,832,690,184,332,163,11,281,279,89,41,142,20,46,42,34,122,20
36526,7691,5638,1089,2993,1275,281,2362,2347,484,445,2053,533,714,547,259,1783,270
36527,2770,2152,260,1180,574,138,951,992,113,96,618,112,100,121,285,548,70
36528,568,398,47,193,133,25,107,232,31,28,170,30,73,54,13,118,52
36529,232,177,37,74,58,8,80,73,9,15,55,0,7,31,17,55,0
36530,2553,1856,382,754,590,130,639,861,209,147,697,107,240,198,152,584,113
36532,9050,6406,877,3003,1841,685,2296,3155,529,426,2644,454,737,775,678,2417,227
36535,7184,5111,929,2110,1646,426,1438,2615,593,465,2073,356,568,579,570,1727,346
36538,201,152,37,69,46,0,64,57,25,6,49,7,14,21,7,49,0
36539,193,149,36,96,9,8,79,53,6,11,44,8,11,16,9,44,0
36540,164,125,12,64,49,0,41,30,18,36,39,0,6,10,23,39,0
36541,4470,3599,855,1653,929,162,1403,1635,352,209,871,129,303,321,118,764,107
36542,3551,2423,337,935,951,200,548,1512,222,141,1128,185,362,354,227,939,189
36544,3729,3022,778,1567,550,127,1186,1105,489,242,707,110,261,272,64,567,140
36545,3340,2523,653,1064,689,117,955,1007,333,228,817,83,287,241,206,775,42
36548,418,313,63,153,82,15,110,133,45,25,105,14,40,16,35,98,7
36549,2073,1520,97,322,871,230,201,1222,42,55,553,56,75,226,196,451,102
36550,129,91,18,41,24,8,14,46,11,20,38,9,6,15,8,29,9
36551,2134,1649,333,784,479,53,573,728,198,150,485,78,142,175,90,435,50
36553,1235,949,231,482,186,50,397,309,139,104,286,39,109,96,42,250,36
36556,117,93,5,31,57,0,14,64,15,0,24,0,7,17,0,24,0
36558,1525,1134,190,543,309,92,455,485,95,99,391,40,92,132,127,374,17
36559,132,92,0,41,51,0,35,57,0,0,40,0,8,14,18,40,0
36560,1579,1208,246,530,340,92,406,430,187,185,371,39,124,111,97,348,23
36561,2084,1311,214,483,481,133,259,800,147,105,773,120,231,351,71,619,154
36562,566,462,142,193,98,29,204,166,45,47,104,0,57,20,27,104,0
36564,47,35,0,12,23,0,0,27,0,8,12,0,0,5,7,12,0
36567,3831,2997,736,1418,699,144,1256,1261,345,135,834,148,299,218,169,770,64
36569,410,319,48,161,91,19,119,135,30,35,91,21,28,12,30,91,0
36570,199,126,3,82,29,12,54,46,7,19,73,20,30,11,12,64,9
36571,5219,4040,959,1681,1134,266,1364,1886,381,409,1179,264,325,354,236,1000,179
36572,2049,1724,338,792,509,85,636,730,128,230,325,29,113,94,89,307,18
36574,434,395,90,157,106,42,113,240,18,24,39,12,14,13,0,32,7
36575,5360,4362,1066,2151,1030,115,1907,1793,351,311,998,270,391,244,93,803,195
36576,1298,970,265,404,247,54,365,399,142,64,328,52,95,107,74,280,48
36577,0,0,0,0,0,0,0,0,0,0,0,0,0,0,0,0,0
36578,211,164,33,32,42,57,55,70,0,39,47,16,13,11,7,44,3
36579,727,549,98,210,201,40,142,224,85,98,178,4,70,38,66,173,5
36580,1743,1335,336,551,384,64,534,626,106,69,408,88,135,141,44,327,81
36581,26,19,12,0,7,0,0,14,5,0,7,0,0,7,0,7,0
36582,7552,5807,1342,2653,1519,293,2018,2341,841,607,1745,295,677,583,190,1461,284
36583,187,140,32,52,37,19,53,53,10,24,47,0,23,17,7,47,0
36584,366,282,68,113,79,22,89,125,22,46,84,0,32,31,21,84,0
36585,393,304,79,103,109,13,107,152,25,20,89,0,0,46,43,89,0
36587,3048,2486,676,1111,626,73,888,1051,319,228,562,64,157,211,130,464,98
36602,555,88,7,54,15,12,32,13,7,36,467,86,75,173,133,446,21
36603,4220,2765,730,1248,560,227,341,546,1078,800,1455,187,513,404,351,1321,134
36604,4735,2640,636,1285,493,226,656,860,648,476,2095,548,872,412,263,1737,358
36605,12409,8911,2419,4021,1902,569,2297,2818,2508,1288,3498,426,1123,1339,610,3085,413
36606,8159,4792,1352,2099,922,419,1273,1567,1124,828,3367,837,1118,719,693,2973,394
36607,3309,1799,367,863,370,199,459,550,362,428,1510,283,406,413,408,1358,152
36608,14562,9345,2225,4079,2245,796,3146,4014,1317,868,5217,1899,1323,1285,710,4309,908
36609,10298,6268,1965,2596,1354,353,1976,2443,1224,625,4030,1630,1225,696,479,3313,717
36610,6701,4879,1125,2163,1129,462,614,1095,1843,1327,1822,216,590,651,365,1657,165
36611,2762,1726,410,630,493,193,484,712,252,278,1036,125,216,342,353,974,62
36612,1863,1340,266,673,332,69,337,367,335,301,523,20,160,237,106,475,48
36613,4057,3236,594,1593,854,195,1141,1348,394,353,821,112,304,241,164,753,68
36617,5873,4240,760,1432,1580,468,624,1336,1016,1264,1633,71,458,696,408,1520,113
36618,5798,4449,909,2080,1164,296,1549,1843,540,517,1349,243,433,437,236,1190,159
36619,4891,3855,777,1741,1133,204,1310,1873,344,328,1036,200,387,339,110,925,111
36693,7245,5196,914,2262,1541,479,1825,2461,421,489,2049,346,550,642,511,1798,251
36695,12096,9458,1832,5564,1825,237,4365,3695,920,478,2638,921,833,609,275,2225,413
36701,10063,7139,1639,3273,1743,484,1842,2562,1677,1058,2924,313,967,951,693,2777,147
36703,5082,3568,881,1467,928,292,749,941,1029,849,1514,103,550,571,290,1437,77
36720,252,218,52,90,37,39,66,58,59,35,34,0,15,14,5,29,5
36722,240,160,39,67,47,7,44,54,56,6,80,0,29,46,5,80,0
36723,115,95,16,26,32,21,26,30,16,23,20,0,0,8,12,20,0
36726,2141,1477,280,738,381,78,403,470,361,243,664,31,180,246,207,612,52
36727,81,27,10,9,8,0,19,8,0,0,54,0,34,20,0,54,0
36728,178,122,13,60,31,18,25,30,17,50,56,0,22,26,8,56,0
36732,3482,2497,526,1133,640,198,741,888,476,392,985,178,307,263,237,910,75
36736,577,399,131,124,94,50,123,114,61,101,178,8,53,58,59,178,0
36738,307,230,44,91,87,8,82,75,24,49,77,13,23,24,17,70,7
36740,510,365,67,193,94,11,106,130,72,57,145,26,36,60,23,142,3
36742,959,727,202,333,160,32,371,200,75,81,232,22,63,95,52,215,17
36744,3012,2165,481,978,522,184,588,716,519,342,847,104,273,294,176,822,25
36748,1620,1167,238,487,370,72,318,516,191,142,453,29,124,177,123,448,5
36749,458,359,87,125,114,33,118,176,43,22,99,10,32,48,9,84,15
36750,1171,906,200,408,236,62,355,411,62,78,265,45,51,98,71,260,5
36751,288,219,37,97,56,29,57,54,57,51,69,7,33,17,12,69,0
36752,719,507,64,248,168,27,130,259,78,40,212,22,65,84,41,199,13
36754,171,134,46,84,4,0,45,36,37,16,37,0,0,15,22,37,0
36756,2103,1430,237,620,423,150,326,512,339,253,673,87,195,220,171,634,39
36758,641,474,118,247,77,32,169,177,84,44,167,15,33,95,24,154,13
36759,656,488,100,226,139,23,155,157,67,109,168,15,57,67,29,168,0
36761,535,402,51,199,115,37,80,162,76,84,133,8,38,50,37,133,0
36763,68,50,3,17,26,4,0,37,3,10,18,2,4,4,8,18,0
36765,506,376,56,208,96,16,152,71,95,58,130,11,43,55,21,128,2
36767,862,564,85,265,167,47,115,164,133,152,298,32,71,124,71,269,29
36768,244,186,37,64,50,35,25,66,69,26,58,3,3,33,19,58,0
36769,1111,799,216,329,211,43,205,253,214,127,312,29,91,119,73,292,20
36773,235,145,26,65,42,12,40,38,41,26,90,0,17,49,24,72,18
36775,447,386,27,164,127,68,71,156,51,108,61,0,16,26,19,54,7
36776,590,448,91,256,67,34,128,106,117,97,142,20,57,37,28,134,8
36779,232,177,40,50,60,27,41,102,14,20,55,4,31,12,8,55,0
36782,983,711,161,245,238,67,217,309,98,87,272,35,50,88,99,250,22
36783,446,312,49,125,108,30,69,134,62,47,134,18,28,36,52,134,0
36784,3263,2378,631,1089,514,144,818,909,406,245,885,116,211,284,274,834,51
36785,561,434,94,181,149,10,94,149,124,67,127,19,42,48,18,123,4
36786,1377,993,296,359,267,71,234,191,340,228,384,57,95,133,99,370,14
36790,81,42,5,17,13,7,10,25,7,0,39,0,9,10,20,39,0
36792,329,265,60,120,55,30,88,135,12,30,64,3,0,27,34,61,3
36793,340,266,52,100,92,22,88,142,24,12,74,12,8,43,11,74,0
36801,8182,5614,1560,2493,1313,248,1581,2156,1220,657,2568,595,786,675,512,2261,307
36804,5580,4421,1231,2061,1011,118,1662,1683,640,436,1159,288,386,377,108,948,211
36830,12033,5524,1475,2659,1102,288,2208,2138,650,528,6509,4715,777,566,451,4427,2082
36832,8537,2870,1189,1081,489,111,699,952,541,678,5667,4951,290,293,133,3085,2582
36849,0,0,0,0,0,0,0,0,0,0,0,0,0,0,0,0,0
36850,1238,863,168,384,210,101,157,306,172,228,375,8,184,112,71,364,11
36852,754,550,170,221,117,42,205,233,70,42,204,42,94,52,16,173,31
36853,3211,2267,422,918,759,168,600,1240,251,176,944,88,337,401,118,852,92
36854,5675,4088,911,1778,1047,352,1247,1778,582,481,1587,208,430,550,399,1440,147
36855,622,437,106,162,121,48,104,229,41,63,185,18,49,55,63,167,18
36856,446,381,109,174,78,20,141,164,42,34,65,6,19,36,4,65,0
36858,164,115,24,59,20,12,31,39,23,22,49,4,6,24,15,49,0
36860,897,561,77,286,172,26,112,211,139,99,336,16,77,149,94,312,24
36861,1387,1111,200,475,373,63,295,613,113,90,276,57,87,108,24,228,48
36862,2679,1924,372,845,587,120,452,774,371,327,755,66,257,212,220,704,51
36863,5526,3907,959,1638,987,323,1037,1617,650,603,1619,195,479,618,327,1506,113
36866,1416,1059,187,436,327,109,246,533,115,165,357,72,100,122,63,326,31
36867,8092,5273,1591,2238,1088,356,1614,1903,1054,702,2819,557,831,898,533,2546,273
36869,7232,5032,1262,2240,1278,252,1525,1790,926,791,2200,291,787,735,387,1905,295
36870,4087,3312,1062,1604,561,85,1518,1202,423,169,775,149,265,303,58,686,89
36871,608,453,62,248,97,46,136,205,48,64,155,22,30,59,44,139,16
36874,2479,1964,403,944,569,48,676,911,198,179,515,25,209,205,76,460,55
36875,1862,1365,236,697,383,49,505,573,138,149,497,65,217,140,75,414,83
36877,3914,3117,732,1479,783,123,1123,1284,356,354,797,207,259,236,95,652,145
36879,454,237,45,106,61,25,68,94,19,56,217,66,107,32,12,187,30
36901,160,121,31,44,41,5,39,31,18,33,39,0,5,27,7,24,15
36904,1939,1344,332,529,386,97,396,569,253,126,595,68,131,243,153,565,30
36907,908,608,129,276,159,44,127,224,145,112,300,38,100,79,83,285,15
36908,1261,935,207,388,292,48,331,486,60,58,326,41,68,89,128,310,16
36910,26,0,0,0,0,0,0,0,0,0,26,0,0,15,11,26,0
36912,919,640,112,320,148,60,167,198,142,133,279,33,133,67,46,261,18
36915,318,251,53,106,64,28,86,98,32,35,67,0,24,28,15,57,10
36916,276,201,35,58,97,11,27,88,42,44,75,3,22,32,18,75,0
36919,850,646,175,250,203,18,245,256,65,80,204,15,58,89,42,185,19
36921,277,192,14,85,86,7,50,109,25,8,85,3,47,28,7,79,6
36922,387,263,51,127,68,17,106,90,35,32,124,24,38,28,34,124,0
36925,1469,981,224,476,196,85,228,237,280,236,488,67,166,149,106,444,44
37010,1120,921,126,481,258,56,283,525,45,68,199,40,48,76,35,180,19
37012,731,554,117,260,133,44,200,257,55,42,177,23,52,58,44,148,29
37013,21643,12996,4508,6379,1945,164,4853,5120,1764,1259,8647,4408,3049,953,237,6595,2052
37014,602,501,58,250,134,59,176,282,21,22,101,16,49,7,29,94,7
37015,6081,4730,1162,2331,1022,215,1686,2152,551,341,1351,172,524,437,218,1111,240
37016,232,170,33,92,34,11,59,92,5,14,62,0,21,22,19,62,0
37018,695,475,97,215,138,25,169,204,44,58,220,27,65,95,33,200,20
37019,338,260,46,152,62,0,102,126,26,6,78,12,38,20,8,74,4
37020,1365,996,254,498,221,23,357,482,91,66,369,65,122,103,79,323,46
37022,1643,1323,287,591,387,58,470,664,108,81,320,83,113,81,43,267,53
37023,590,438,115,231,70,22,166,219,36,17,152,9,40,81,22,134,18
37025,1929,1460,400,560,427,73,486,735,170,69,469,79,212,104,74,373,96
37026,708,585,203,212,150,20,243,247,64,31,123,8,35,45,35,117,6
37027,12879,10265,880,6242,2788,355,4847,4544,490,384,2614,771,916,657,270,2215,399
37028,227,190,44,81,57,8,66,99,0,25,37,0,0,21,16,37,0
37029,1535,1291,317,613,305,56,499,633,107,52,244,40,92,72,40,213,31
37030,2842,1995,523,874,488,110,751,862,226,156,847,68,277,261,241,791,56
37031,1043,769,141,394,203,31,245,434,41,49,274,73,100,66,35,213,61
37032,1228,984,192,466,269,57,419,448,69,48,244,50,71,50,73,220,24
37033,2908,2060,463,853,614,130,667,970,244,179,848,99,197,343,209,775,73
37034,1782,1427,375,710,258,84,566,636,135,90,355,64,122,99,70,321,34
37035,1023,799,239,358,190,12,379,310,81,29,224,35,89,56,44,159,65
37036,1989,1478,367,661,353,97,558,680,134,106,511,109,125,123,154,424,87
37037,1488,1225,302,560,297,66,523,528,90,84,263,66,118,45,34,203,60
37040,11847,8035,2554,3571,1546,364,2800,3020,1359,856,3812,1153,1203,940,516,3169,643
37042,18839,14648,6375,6198,1853,222,6670,4961,2245,772,4191,1783,1385,835,188,3106,1085
37043,12224,8954,2135,4349,1997,473,3518,3986,998,452,3270,920,948,840,562,2707,563
37046,1104,912,140,490,205,77,374,413,82,43,192,8,61,75,48,166,26
37047,872,655,148,298,173,36,264,291,72,28,217,38,28,89,62,200,17
37048,1846,1501,182,830,393,96,559,778,59,105,345,32,150,62,101,301,44
37049,1014,818,159,433,198,28,268,397,102,51,196,28,88,53,27,162,34
37050,695,548,97,302,109,40,204,250,53,41,147,25,30,60,32,136,11
37051,1179,933,180,441,234,78,352,446,62,73,246,46,89,80,31,227,19
37052,893,695,153,368,145,29,304,276,51,64,198,14,50,71,63,178,20
37055,9466,6785,1656,3151,1560,418,2331,2780,1165,509,2681,544,1004,605,528,2325,356
37057,374,297,46,154,44,53,90,119,41,47,77,14,54,9,0,52,25
37058,2690,1956,372,870,550,164,648,1058,152,98,734,92,214,261,167,670,64
37059,670,486,100,239,112,35,132,252,42,60,184,23,46,57,58,181,3
37060,669,481,64,259,143,15,154,223,71,33,188,20,63,36,69,155,33
37061,1917,1373,300,585,388,100,457,603,179,134,544,88,101,209,146,501,43
37062,3338,2594,570,1309,590,125,1022,1114,282,176,744,158,317,154,115,600,144
37064,13467,10348,2018,5923,2002,405,4582,3960,933,873,3119,621,1121,885,492,2662,457
37066,13005,9649,1983,4627,2511,528,3119,4108,1363,1059,3356,571,1073,1026,686,2907,449
37067,6101,4325,1023,2522,697,83,1874,1821,384,246,1776,767,734,113,162,1428,348
37069,5482,4683,609,2970,909,195,2499,1829,207,148,799,154,303,236,106,662,137
37072,10403,7481,1595,3462,2092,332,2358,3700,778,645,2922,597,1286,602,437,2369,553
37073,4182,3409,955,1522,835,97,1447,1493,259,210,773,109,276,202,186,671,102
37074,2417,1676,358,823,395,100,580,716,210,170,741,82,224,276,159,637,104
37075,18509,14021,2630,7315,3481,595,5494,6250,1400,877,4488,1277,1362,1156,693,3819,669
37076,12511,7827,2315,3723,1527,262,2675,3128,1243,781,4684,1714,1750,753,467,3703,981
37078,262,189,79,71,39,0,76,81,26,6,73,0,43,25,5,48,25
37079,995,803,144,412,207,40,313,356,80,54,192,44,44,54,50,186,6
37080,2670,2058,388,1016,528,126,732,934,198,194,612,78,238,177,119,526,86
37082,2136,1707,310,996,345,56,695,713,155,144,429,78,188,119,44,356,73
37083,4961,3677,1006,1511,941,219,1298,1717,387,275,1284,140,389,484,271,1147,137
37085,1016,823,162,457,169,35,350,345,51,77,193,36,32,75,50,181,12
37086,6617,5294,1751,2679,713,151,2273,1843,770,408,1323,336,594,334,59,988,335
37087,12253,8858,2088,4147,2172,451,2893,3914,1189,862,3395,738,1006,891,760,2909,486
37090,4436,3530,739,1726,940,125,1304,1634,332,260,906,129,380,277,120,732,174
37091,7458,5330,1211,2513,1226,380,1765,2318,665,582,2128,460,700,494,474,1861,267
37095,810,603,128,278,141,56,230,240,59,74,207,26,81,78,22,188,19
37096,2242,1615,314,681,528,92,582,771,119,143,627,71,138,248,170,551,76
37097,780,573,131,248,153,41,192,279,66,36,207,23,65,77,42,190,17
37098,1701,1307,332,610,283,82,613,451,113,130,394,58,133,126,77,342,52
37101,2328,1742,377,783,467,115,642,821,163,116,586,101,190,170,125,525,61
37110,12616,8901,2178,3935,2145,643,2750,4097,1200,854,3715,539,1165,1224,787,3264,451
37115,15595,8751,2526,3628,2050,547,2324,3477,1700,1250,6844,1709,2303,1605,1227,5593,1251
37118,323,279,34,162,78,5,121,133,9,16,44,0,15,8,21,29,15
37122,11486,9664,1783,5546,2089,246,4146,4307,774,437,1822,333,748,485,256,1535,287
37127,4145,3200,752,1799,553,96,1436,1188,313,263,945,266,363,208,108,708,237
37128,6512,5050,1441,2709,781,119,2385,1908,479,278,1462,624,529,239,70,1121,341
37129,13786,10530,2513,5497,2135,385,4428,4325,1017,760,3256,934,1142,737,443,2579,677
37130,17033,9357,3126,3780,1944,507,3059,3704,1561,1033,7676,4114,1664,1044,854,5157,2519
37134,1203,909,179,431,254,45,293,455,95,66,294,43,112,92,47,260,34
37135,1419,1243,183,762,272,26,642,495,60,46,176,14,70,64,28,149,27
37137,768,606,160,252,179,15,233,271,20,82,162,9,52,65,36,126,36
37138,8646,6409,1251,3330,1543,285,2529,2844,529,507,2237,464,803,596,374,1914,323
37140,88,35,0,14,21,0,7,20,0,8,53,0,19,34,0,33,20
37141,333,262,33,116,87,26,78,126,11,47,71,9,22,19,21,65,6
37142,551,437,73,197,147,20,132,223,39,43,114,11,40,51,12,89,25
37143,1489,1222,246,624,320,32,468,577,84,93,267,46,101,82,38,229,38
37144,1321,999,185,465,293,56,317,520,73,89,322,30,89,103,100,296,26
37145,695,537,101,198,172,66,206,280,6,45,158,33,27,48,50,153,5
37146,1477,1238,301,746,162,29,580,493,76,89,239,72,79,56,32,200,39
37147,266,174,30,85,49,10,91,72,6,5,92,11,18,31,32,92,0
37148,6390,4884,1265,2191,1171,257,1784,2172,605,323,1506,294,470,336,406,1262,244
37149,746,578,181,239,141,17,269,180,61,68,168,27,43,64,34,149,19
37150,1841,1321,277,635,331,78,526,553,103,139,520,50,75,264,131,462,58
37151,210,151,44,77,25,5,60,65,11,15,59,14,12,12,21,53,6
37152,9,9,5,4,0,0,8,1,0,0,0,0,0,0,0,0,0
37153,1593,1347,354,716,245,32,620,523,151,53,246,39,123,49,35,215,31
37160,10028,7368,2020,3013,1807,528,2502,3151,964,751,2660,442,809,804,605,2254,406
37166,4889,3483,836,1488,940,219,1129,1663,389,302,1406,236,341,567,262,1259,147
37167,12619,9622,2884,4793,1749,196,3896,3627,1346,753,2997,852,1324,621,200,2361,636
37171,359,291,50,112,129,0,92,167,10,22,68,8,22,29,9,68,0
37172,9237,6934,1485,3351,1707,391,2251,3227,847,609,2303,419,763,633,488,1954,349
37174,2719,2290,578,1296,363,53,1041,978,214,57,429,117,159,91,62,376,53
37175,476,310,51,113,114,32,86,175,40,9,166,10,30,73,53,154,12
37178,693,544,100,267,144,33,194,255,54,41,149,16,45,62,26,123,26
37179,2241,1962,537,1076,299,50,1000,760,135,67,279,68,111,71,29,247,32
37180,842,705,188,303,169,45,224,321,117,43,137,41,21,42,33,110,27
37181,626,462,109,187,142,24,171,219,38,34,164,14,50,64,36,143,21
37183,1017,765,177,360,205,23,280,393,56,36,252,37,53,88,74,222,30
37184,2117,1612,356,735,418,103,610,733,168,101,505,106,181,101,117,447,58
37185,3484,2396,406,1060,764,166,654,1282,284,176,1088,159,197,451,281,988,100
37186,3273,2519,619,1163,621,116,990,1087,235,207,754,119,229,260,146,641,113
37187,2156,1632,402,762,391,77,637,711,163,121,524,79,129,228,88,468,56
37188,3596,2936,842,1573,454,67,1428,1090,339,79,660,98,297,152,113,538,122
37189,858,654,124,323,184,23,168,310,130,46,204,26,87,61,30,155,49
37190,3235,2331,531,1011,616,173,735,1126,245,225,904,130,224,348,202,828,76
37191,1374,1108,319,560,191,38,490,474,93,51,266,69,84,65,48,212,54
37201,224,26,6,20,0,0,0,6,0,20,198,120,43,28,7,148,50
37203,5151,2124,804,840,340,140,198,525,940,461,3027,1074,871,736,346,2584,443
37204,5099,2580,510,1130,621,319,652,1110,312,506,2519,692,888,555,384,2120,399
37205,10189,5529,827,2455,1581,666,1895,2937,278,419,4660,1508,1227,868,1057,3849,811
37206,10927,6684,1955,2961,1346,422,1370,2135,1888,1291,4243,807,1972,950,514,3329,914
37207,13236,9597,2593,4360,2152,492,2141,2678,3046,1732,3639,624,1555,959,501,3024,615
37208,6021,3448,996,1274,855,323,321,708,1346,1073,2573,500,978,759,336,2159,414
37209,13310,7466,2226,3087,1574,579,1953,2929,1458,1126,5844,1995,2043,1197,609,4650,1194
37210,6739,3731,1228,1663,654,186,908,1201,1092,530,3008,750,993,614,651,2584,424
37211,27547,15305,4912,6918,2836,639,5048,5896,2526,1835,12242,4511,4450,2065,1216,9885,2357
37212,7231,2545,676,1296,460,113,786,982,346,431,4686,2502,1329,467,388,3535,1151
37213,0,0,0,0,0,0,0,0,0,0,0,0,0,0,0,0,0
37214,11852,6798,1718,3101,1592,387,1978,3121,868,831,5054,1503,1958,946,647,4030,1024
37215,9905,5449,703,2668,1585,493,1913,2841,305,390,4456,1415,1218,896,927,3711,745
37216,7811,5059,1092,2412,1165,390,1259,2062,996,742,2752,491,1053,671,537,2229,523
37217,12219,6636,2131,3020,1255,230,2070,2517,1017,1032,5583,2344,1967,990,282,4248,1335
37218,5120,3734,598,1765,1170,201,856,1502,653,723,1386,130,479,552,225,1209,177
37219,470,64,47,17,0,0,11,53,0,0,406,201,158,35,12,335,71
37220,2500,1922,184,966,538,234,729,1040,80,73,578,70,203,194,111,490,88
37221,15161,9664,2247,4827,2063,527,3662,4498,857,647,5497,2031,2009,1118,339,4446,1051
37228,208,0,0,0,0,0,0,0,0,0,208,0,0,81,127,208,0
37301,589,465,109,210,126,20,212,188,26,39,124,17,52,39,16,110,14
37302,990,748,135,323,200,90,230,408,41,69,242,56,73,53,60,195,47
37303,9631,6711,1664,2925,1674,448,2378,3060,741,532,2920,496,866,954,604,2637,283
37305,280,209,57,78,56,18,79,99,19,12,71,6,8,46,11,63,8
37306,895,724,177,316,193,38,250,346,65,63,171,8,77,42,44,161,10
37307,1979,1474,304,656,438,76,507,717,114,136,505,94,153,200,58,459,46
37308,858,727,184,372,138,33,358,316,36,17,131,6,51,59,15,110,21
37309,770,620,101,269,199,51,198,331,45,46,150,30,33,55,32,126,24
37310,1325,995,146,506,292,51,300,563,38,94,330,50,99,92,89,273,57
37311,10199,6180,1785,2530,1557,308,1821,2484,1109,766,4019,1058,1124,1110,727,3374,645
37312,10692,8110,1605,3790,2275,440,2941,3840,676,653,2582,702,731,742,407,2149,433
37313,530,398,107,177,88,26,138,141,46,73,132,20,25,65,22,122,10
37316,57,52,6,18,23,5,15,23,0,14,5,0,0,0,5,5,0
37317,1078,764,159,289,249,67,219,399,56,90,314,26,72,133,83,283,31
37318,771,569,136,255,118,60,206,222,99,42,202,8,63,77,54,198,4
37321,6160,4486,1059,2074,1139,214,1465,2087,596,338,1674,281,504,528,361,1487,187
37322,3073,2291,538,1047,595,111,801,1175,188,127,782,106,259,306,111,647,135
37323,9830,7822,2073,3468,2013,268,2816,3734,667,605,2008,364,777,586,281,1747,261
37324,2079,1478,336,633,406,103,413,663,193,209,601,106,138,220,137,520,81
37325,667,532,177,184,101,70,194,242,5,91,135,14,24,43,54,135,0
37326,239,141,19,45,61,16,30,86,5,20,98,9,10,50,29,93,5
37327,3508,2668,708,1124,732,104,888,1251,345,184,840,178,239,244,179,784,56
37328,546,407,90,159,127,31,126,212,41,28,139,23,29,62,25,139,0
37329,2080,1616,333,637,530,116,511,822,174,109,464,64,133,134,133,436,28
37330,2517,1993,400,907,581,105,660,1026,183,124,524,76,166,171,111,440,84
37331,3342,2337,479,1037,615,206,630,1188,260,259,1005,87,290,400,228,891,114
37332,897,712,160,311,206,35,239,375,57,41,185,16,27,64,78,168,17
37333,259,208,44,84,75,5,71,98,20,19,51,11,7,21,12,43,8
37334,8081,5744,1092,2442,1777,433,1729,2689,674,652,2337,303,603,730,701,2113,224
37335,1068,862,227,403,188,44,338,368,95,61,206,12,52,80,62,194,12
37336,1278,1012,263,482,214,53,380,520,65,47,266,42,145,58,21,234,32
37337,595,392,91,181,108,12,178,168,35,11,203,25,73,58,47,176,27
37338,1000,745,169,409,130,37,199,342,109,95,255,46,77,98,34,222,33
37339,776,610,169,243,144,54,200,284,75,51,166,10,51,63,42,156,10
37340,325,236,65,112,36,23,52,122,23,39,89,10,18,52,9,89,0
37341,4207,3568,693,1939,811,125,1505,1675,199,189,639,107,201,205,126,544,95
37342,1123,907,196,378,292,41,313,482,45,67,216,7,78,66,65,193,23
37343,14202,11011,1935,5576,2968,532,4056,5165,889,901,3191,696,1011,986,498,2730,461
37345,852,609,116,269,167,57,207,282,53,67,243,38,29,68,108,224,19
37347,3047,2232,374,1152,610,96,747,1148,194,143,815,109,282,270,154,742,73
37348,356,278,33,144,88,13,111,135,5,27,78,42,22,0,14,59,19
37350,825,606,66,293,180,67,261,304,26,15,219,20,48,78,73,199,20
37351,110,77,0,49,28,0,9,38,30,0,33,11,10,0,12,23,10
37352,1153,847,199,306,287,55,259,396,95,97,306,26,80,82,118,287,19
37353,1520,1090,240,494,284,72,353,610,86,41,430,83,195,120,32,383,47
37354,5515,4016,1096,1593,1024,303,1316,1912,489,299,1499,341,435,485,238,1341,158
37355,8627,6396,1442,2878,1664,412,2144,3022,762,468,2231,381,703,765,382,1946,285
37356,982,690,140,293,191,66,187,315,126,62,292,19,118,90,65,277,15
37357,1919,1414,349,680,303,82,558,620,123,113,505,89,154,168,94,447,58
37359,230,171,43,67,45,16,75,87,0,9,59,0,6,22,31,53,6
37360,674,511,97,233,158,23,196,241,24,50,163,24,52,49,38,136,27
37361,541,426,126,182,95,23,171,210,17,28,115,26,29,56,4,103,12
37362,1122,878,209,399,229,41,338,380,72,88,244,42,82,88,32,222,22
37363,8439,6891,1264,3608,1653,366,2617,3230,559,485,1548,323,476,442,307,1332,216
37365,613,438,87,168,142,41,129,218,37,54,175,11,68,53,43,165,10
37366,344,250,56,96,78,20,65,144,24,17,94,11,32,42,9,94,0
37367,3499,2621,553,1151,764,153,882,1289,231,219,878,129,292,302,155,797,81
37369,363,289,53,105,114,17,93,171,8,17,74,0,45,29,0,50,24
37370,1532,1229,262,637,304,26,426,610,140,53,303,40,110,78,75,281,22
37373,1051,774,210,336,172,56,263,376,72,63,277,33,127,68,49,255,22
37374,672,514,126,299,89,0,164,260,72,18,158,35,16,82,25,150,8
37375,1029,714,89,301,238,86,234,376,25,79,315,73,84,95,63,271,44
37376,232,150,39,46,53,12,35,94,0,21,82,6,33,38,5,75,7
37377,5605,4248,537,2220,1165,326,1692,2046,302,208,1357,93,347,394,523,1219,138
37379,8872,7059,1532,3319,1903,305,2466,3597,555,441,1813,239,629,569,376,1552,261
37380,2479,1756,449,759,458,90,545,726,264,221,723,57,211,278,177,671,52
37381,3299,2328,417,973,763,175,612,1303,224,189,971,125,312,319,215,821,150
37385,3032,2224,502,958,600,164,833,1096,169,126,808,104,263,326,115,718,90
37387,1598,1145,254,509,310,72,407,475,131,132,453,65,97,184,107,395,58
37388,9499,6833,1457,2906,1958,512,2307,3166,848,512,2666,458,880,716,612,2370,296
37391,577,405,59,183,130,33,132,229,19,25,172,13,48,65,46,159,13
37394,18,17,6,3,8,0,8,6,0,3,1,1,0,0,0,0,1
37396,115,103,16,43,32,12,34,49,8,12,12,0,0,12,0,12,0
37397,3883,2902,688,1273,816,125,1009,1304,303,286,981,100,332,296,253,885,96
37398,5582,4172,783,1800,1318,271,1276,2118,435,343,1410,224,378,406,402,1284,126
37402,2434,594,290,211,75,18,58,114,305,117,1840,317,466,672,385,1782,58
37403,1237,403,53,178,117,55,51,141,69,142,834,356,236,144,98,657,177
37404,5012,3133,706,1454,747,226,678,1000,696,759,1879,230,739,527,383,1647,232
37405,6272,3092,775,1394,697,226,699,1509,451,433,3180,1306,898,533,443,2462,718
37406,5703,4112,1165,1660,1029,258,576,1271,1325,940,1591,214,604,554,219,1335,256
37407,3212,2049,559,856,488,146,505,695,462,387,1163,148,354,389,272,998,165
37408,775,425,205,144,59,17,33,44,250,98,350,29,97,157,67,323,27
37409,1097,681,110,309,192,70,248,240,59,134,416,87,131,117,81,341,75
37410,1750,1171,423,396,258,94,124,215,489,343,579,61,216,227,75,520,59
37411,7439,4680,1022,2225,1019,414,1044,1800,958,878,2759,564,1004,701,490,2357,402
37412,9285,5693,1231,2437,1445,580,1582,2713,665,733,3592,800,1068,1047,677,3070,522
37415,11140,6322,1555,2453,1672,642,1748,3174,775,625,4818,1307,1475,1196,840,4206,612
37416,6074,4241,915,1795,1286,245,1245,1866,562,568,1833,387,591,535,320,1657,176
37419,2290,1643,212,752,568,111,427,890,121,205,647,120,172,241,114,580,67
37421,16610,11120,2024,5461,2894,741,3624,5522,1020,954,5490,1651,1774,1248,817,4731,759
37601,14502,9164,2374,3747,2338,705,2630,4190,1410,934,5338,1478,1728,1166,966,4534,804
37604,14075,8176,1735,3568,2213,660,2512,3894,853,917,5899,1934,1583,1418,964,4796,1103
37614,57,57,43,9,5,0,9,43,5,0,0,0,0,0,0,0,0
37615,6631,4860,1227,2272,1150,211,1750,2320,479,311,1771,486,699,429,157,1432,339
37616,1805,1356,365,506,404,81,359,737,109,151,449,55,162,173,59,410,39
37617,5026,3847,686,1886,1035,240,1202,2118,240,287,1179,202,302,436,239,1105,74
37618,4850,3627,820,1728,893,186,1333,1726,319,249,1223,224,376,359,264,1078,145
37620,16409,11241,2303,4710,3393,835,3481,5590,1089,1081,5168,913,1530,1613,1112,4639,529
37640,1536,1094,264,432,330,68,307,640,56,91,442,68,119,144,111,376,66
37641,2796,2105,530,936,534,105,744,981,168,212,691,94,209,266,122,633,58
37642,5646,4175,1082,1753,1202,138,1412,2107,423,233,1471,313,564,325,269,1278,193
37643,13997,9844,2085,4297,2749,713,2857,4692,1168,1127,4153,559,1026,1555,1013,3719,434
37645,1976,1565,395,662,429,79,560,795,110,100,411,45,104,160,102,396,15
37650,5421,3682,715,1502,1092,373,1075,1858,357,392,1739,237,443,619,440,1599,140
37656,1473,1107,180,578,258,91,381,619,55,52,366,32,96,152,86,317,49
37657,370,280,64,97,104,15,63,165,39,13,90,12,0,48,30,85,5
37658,1855,1359,337,574,374,74,395,714,115,135,496,45,163,175,113,460,36
37659,8744,6681,1371,3144,1862,304,2213,3470,543,455,2063,314,647,675,427,1833,230
37660,17475,11759,2483,5003,3314,959,3399,5653,1554,1153,5716,941,1608,1800,1367,5243,473
37663,5616,4393,690,2055,1355,293,1509,2427,259,198,1223,257,346,368,252,1101,122
37664,11016,7769,1335,3557,2196,681,2427,3903,759,680,3247,413,811,1208,815,2974,273
37665,1945,1314,274,492,387,161,307,625,172,210,631,75,159,235,162,543,88
37680,230,183,35,75,54,19,46,113,17,7,47,0,5,13,29,32,15
37681,2294,1690,363,745,454,128,493,901,180,116,604,102,211,183,108,490,114
37683,4695,3221,716,1304,937,264,893,1587,342,399,1474,125,450,557,342,1316,158
37684,7,7,0,0,7,0,0,7,0,0,0,0,0,0,0,0,0
37686,2644,2061,346,953,625,137,707,1090,126,138,583,109,183,212,79,470,113
37687,2073,1515,339,648,427,101,545,686,150,134,558,104,118,159,177,512,46
37688,495,347,16,101,167,63,63,224,19,41,148,10,32,72,34,131,17
37690,1152,927,227,478,193,29,352,447,72,56,225,60,78,46,41,201,24
37691,367,301,62,149,90,0,107,149,27,18,66,10,18,38,0,57,9
37692,1832,1357,236,668,385,68,427,742,84,104,475,71,169,97,138,424,51
37694,575,444,93,198,120,33,148,222,26,48,131,17,56,35,23,115,16
37701,2743,1796,340,687,559,210,441,935,227,193,947,148,253,243,303,835,112
37705,1522,1188,272,521,331,64,407,640,53,88,334,39,113,130,52,314,20
37708,2606,1958,487,844,545,82,659,955,207,137,648,138,183,225,102,558,90
37709,1288,965,252,452,213,48,385,443,70,67,323,31,130,123,39,292,31
37710,555,442,70,246,126,0,164,172,44,62,113,12,27,51,23,105,8
37711,1773,1293,274,656,290,73,475,606,119,93,480,56,178,160,86,426,54
37713,578,435,86,186,130,33,121,242,42,30,143,0,18,81,44,137,6
37714,1716,1249,300,520,331,98,364,643,106,136,467,89,136,171,71,389,78
37715,410,331,109,135,58,29,134,111,28,58,79,6,20,29,24,79,0
37716,10061,7122,1472,3289,1978,383,2297,3420,826,579,2939,544,881,794,720,2558,381
37719,41,26,11,15,0,0,21,0,0,5,15,10,5,0,0,15,0
37721,3845,3046,655,1462,802,127,1105,1509,246,186,799,148,230,243,178,694,105
37722,2017,1472,338,620,419,95,412,703,219,138,545,65,210,195,75,430,115
37723,302,228,43,99,63,23,90,112,6,20,74,12,13,41,8,60,14
37724,1225,948,173,445,272,58,306,468,68,106,277,34,78,88,77,258,19
37725,4970,3770,792,1617,1097,264,1185,1992,333,260,1200,162,401,475,162,1088,112
37726,659,467,53,221,136,57,128,237,49,53,192,50,44,77,21,170,22
37727,886,659,136,323,181,19,170,328,94,67,227,14,80,95,38,212,15
37729,632,484,124,221,125,14,187,183,44,70,148,11,47,46,44,148,0
37730,9,9,0,5,0,4,5,0,0,4,0,0,0,0,0,0,0
37731,396,261,38,120,88,15,91,136,23,11,135,11,24,76,24,130,5
37732,85,53,22,17,14,0,13,39,0,1,32,9,5,18,0,23,9
37737,1847,1438,297,615,450,76,528,731,108,71,409,55,138,150,66,328,81
37738,2360,1566,200,697,536,133,403,923,99,141,794,155,248,183,208,652,142
37742,1697,1373,250,695,363,65,474,676,117,106,324,43,111,99,71,274,50
37743,9802,6926,1299,3044,2191,392,1980,3698,728,520,2876,454,826,1027,569,2519,357
37744,0,0,0,0,0,0,0,0,0,0,0,0,0,0,0,0,0
37745,7153,4766,970,2119,1300,377,1550,2215,508,493,2387,497,629,777,484,2142,245
37748,7412,5158,1027,2164,1543,424,1475,2549,537,597,2254,246,727,800,481,1998,256
37752,1967,1476,342,695,358,81,491,687,150,148,491,96,130,145,120,432,59
37753,386,230,53,128,46,3,73,82,31,44,156,9,59,46,42,114,42
37754,1739,1348,304,617,392,35,454,630,175,89,391,88,156,90,57,331,60
37755,1294,992,304,398,245,45,465,368,113,46,302,67,113,83,39,268,34
37756,1066,773,180,376,172,45,287,348,78,60,293,33,90,109,61,278,15
37757,3525,2641,639,1160,722,120,951,1264,218,208,884,188,219,296,181,802,82
37760,4661,3222,761,1334,930,197,961,1559,395,307,1439,458,348,360,273,1208,231
37762,1390,964,206,433,248,77,280,424,127,133,426,23,101,190,112,399,27
37763,6175,4465,841,1994,1235,395,1329,2465,357,314,1710,297,509,528,376,1517,193
37764,3149,2429,584,1027,685,133,794,1149,291,195,720,166,309,179,66,554,166
37765,216,142,33,39,53,17,62,52,18,10,74,15,23,30,6,65,9
37766,7439,5265,1210,1990,1585,480,1533,2474,556,702,2174,256,602,824,492,1972,202
37769,2545,1771,324,774,539,134,561,781,198,231,774,81,174,350,169,728,46
37770,1021,768,180,317,203,68,256,350,94,68,253,37,73,102,41,215,38
37771,5144,3621,973,1580,822,246,1186,1581,497,357,1523,274,442,415,392,1392,131
37772,3600,2735,440,1304,810,181,908,1447,148,232,865,75,325,319,146,763,102
37774,6083,4651,655,1807,1910,279,1247,2741,279,384,1432,106,377,565,384,1237,195
37777,4891,3035,730,1436,705,164,970,1414,362,289,1856,702,650,320,184,1485,371
37779,1256,976,238,461,247,30,312,489,101,74,280,16,115,71,78,260,20
37801,8092,5688,1318,2494,1545,331,1848,2486,703,651,2404,441,661,758,544,2122,282
37803,10729,8277,1456,4061,2210,550,3069,4131,526,551,2452,371,706,721,654,2218,234
37804,8554,6137,1442,2624,1562,509,2034,2927,580,596,2417,401,768,788,460,2176,241
37806,1081,780,171,333,248,28,289,367,40,84,301,100,78,88,35,233,68
37807,3571,2747,686,1295,603,163,1090,1080,284,293,824,151,298,278,97,750,74
37809,765,648,122,245,261,20,194,315,66,73,117,24,19,28,46,107,10
37810,731,509,154,237,102,16,199,243,51,16,222,41,64,83,34,196,26
37811,1131,879,215,397,256,11,278,492,91,18,252,28,63,108,53,232,20
37813,6669,4708,1122,2099,1279,208,1511,2097,597,503,1961,284,645,644,388,1704,257
37814,12288,8560,2061,3693,2399,407,2717,4023,973,847,3728,863,1053,1194,618,3218,510
37818,1832,1316,316,584,336,80,466,647,106,97,516,71,200,198,47,463,53
37819,310,233,36,99,67,31,62,118,32,21,77,19,10,33,15,63,14
37820,2572,1971,471,859,542,99,673,987,180,131,601,92,199,204,106,508,93
37821,9020,6342,1598,2618,1867,259,1899,2912,748,783,2678,361,946,866,505,2412,266
37825,3141,2181,514,908,647,112,778,1002,185,216,960,188,266,366,140,827,133
37826,1433,1114,247,470,339,58,382,579,100,53,319,52,79,100,88,270,49
37828,609,433,47,219,117,50,162,229,22,20,176,9,42,53,72,161,15
37829,598,468,109,219,132,8,178,226,28,36,130,7,43,52,28,130,0
37830,11991,7649,1262,3393,2167,827,2287,3624,1059,679,4342,607,1308,1106,1321,3951,391
37840,4215,3256,734,1395,942,185,1128,1532,337,259,959,150,286,338,185,849,110
37841,3513,2509,685,1079,624,121,884,1082,328,215,1004,74,305,366,259,935,69
37843,1203,909,180,428,260,41,301,431,113,64,294,30,96,108,60,272,22
37845,263,193,24,69,73,27,45,90,14,44,70,8,16,28,18,61,9
37846,1593,1262,272,638,281,71,541,537,93,91,331,50,96,123,62,290,41
37847,1052,769,265,301,180,23,273,364,59,73,283,22,51,125,85,253,30
37848,128,78,5,39,28,6,0,72,0,6,50,7,13,18,12,50,0
37849,8435,6269,1253,3161,1515,340,2445,2845,493,486,2166,323,699,774,370,1893,273
37852,1008,759,128,380,189,62,251,282,116,110,249,30,92,85,42,224,25
37853,1452,1108,182,567,320,39,356,594,71,87,344,90,110,104,40,290,54
37854,4854,3465,688,1454,1035,288,1038,1663,365,399,1389,156,354,577,302,1270,119
37857,8315,5933,1318,2470,1715,430,1949,2793,562,629,2382,370,775,740,497,2200,182
37860,1280,1045,243,502,262,38,334,535,133,43,235,40,103,59,33,202,33
37861,2842,2094,486,890,612,106,655,1068,170,201,748,116,192,304,136,672,76
37862,7391,5038,947,2292,1492,307,1543,2456,638,401,2353,554,751,664,384,1957,396
37863,2122,1528,444,619,388,77,518,667,199,144,594,98,184,199,113,472,122
37865,6559,5188,888,2639,1419,242,1805,2576,444,363,1371,275,447,384,265,1189,182
37866,673,543,71,255,191,26,131,346,43,23,130,8,34,39,49,130,0
37869,1965,1373,269,654,336,114,467,575,162,169,592,53,136,249,154,549,43
37870,1813,1387,243,588,433,123,440,679,97,171,426,40,122,197,67,379,47
37871,3235,2520,606,1154,612,148,895,1215,217,193,715,92,234,258,131,576,139
37872,768,595,135,296,155,9,195,291,59,50,173,23,35,91,24,148,25
37873,1737,1282,270,533,388,91,389,704,86,103,455,66,160,151,78,399,56
37874,5124,3655,815,1577,1020,243,1069,1864,400,322,1469,224,467,513,265,1266,203
37876,7800,5884,1181,2747,1711,245,1988,2988,470,438,1916,422,709,602,183,1645,271
37877,3168,2489,492,1158,702,137,870,1234,183,202,679,112,206,254,107,592,87
37878,230,145,39,40,35,31,31,72,19,23,85,10,40,35,0,65,20
37879,3983,2953,759,1247,749,198,1017,1346,355,235,1030,133,308,404,185,932,98
37880,1168,967,181,382,349,55,369,477,58,63,201,20,40,73,68,201,0
37881,814,599,154,228,200,17,217,314,25,43,215,46,76,73,20,188,27
37882,1033,711,83,309,248,71,240,397,43,31,322,19,101,146,56,299,23
37885,1595,1238,305,437,415,81,400,617,111,110,357,54,141,85,77,287,70
37886,1498,1156,219,552,316,69,372,620,65,99,342,50,129,119,44,255,87
37887,1971,1476,338,701,329,108,570,627,179,100,495,63,166,144,122,454,41
37888,1044,834,212,375,205,42,339,373,63,59,210,15,31,104,60,199,11
37890,2271,1702,350,719,520,113,513,878,189,122,569,102,171,189,107,506,63
37891,1296,919,218,403,262,36,291,476,87,65,377,47,82,157,91,302,75
37892,730,537,175,226,107,29,222,204,58,53,193,43,55,59,36,174,19
37902,706,77,16,25,29,7,0,59,7,11,629,215,150,141,123,555,74
37909,6092,2895,908,1136,600,251,790,1367,421,317,3197,1926,581,417,273,2346,851
37912,8751,4841,1367,2007,1117,350,1274,2237,777,553,3910,1390,1157,893,470,3190,720
37914,8291,5494,967,2318,1691,518,1399,2343,819,933,2797,350,937,854,656,2455,342
37915,2585,1285,539,444,234,68,82,259,674,270,1300,294,617,251,138,1206,94
37916,2781,314,200,87,16,11,60,148,42,64,2467,2110,236,93,28,1567,900
37917,11645,5832,1440,2365,1437,590,1462,2341,1007,1022,5813,1460,1724,1492,1137,4957,856
37918,14908,10222,2401,4596,2544,681,3296,4825,1203,898,4686,862,1645,1259,920,4083,603
37919,13163,6813,1497,3170,1621,525,2301,3141,711,660,6350,2567,1495,1259,1029,5313,1037
37920,16060,9972,2297,4313,2552,810,2894,4748,1226,1104,6088,1980,1554,1550,1004,4755,1333
37921,10671,7313,2159,3259,1391,504,2163,2728,1465,957,3358,913,1172,773,500,2754,604
37922,16489,13310,1742,7958,3122,488,6105,6010,796,399,3179,693,1252,830,404,2635,544
37923,11447,6883,1641,3326,1608,308,2303,3204,802,574,4564,1833,1645,828,258,3613,951
37924,3912,2675,568,1149,801,157,773,1404,221,277,1237,237,404,379,217,1049,188
37931,7315,5295,1217,2659,1156,263,1957,2429,486,423,2020,658,740,450,172,1690,330
37932,4216,3176,552,1827,725,72,1376,1429,195,176,1040,240,431,253,116,834,206
37938,5106,4272,666,2195,1171,240,1550,2205,315,202,834,118,281,218,217,753,81
38001,1735,1204,289,464,341,110,387,548,124,145,531,83,142,188,118,501,30
38002,6309,4978,1129,2648,986,215,2062,2190,361,365,1331,301,500,430,100,1106,225
38004,4127,3415,724,1868,716,107,1396,1396,341,282,712,166,249,199,98,599,113
38006,1924,1398,341,542,366,149,470,604,145,179,526,87,180,120,139,469,57
38008,3939,2811,574,1361,723,153,776,984,561,490,1128,145,306,422,255,1019,109
38011,3063,2547,555,1223,634,135,945,1173,249,180,516,76,143,201,96,444,72
38012,5729,4086,1081,1793,966,246,1172,1485,786,643,1643,186,500,519,438,1479,164
38015,1067,824,154,430,207,33,297,391,76,60,243,25,88,78,52,220,23
38017,11853,10229,1271,6731,1931,296,5237,3796,773,423,1624,321,615,479,209,1388,236
38018,21248,14708,3884,7914,2542,368,6537,6179,1302,690,6540,2553,2275,1160,552,5423,1117
38019,5774,4189,986,1933,1064,206,1241,1612,804,532,1585,192,504,523,366,1403,182
38021,28,17,0,11,6,0,0,11,6,0,11,5,0,0,6,11,0
38023,838,684,124,348,192,20,273,267,86,58,154,6,62,57,29,132,22
38024,11134,7786,1922,3504,1848,512,2501,3268,1238,779,3348,593,1067,958,730,2975,373
38028,1666,1424,103,806,461,54,500,766,45,113,242,9,96,87,50,192,50
38030,63,63,6,8,43,6,13,50,0,0,0,0,0,0,0,0,0
38034,1357,1045,176,450,323,96,325,489,103,128,312,31,112,88,81,298,14
38036,117,61,22,25,10,4,2,16,36,7,56,6,28,18,4,53,3
38037,644,475,110,227,122,16,125,153,117,80,169,9,68,63,29,161,8
38039,703,573,138,235,155,45,179,153,120,121,130,13,37,54,26,115,15
38040,2156,1613,322,736,438,117,500,773,181,159,543,79,136,174,154,496,47
38041,1008,699,179,262,189,69,215,271,102,111,309,41,104,119,45,279,30
38042,363,270,45,141,71,13,70,116,50,34,93,8,42,18,25,92,1
38044,360,224,42,85,90,7,66,128,15,15,136,16,32,81,7,126,10
38046,47,40,3,14,18,5,10,28,2,0,7,0,2,3,2,7,0
38047,28,10,0,10,0,0,0,10,0,0,18,0,8,10,0,18,0
38049,1515,1141,234,507,308,92,317,430,221,173,374,65,111,93,105,313,61
38050,198,101,17,49,26,9,40,41,6,14,97,11,25,35,26,93,4
38052,1441,1039,241,423,320,55,366,478,106,89,402,56,122,142,82,370,32
38053,9836,7765,1637,3835,1912,381,2912,3428,830,595,2071,270,792,676,333,1726,345
38057,1279,984,156,517,267,44,359,395,108,122,295,25,85,102,83,260,35
38058,1385,1151,318,564,243,26,526,374,188,63,234,9,108,81,36,221,13
38059,2592,1940,441,859,476,164,679,872,218,171,652,96,231,192,133,575,77
38060,1487,1195,207,587,368,33,395,579,115,106,292,57,120,70,45,255,37
38061,420,308,40,162,95,11,93,156,18,41,112,16,27,18,51,91,21
38063,6476,4682,1249,2002,1131,300,1536,1862,787,497,1794,291,476,500,527,1640,154
38066,813,565,100,259,152,54,156,274,49,86,248,19,115,56,58,201,47
38067,544,361,36,134,138,53,96,212,24,29,183,25,53,70,35,159,24
38068,3601,2707,523,1246,696,242,823,1167,333,384,894,68,289,322,215,840,54
38069,994,722,164,325,192,41,175,275,150,122,272,36,86,85,65,256,16
38075,1221,890,201,457,159,73,291,298,133,168,331,57,114,86,74,294,37
38076,171,118,11,54,49,4,66,44,1,7,53,8,8,11,26,46,7
38079,1532,1002,205,456,275,66,281,445,158,118,530,59,129,169,173,495,35
38080,1088,781,198,300,226,57,263,332,98,88,307,42,76,122,67,279,28
38103,3635,983,371,382,220,10,163,663,85,72,2652,1196,998,403,55,2258,394
38104,13216,4831,1467,2356,770,238,1136,1792,1090,813,8385,3009,2823,1491,1062,6897,1488
38105,3750,1662,627,618,287,130,136,228,853,445,2088,603,777,471,237,1829,259
38106,12421,8185,1740,2945,2624,876,805,1832,2633,2915,4236,521,1280,1578,857,3678,558
38107,8184,5210,1255,2278,1370,307,725,1156,1694,1635,2974,652,1046,849,427,2425,549
38108,8471,5554,1392,1997,1566,599,886,1441,1564,1663,2917,412,1013,923,569,2509,408
38109,17536,13325,2209,5924,4355,837,2162,3962,3222,3979,4211,376,1559,1578,698,3750,461
38111,18817,10248,3089,4448,1924,787,2624,3397,2292,1935,8569,2401,2748,1760,1660,7056,1513
38112,7440,4286,1089,2071,855,271,972,1144,1277,893,3154,826,1203,753,372,2479,675
38114,12643,8615,2378,3341,2234,662,1143,1816,2977,2679,4028,639,1333,1443,613,3544,484
38115,17209,10103,4306,4281,1159,357,2964,2924,2771,1444,7106,2946,2426,673,1061,6046,1060
38116,18129,13041,4186,6618,1942,295,3165,3066,4650,2160,5088,1552,1873,1206,457,4294,794
38117,11622,7132,1106,3045,1925,1056,2211,3611,566,744,4490,594,1157,1403,1336,4041,449
38118,16160,11753,3911,5939,1528,375,3406,2500,3922,1925,4407,1586,1667,860,294,3589,818
38119,9688,6033,1030,2900,1645,458,1857,3117,626,433,3655,1426,1088,710,431,2927,728
38120,6001,3965,364,1734,1410,457,1274,2175,243,273,2036,618,663,414,341,1734,302
38122,10673,6148,1699,2559,1280,610,1755,2303,1101,989,4525,894,1582,1206,843,3755,770
38125,8614,6857,1270,4338,1108,141,3054,2701,678,424,1757,631,751,309,66,1491,266
38126,2599,1663,518,800,263,82,143,148,911,461,936,105,399,309,123,785,151
38127,17343,13229,4043,6332,2239,615,3022,3326,4692,2189,4114,716,1618,1184,596,3550,564
38128,16096,11527,3558,5511,1964,494,3337,3147,3247,1796,4569,1244,1633,978,714,3951,618
38131,0,0,0,0,0,0,0,0,0,0,0,0,0,0,0,0,0
38132,16,16,10,0,0,6,0,10,6,0,0,0,0,0,0,0,0
38133,6550,5379,1300,3073,888,118,2571,2006,498,304,1171,262,610,252,47,955,216
38134,14517,10095,2589,4952,2183,371,3526,4279,1323,967,4422,1811,1408,870,333,3508,914
38135,8528,6983,1169,4260,1328,226,3177,2878,622,306,1545,262,499,481,303,1343,202
38138,8638,6881,516,3889,2113,363,2865,3268,423,325,1757,366,607,570,214,1602,155
38139,4656,4241,214,2879,1049,99,2228,1793,160,60,415,8,220,109,78,386,29
38141,7674,5946,1812,3375,689,70,2476,1629,1122,719,1728,443,950,264,71,1410,318
38157,5,5,0,0,5,0,0,5,0,0,0,0,0,0,0,0,0
38201,3898,2753,587,1176,798,192,789,1373,373,218,1145,172,280,427,266,1003,142
38220,823,606,160,263,130,53,212,254,75,65,217,19,61,59,78,193,24
38221,1404,1025,179,415,365,66,271,575,108,71,379,28,93,174,84,346,33
38222,943,745,157,265,276,47,198,438,49,60,198,14,64,63,57,176,22
38224,384,311,66,135,95,15,150,118,26,17,73,13,36,19,5,66,7
38225,2564,1812,386,767,513,146,574,929,166,143,752,121,194,242,195,657,95
38226,167,130,46,27,57,0,53,70,0,7,37,0,9,12,16,34,3
38229,1201,883,229,382,224,48,313,367,142,61,318,73,79,96,70,300,18
38230,1630,1173,237,495,318,123,390,552,103,128,457,55,135,144,123,437,20
38231,743,607,120,312,141,34,238,263,53,53,136,28,29,40,39,111,25
38232,909,670,185,268,178,39,237,325,57,51,239,19,79,93,48,214,25
38233,1254,898,224,356,290,28,300,437,92,69,356,38,73,124,121,325,31
38235,99,61,8,25,21,7,9,31,9,12,38,4,8,17,9,35,3
38236,292,182,30,82,47,23,49,113,12,8,110,12,59,13,26,81,29
38237,5892,3673,955,1658,839,221,1195,1702,508,268,2219,872,537,498,312,1693,526
38240,964,706,171,268,214,53,237,333,66,70,258,22,60,103,73,224,34
38241,360,267,40,137,52,38,98,122,21,26,93,8,43,31,11,89,4
38242,8074,5375,1132,2236,1520,487,1592,2554,597,632,2699,331,654,992,722,2394,305
38251,1079,822,175,344,245,58,280,412,74,56,257,47,83,74,53,217,40
38253,416,361,74,151,112,24,91,213,24,33,55,14,12,14,15,55,0
38255,991,692,132,256,221,83,207,380,65,40,299,32,83,109,75,269,30
38256,1432,956,93,386,388,89,251,604,48,53,476,51,140,190,95,434,42
38257,2006,1463,296,612,456,99,474,724,131,134,543,53,142,201,147,481,62
38258,711,482,86,200,149,47,126,234,70,52,229,17,100,48,64,215,14
38259,387,287,73,144,55,15,112,130,34,11,100,16,32,30,22,88,12
38260,1440,1108,234,525,288,61,418,556,96,38,332,61,66,88,117,301,31
38261,6890,4760,1087,2199,1197,277,1529,2156,646,429,2130,293,659,696,482,1915,215
38301,15636,10162,2612,4316,2341,893,2504,3598,2421,1639,5474,1007,1920,1467,1080,4821,653
38305,15715,11317,2778,5678,2390,471,4287,4869,1298,863,4398,1372,1422,888,716,3657,741
38310,2261,1684,373,678,526,107,549,874,104,157,577,55,128,226,168,522,55
38311,391,309,60,146,92,11,84,191,30,4,82,5,40,16,21,77,5
38313,1161,895,201,424,222,48,319,412,68,96,266,54,100,73,39,218,48
38315,1483,1103,242,500,289,72,334,484,152,133,380,65,101,151,63,350,30
38316,1183,858,194,337,268,59,277,441,83,57,325,47,120,69,89,274,51
38317,1124,794,152,269,303,70,195,435,78,86,330,50,91,89,100,307,23
38318,226,174,40,77,43,14,70,79,10,15,52,2,7,28,15,50,2
38320,4470,3154,560,1311,1003,280,977,1652,214,311,1316,166,298,470,382,1198,118
38321,849,638,103,280,175,80,135,346,78,79,211,15,68,65,63,182,29
38326,1083,729,171,253,263,42,186,418,64,61,354,41,130,143,40,307,47
38327,214,145,23,60,49,13,40,69,8,28,69,9,12,26,22,69,0
38328,330,205,38,106,45,16,85,86,4,30,125,19,17,39,50,125,0
38329,1303,919,181,362,312,64,299,474,60,86,384,27,97,136,124,367,17
38330,1796,1305,303,554,324,124,397,671,163,74,491,48,118,190,135,455,36
38332,501,397,69,176,139,13,155,187,31,24,104,18,28,35,23,102,2
38333,244,182,56,60,46,20,49,84,20,29,62,5,13,33,11,62,0
38334,697,530,158,255,96,21,248,212,39,31,167,22,30,67,48,154,13
38337,617,454,60,216,126,52,145,263,26,20,163,8,62,53,40,145,18
38339,257,189,39,64,72,14,56,105,10,18,68,8,18,33,9,60,8
38340,4131,2991,744,1279,719,249,1089,1276,290,336,1140,156,335,381,268,1020,120
38341,894,666,123,286,223,34,228,318,78,42,228,22,106,54,46,207,21
38342,642,452,101,213,124,14,181,215,30,26,190,30,56,55,49,175,15
38343,6441,4565,943,2027,1246,349,1447,1975,706,437,1876,228,634,520,494,1702,174
38344,3665,2640,527,1098,816,199,868,1238,262,272,1025,158,228,376,263,916,109
38345,741,537,103,262,131,41,197,290,30,20,204,46,58,77,23,185,19
38347,143,122,15,75,25,7,35,72,0,15,21,0,10,0,11,21,0
38348,505,359,68,174,93,24,139,182,18,20,146,46,41,39,20,126,20
38351,6607,4719,1179,2069,1208,263,1559,2039,691,430,1888,303,581,624,380,1719,169
38352,169,128,24,56,48,0,55,32,19,22,41,11,0,0,30,30,11
38355,1023,755,157,344,223,31,273,369,75,38,268,69,63,91,45,246,22
38356,946,713,126,363,203,21,277,318,49,69,233,29,69,97,38,200,33
38357,1059,823,139,411,208,65,257,447,61,58,236,21,60,118,37,202,34
38358,4820,3323,650,1482,909,282,1165,1461,354,343,1497,210,457,515,315,1366,131
38359,117,87,15,28,27,17,20,57,4,6,30,4,4,6,16,26,4
38361,364,289,58,139,72,20,128,102,29,30,75,4,16,34,21,69,6
38362,299,246,91,116,14,25,106,91,38,11,53,23,30,0,0,21,32
38363,2503,1739,381,702,521,135,465,915,219,140,764,90,197,268,209,695,69
38366,799,648,139,260,198,51,224,314,46,64,151,17,51,65,18,143,8
38367,1088,797,212,320,199,66,263,406,77,51,291,47,87,101,56,265,26
38368,765,567,87,249,186,45,185,289,44,49,198,41,36,53,68,198,0
38369,835,571,102,244,164,61,142,295,86,48,264,21,77,90,76,235,29
38370,306,178,33,82,45,18,45,95,20,18,128,1,30,70,27,107,21
38371,618,469,118,172,148,31,147,237,58,27,149,22,21,52,54,133,16
38372,6959,4965,1141,2077,1345,402,1620,2390,547,408,1994,335,478,757,424,1799,195
38374,638,494,115,189,136,54,167,253,30,44,144,7,25,39,73,132,12
38375,3569,2418,542,973,697,206,862,1086,292,178,1151,136,322,403,290,1038,113
38376,181,128,23,71,20,14,48,68,3,9,53,5,9,12,27,45,8
38378,37,37,0,0,37,0,15,22,0,0,0,0,0,0,0,0,0
38379,411,300,57,112,114,17,94,161,6,39,111,16,20,42,33,86,25
38380,199,117,36,28,45,8,50,58,0,9,82,0,37,35,10,71,11
38381,573,436,92,167,139,38,124,188,63,61,137,31,52,25,29,125,12
38382,3999,2796,582,1235,746,233,886,1318,336,256,1203,161,256,460,326,1131,72
38387,130,105,16,49,32,8,42,63,0,0,25,0,16,4,5,17,8
38388,738,561,116,239,179,27,149,253,100,59,177,41,57,48,31,158,19
38390,358,246,70,105,63,8,89,106,41,10,112,7,39,33,33,101,11
38391,429,317,36,148,66,67,93,119,23,82,112,33,32,21,26,108,4
38392,313,220,51,86,64,19,83,103,17,17,93,10,17,35,31,76,17
38401,19426,13991,3088,6946,3210,747,4695,5774,2002,1520,5435,850,2016,1549,1020,4757,678
38425,719,469,71,191,164,43,142,246,36,45,250,56,62,69,63,232,18
38449,1091,816,177,290,304,45,245,446,43,82,275,15,98,107,55,246,29
38450,1133,829,210,353,215,51,286,386,86,71,304,29,88,99,88,268,36
38451,1421,1209,275,612,276,46,543,474,111,81,212,52,67,67,26,188,24
38452,389,289,49,160,61,19,146,95,15,33,100,10,25,43,22,95,5
38453,98,76,43,21,12,0,28,42,6,0,22,0,5,4,13,22,0
38454,464,375,78,167,87,43,121,205,29,20,89,8,18,21,42,79,10
38456,1390,1046,257,462,274,53,414,467,110,55,344,38,108,124,74,312,32
38457,351,257,64,112,61,20,89,129,29,10,94,16,11,46,21,86,8
38459,162,113,28,54,31,0,72,22,13,6,49,6,22,6,15,49,0
38460,531,400,77,196,108,19,131,188,66,15,131,24,37,40,30,121,10
38461,423,344,65,172,88,19,116,179,10,39,79,29,37,13,0,52,27
38462,3807,2724,605,1226,738,155,942,1237,299,246,1083,125,352,370,236,955,128
38463,1057,814,223,292,226,73,293,366,71,84,243,36,67,99,41,223,20
38464,8924,6316,1456,2719,1708,433,2178,2887,693,558,2608,319,685,845,759,2362,246
38468,1679,1334,344,562,364,64,490,650,109,85,345,38,83,116,108,321,24
38469,1562,1190,259,527,332,72,427,596,113,54,372,50,86,106,130,334,38
38471,273,219,12,91,87,29,41,149,16,13,54,10,6,12,26,46,8
38472,1093,821,157,390,224,50,282,412,64,63,272,43,102,85,42,243,29
38473,445,339,75,136,112,16,119,176,23,21,106,6,40,24,36,101,5
38474,2764,2057,526,881,547,103,697,844,292,224,707,96,235,227,149,669,38
38475,211,155,67,28,60,0,63,61,6,25,56,14,18,7,17,49,7
38476,395,345,34,215,68,28,93,210,15,27,50,0,32,18,0,36,14
38477,1126,840,143,425,221,51,328,367,66,79,286,37,119,85,45,249,37
38478,7205,4966,973,2206,1280,507,1672,2094,582,618,2239,319,646,719,555,1980,259
38481,411,298,64,139,79,16,113,117,31,37,113,17,32,38,26,102,11
38482,514,364,52,180,114,18,138,173,26,27,150,32,65,29,24,145,5
38483,1668,1330,317,650,306,57,527,541,122,140,338,50,108,124,56,297,41
38485,2562,1860,441,690,545,184,533,920,237,170,702,81,193,263,165,633,69
38486,307,251,33,126,68,24,68,145,9,29,56,16,27,7,6,51,5
38487,352,288,83,99,90,16,103,147,14,24,64,5,23,31,5,55,9
38488,858,675,152,375,131,17,304,261,69,41,183,17,65,70,31,173,10
38501,13399,8024,2142,3221,2065,596,2587,3646,954,837,5375,2335,1112,1059,869,4050,1325
38504,302,255,48,129,61,17,97,119,0,39,47,0,6,14,27,41,6
38506,8880,6628,1457,3157,1696,318,2401,3100,653,474,2252,372,716,735,429,1987,265
38541,575,433,44,207,157,25,149,251,0,33,142,19,47,62,14,129,13
38542,24,16,0,7,0,9,7,9,0,0,8,0,0,0,8,8,0
38543,240,147,39,69,26,13,19,98,17,13,93,8,29,37,19,80,13
38544,2366,1651,346,749,458,98,563,780,161,147,715,144,161,233,177,598,117
38545,428,313,68,132,92,21,144,140,16,13,115,8,57,33,17,99,16
38547,562,404,90,153,129,32,135,198,35,36,158,48,44,11,55,144,14
38548,245,204,35,73,85,11,68,117,12,7,41,7,4,23,7,34,7
38549,1532,1096,175,453,371,97,323,619,79,75,436,56,88,191,101,408,28
38551,1789,1222,257,508,398,59,318,576,138,190,567,69,133,238,127,523,44
38552,237,172,45,70,51,6,71,101,0,0,65,22,16,21,6,54,11
38553,792,613,126,304,164,19,226,255,70,62,179,39,49,61,30,164,15
38554,378,300,62,132,99,7,99,124,43,34,78,15,13,36,14,59,19
38555,13114,9637,1899,3825,3126,787,2799,4915,1085,838,3477,472,913,1370,722,3111,366
38556,4981,3471,819,1445,978,229,1199,1569,362,341,1510,164,470,591,285,1366,144
38558,4445,3465,353,792,1823,497,613,2556,157,139,980,96,205,439,240,883,97
38559,515,391,56,176,132,27,96,206,44,45,124,21,49,19,35,116,8
38560,501,381,92,165,85,39,138,179,35,29,120,9,23,58,30,106,14
38562,2580,1818,408,797,494,119,564,834,216,204,762,118,231,288,125,677,85
38563,752,584,113,317,131,23,213,273,73,25,168,21,63,47,37,154,14
38564,240,150,22,28,67,33,19,105,7,19,90,0,20,44,26,83,7
38565,160,140,62,31,31,16,49,41,31,19,20,7,7,6,0,14,6
38567,304,236,41,108,70,17,61,146,10,19,68,18,16,34,0,63,5
38568,778,483,107,218,114,44,154,212,44,73,295,47,94,65,89,236,59
38569,173,131,0,59,62,10,43,65,4,19,42,9,0,21,12,38,4
38570,3964,2814,620,1165,797,232,863,1358,257,336,1150,133,266,538,213,1060,90
38573,781,604,110,277,160,57,210,287,50,57,177,21,18,91,47,155,22
38574,2844,2176,513,922,608,133,812,1019,178,167,668,113,189,244,122,600,68
38575,504,357,92,154,87,24,124,194,27,12,147,19,34,48,46,143,4
38577,501,361,83,148,101,29,138,183,6,34,140,7,45,69,19,132,8
38579,391,304,60,89,130,25,96,181,7,20,87,18,22,20,27,76,11
38580,394,272,64,109,79,20,64,147,30,31,122,27,31,22,42,106,16
38581,1526,1178,268,586,272,52,455,561,98,64,348,51,117,117,63,308,40
38582,533,395,83,172,100,40,140,191,21,43,138,9,69,38,22,115,23
38583,8491,6185,1216,2704,1807,458,1930,3039,645,571,2306,380,606,775,545,2035,271
38585,1690,1264,283,533,344,104,349,637,148,130,426,56,133,169,68,361,65
38587,486,414,88,146,149,31,148,232,19,15,72,0,31,27,14,63,9
38588,442,292,56,120,70,46,110,125,22,35,150,27,42,52,29,130,20
38589,46,46,0,0,33,13,0,38,0,8,0,0,0,0,0,0,0
38601,911,667,173,322,132,40,226,267,96,78,244,60,83,63,38,212,32
38603,1096,754,166,270,230,88,210,389,77,78,342,38,86,129,89,307,35
38606,5590,4096,979,1874,946,297,1395,1457,708,536,1494,227,465,527,275,1319,175
38609,35,27,4,12,9,2,6,12,3,6,8,0,5,1,2,7,1
38610,1267,1005,249,445,237,74,330,464,113,98,262,38,84,77,63,244,18
38611,5314,4073,820,1928,1113,212,1302,1666,496,609,1241,152,476,423,190,1064,177
38614,8083,5720,1347,2595,1401,377,1388,1632,1614,1086,2363,348,706,761,548,2100,263
38617,427,288,92,131,52,13,63,55,118,52,139,16,53,31,39,131,8
38618,3868,2865,596,1288,791,190,931,1269,349,316,1003,184,289,288,242,869,134
38619,1757,1337,297,570,394,76,359,536,233,209,420,38,150,100,132,370,50
38620,1124,896,244,450,145,57,347,271,177,101,228,15,90,84,39,213,15
38621,868,630,164,266,159,41,164,162,194,110,238,31,77,52,78,223,15
38622,279,154,34,64,48,8,46,61,32,15,125,12,32,61,20,112,13
38623,145,103,23,39,29,12,22,27,25,29,42,10,8,17,7,41,1
38625,431,326,86,143,67,30,119,136,36,35,105,10,27,32,36,101,4
38626,461,314,66,125,97,26,93,105,54,62,147,22,52,46,27,126,21
38627,358,288,82,95,91,20,86,150,21,31,70,0,18,33,19,70,0
38629,677,473,136,204,105,28,215,200,40,18,204,14,63,71,56,185,19
38630,47,33,15,11,3,4,9,5,14,5,14,0,7,5,2,14,0
38631,523,376,98,176,84,18,66,68,145,97,147,13,52,42,40,136,11
38632,5798,4580,937,2185,1255,203,1575,2152,428,425,1218,155,490,387,186,1061,157
38633,774,584,133,236,170,45,190,260,81,53,190,26,47,77,40,165,25
38635,5455,4043,908,1835,1035,265,959,1267,1021,796,1412,138,498,493,283,1307,105
38637,5385,4001,1506,1880,534,81,1965,1019,681,336,1384,423,491,332,138,1077,307
38639,366,283,93,127,41,22,62,29,114,78,83,5,15,36,27,71,12
38641,708,540,102,234,174,30,162,234,96,48,168,33,74,15,46,141,27
38642,810,615,151,293,160,11,196,177,164,78,195,22,61,74,38,180,15
38643,1041,761,173,329,199,60,160,205,226,170,280,31,74,111,64,248,32
38644,75,54,8,17,25,4,8,27,7,12,21,1,4,12,4,17,4
38645,630,451,98,215,106,32,130,133,104,84,179,22,76,56,25,162,17
38646,1350,944,188,408,246,102,236,322,195,191,406,50,106,130,120,371,35
38647,165,137,27,55,36,19,43,52,21,21,28,0,7,8,13,28,0
38649,39,30,0,10,14,6,5,17,0,8,9,0,9,0,0,9,0
38650,1357,1007,202,489,279,37,372,508,69,58,350,35,139,81,95,314,36
38651,2445,2026,349,1059,523,95,775,887,210,154,419,11,145,164,99,377,42
38652,6013,4390,1157,1867,1066,300,1566,1910,574,340,1623,205,453,477,488,1482,141
38654,9798,8015,1841,4071,1838,265,3442,3398,697,478,1783,357,598,576,252,1485,298
38655,12132,6782,1878,3057,1505,342,2366,2863,992,561,5350,3054,1019,807,470,3597,1753
38658,786,624,98,292,184,50,195,270,97,62,162,23,33,61,45,160,2
38659,1257,966,204,464,253,45,343,399,121,103,291,35,80,108,68,271,20
38661,765,582,107,242,187,46,152,311,44,75,183,55,59,69,0,145,38
38663,4505,3195,849,1287,801,258,1006,1385,470,334,1310,177,416,466,251,1184,126
38664,614,357,105,172,72,8,57,142,95,63,257,89,105,48,15,173,84
38665,722,489,69,225,143,52,131,232,59,67,233,26,59,100,48,202,31
38666,2592,1822,378,828,500,116,456,693,398,275,770,72,256,240,202,690,80
38668,4360,3453,780,1642,801,230,1274,1318,485,376,907,131,266,304,206,830,77
38669,28,14,3,3,8,0,3,6,3,2,14,0,6,6,2,11,3
38670,382,282,76,111,59,36,82,70,56,74,100,18,26,32,24,96,4
38671,10476,7791,2246,3428,1895,222,2901,3161,1063,666,2685,760,893,755,277,2236,449
38672,491,465,68,261,106,30,180,251,22,12,26,0,14,12,0,16,10
38673,200,120,31,75,11,3,36,58,15,11,80,12,32,34,2,76,4
38674,400,309,29,163,78,39,119,145,6,39,91,0,0,60,31,86,5
38676,2278,1605,358,752,414,81,364,387,435,419,673,65,251,205,152,606,67
38677,97,66,20,46,0,0,16,16,34,0,31,13,18,0,0,31,0
38680,3078,2379,576,1149,576,78,813,1064,254,248,699,145,314,157,83,515,184
38683,1898,1383,363,553,365,102,493,671,114,105,515,46,140,204,125,477,38
38685,18,9,0,9,0,0,0,9,0,0,9,0,0,0,9,9,0
38701,10665,7578,1878,3569,1621,510,1912,2401,1954,1311,3087,518,976,926,667,2688,399
38703,6274,4570,1152,2009,1139,270,1171,1532,1107,760,1704,300,585,537,282,1517,187
38720,148,122,31,56,30,5,32,50,26,14,26,6,3,9,8,25,1
38721,577,402,124,171,86,21,118,105,108,71,175,22,52,47,54,160,15
38722,331,220,37,105,52,26,29,49,81,61,111,15,50,15,31,100,11
38723,61,53,12,19,22,0,5,14,26,8,8,0,0,8,0,8,0
38725,437,322,57,156,87,22,56,103,96,67,115,19,34,40,22,98,17
38726,425,323,89,142,72,20,35,74,131,83,102,29,34,23,16,91,11
38730,528,451,102,201,129,19,138,206,62,45,77,5,24,18,30,75,2
38732,6645,4526,1099,2018,1084,325,1222,1478,1059,767,2119,667,603,529,320,1795,324
38736,162,115,32,34,36,13,50,49,10,6,47,13,13,10,11,45,2
38737,1226,896,205,400,220,71,218,244,258,176,330,62,92,107,69,296,34
38738,97,72,0,61,11,0,19,21,20,12,25,0,19,6,0,25,0
38739,48,29,1,14,11,3,14,15,0,0,19,0,4,8,7,19,0
38740,273,204,75,77,47,5,39,43,73,49,69,6,17,38,8,60,9
38744,381,279,39,163,61,16,78,85,78,38,102,16,22,26,38,93,9
38745,53,41,11,16,12,2,12,13,8,8,12,5,3,4,0,12,0
38746,393,296,36,134,96,30,80,72,57,87,97,8,47,29,13,83,14
38748,1795,1364,292,640,333,99,435,419,262,248,431,50,112,150,119,403,28
38751,4447,3348,840,1577,708,223,840,1072,866,570,1099,230,294,374,201,968,131
38753,589,446,86,174,153,33,132,148,59,107,143,9,41,52,41,132,11
38754,948,722,147,379,110,86,159,171,251,141,226,21,53,97,55,212,14
38756,2639,1968,430,934,461,143,522,637,445,364,671,143,179,213,136,616,55
38758,13,8,2,6,0,0,3,5,0,0,5,1,1,0,3,3,2
38759,509,351,71,186,73,21,116,146,51,38,158,25,61,38,34,135,23
38760,268,198,42,103,46,7,51,35,58,54,70,14,19,17,20,61,9
38761,862,676,162,336,147,31,161,154,195,166,186,27,45,61,53,159,27
38762,1106,834,176,386,196,76,170,157,231,276,272,31,103,94,44,245,27
38763,32,22,6,6,10,0,7,3,6,6,10,0,3,0,7,0,10
38764,137,96,15,44,19,18,18,13,13,52,41,4,24,9,4,39,2
38765,53,39,0,15,14,10,19,0,6,14,14,0,14,0,0,14,0
38767,44,35,2,21,9,3,11,14,4,6,9,0,4,0,5,9,0
38768,78,64,21,32,11,0,22,15,15,12,14,0,14,0,0,14,0
38769,773,542,156,213,135,38,106,129,202,105,231,10,72,108,41,211,20
38771,1141,864,266,359,151,88,208,237,239,180,277,28,76,100,73,241,36
38772,45,36,10,15,5,6,11,11,6,8,9,0,4,5,0,7,2
38773,1648,1233,296,525,336,76,292,381,315,245,415,40,181,107,87,380,35
38774,1132,793,191,356,162,84,155,208,270,160,339,48,109,77,105,309,30
38778,679,534,183,175,128,48,169,141,133,91,145,25,38,40,42,118,27
38801,10821,7720,2067,3650,1698,305,2668,2827,1482,743,3101,768,1152,771,410,2723,378
38804,6798,4563,1178,2042,1075,268,1531,1853,709,470,2235,553,638,611,433,1957,278
38821,5082,3696,753,1701,979,263,1242,1528,520,406,1386,196,360,419,411,1326,60
38824,3286,2417,687,1033,560,137,925,964,285,243,869,136,203,326,204,829,40
38826,1321,1077,254,479,251,93,405,480,93,99,244,49,121,54,20,215,29
38827,1173,863,237,354,218,54,298,372,105,88,310,40,60,141,69,292,18
38828,1260,970,188,453,254,75,337,496,85,52,290,60,49,74,107,269,21
38829,7099,5088,1083,2223,1389,393,1731,2160,574,623,2011,353,476,631,551,1821,190
38833,972,723,176,326,186,35,276,288,79,80,249,39,70,87,53,238,11
38834,11156,7566,1663,3302,2081,520,2328,3478,930,830,3590,553,1005,1215,817,3291,299
38838,513,399,104,148,109,38,182,190,9,18,114,5,39,21,49,114,0
38841,1012,759,183,394,156,26,333,316,46,64,253,34,99,53,67,240,13
38843,4513,3212,749,1309,893,261,1111,1507,272,322,1301,157,326,450,368,1208,93
38844,114,89,18,47,21,3,43,40,2,4,25,3,7,10,5,24,1
38846,895,691,159,338,169,25,280,304,50,57,204,38,55,69,42,191,13
38847,1343,1060,194,498,339,29,379,502,105,74,283,53,79,72,79,268,15
38848,263,213,65,63,72,13,83,101,8,21,50,5,17,20,8,45,5
38849,1510,1119,291,569,210,49,507,409,150,53,391,76,73,129,113,351,40
38850,1090,816,187,377,191,61,355,288,82,91,274,28,58,118,70,265,9
38851,3425,2495,571,1142,582,200,846,954,360,335,930,137,167,383,243,853,77
38852,3926,2708,524,1124,824,236,866,1400,245,197,1218,100,345,518,255,1143,75
38855,1752,1323,344,553,339,87,489,624,148,62,429,82,134,144,69,364,65
38856,712,535,147,186,169,33,216,243,43,33,177,43,8,70,56,170,7
38857,960,736,178,345,166,47,254,322,106,54,224,40,106,44,34,176,48
38858,2714,2081,481,948,503,149,711,848,268,254,633,71,179,246,137,562,71
38859,288,197,63,107,21,6,111,50,11,25,91,14,19,35,23,83,8
38860,2153,1612,396,711,402,103,438,526,391,257,541,11,190,168,172,525,16
38862,1208,838,214,402,163,59,340,351,81,66,370,56,117,144,53,314,56
38863,6830,5022,1253,2344,1131,294,1871,2099,651,401,1808,290,502,549,467,1674,134
38864,739,585,134,223,199,29,229,281,50,25,154,19,49,32,54,137,17
38865,1839,1479,346,616,422,95,525,694,95,165,360,56,90,120,94,330,30
38866,3387,2531,677,1174,536,144,955,1097,302,177,856,199,300,229,128,727,129
38868,1990,1469,390,692,328,59,464,509,321,175,521,62,226,188,45,450,71
38869,167,123,68,38,12,5,49,34,13,27,44,9,8,19,8,40,4
38870,1166,845,171,386,231,57,326,341,88,90,321,40,61,109,111,301,20
38871,592,506,134,210,120,42,203,250,25,28,86,14,22,28,22,75,11
38873,1028,694,195,270,188,41,255,322,55,62,334,32,81,151,70,291,43
38874,33,21,0,10,8,3,6,10,2,3,12,0,1,9,2,12,0
38876,500,364,80,176,75,33,160,168,30,6,136,19,26,49,42,131,5
38878,1025,751,189,325,200,37,251,278,112,110,274,19,89,82,84,235,39
38879,321,206,59,89,47,11,41,65,56,44,115,30,56,23,6,85,30
38880,27,20,0,20,0,0,6,9,5,0,7,0,0,7,0,7,0
38901,7620,5478,1302,2511,1297,368,1678,2027,1067,706,2142,268,655,708,511,1946,196
38913,185,131,44,25,53,9,31,74,17,9,54,8,18,28,0,54,0
38914,168,125,41,53,25,6,35,58,10,22,43,0,27,11,5,38,5
38915,1704,1155,245,496,292,122,279,554,203,119,549,75,105,204,165,509,40
38916,2124,1535,368,658,379,130,397,610,317,211,589,64,173,202,150,571,18
38917,1281,1024,183,499,275,67,288,483,122,131,257,28,51,64,114,247,10
38920,255,218,57,79,63,19,68,106,28,16,37,0,26,11,0,37,0
38921,1973,1408,357,645,278,128,386,453,304,265,565,83,170,190,122,523,42
38922,1373,961,196,386,276,103,205,424,141,191,412,41,125,135,111,405,7
38923,447,319,83,104,105,27,100,98,40,81,128,21,26,66,15,115,13
38924,390,297,46,177,54,20,79,104,68,46,93,16,30,20,27,89,4
38925,979,679,124,310,190,55,167,336,98,78,300,42,63,101,94,276,24
38927,393,270,63,80,89,38,76,135,20,39,123,33,27,27,36,111,12
38928,249,161,44,66,44,7,24,28,72,37,88,2,64,19,3,81,7
38929,479,369,65,169,89,46,83,170,41,75,110,0,52,40,18,101,9
38930,10426,7149,1828,3106,1678,537,1662,2160,2038,1289,3277,563,987,983,744,2997,280
38940,768,575,125,241,142,67,187,284,34,70,193,12,76,52,53,188,5
38941,1594,1175,301,549,258,67,281,235,363,296,419,58,135,125,101,371,48
38943,186,122,21,54,27,20,54,54,7,7,64,0,15,34,15,59,5
38944,294,217,33,92,67,25,57,83,38,39,77,18,24,9,26,68,9
38946,137,110,12,54,31,13,20,36,33,21,27,6,12,2,7,27,0
38947,269,159,28,72,44,15,48,75,24,12,110,15,13,37,45,102,8
38948,875,645,118,259,214,54,150,287,135,73,230,34,61,101,34,208,22
38949,63,63,13,18,24,8,22,24,0,17,0,0,0,0,0,0,0
38950,214,126,28,34,34,30,34,55,11,26,88,22,0,41,25,68,20
38951,477,343,67,126,116,34,115,151,41,36,134,38,14,43,39,129,5
38952,251,187,32,105,35,15,50,56,52,29,64,22,25,7,10,62,2
38953,218,155,30,84,41,0,46,53,43,13,63,5,18,23,17,57,6
38954,690,506,158,190,140,18,116,207,130,53,184,74,46,41,23,170,14
38957,341,251,69,93,61,28,56,93,62,40,90,3,9,46,32,77,13
38959,52,37,4,17,16,0,15,10,0,12,15,15,0,0,0,15,0
38961,499,380,114,118,111,37,89,190,67,34,119,23,26,44,26,103,16
38962,133,97,25,13,59,0,13,35,25,24,36,0,13,6,17,29,7
38963,644,474,88,224,120,42,82,162,136,94,170,30,69,40,31,145,25
38964,62,44,4,27,13,0,7,18,9,10,18,5,2,9,2,13,5
38965,3591,2525,550,1159,614,202,779,1041,351,354,1066,163,286,381,236,968,98
38966,473,308,61,121,68,58,65,93,77,73,165,26,59,51,29,147,18
38967,3035,2189,428,961,615,185,607,857,402,323,846,70,224,356,196,784,62
39038,1945,1430,391,637,310,92,285,398,424,323,515,47,208,130,130,474,41
39039,750,603,135,292,143,33,149,211,147,96,147,7,44,45,51,136,11
39040,1258,923,173,407,278,65,283,376,158,106,335,28,110,99,98,292,43
39041,1120,833,88,507,186,52,219,245,142,227,287,9,96,104,78,279,8
39042,9982,7697,1637,3862,1913,285,2916,3337,822,622,2285,451,746,678,410,2008,277
39044,1372,1031,243,510,221,57,438,391,134,68,341,41,129,71,100,320,21
39045,373,265,36,146,48,35,77,29,87,72,108,8,33,43,24,108,0
39046,7363,5675,1346,2571,1417,341,1286,1669,1625,1095,1688,207,503,601,377,1550,138
39047,9543,7341,1631,4005,1494,211,3107,3194,646,394,2202,612,812,585,193,1855,347
39051,5617,4128,936,1801,1114,277,1464,1489,663,512,1489,215,363,545,366,1368,121
39054,373,279,62,140,60,17,78,83,65,53,94,6,34,29,25,93,1
39056,9016,6684,1396,3341,1621,326,2502,2657,793,732,2332,572,711,608,441,2035,297
39057,719,518,147,253,100,18,159,156,109,94,201,52,32,91,26,186,15
39059,4476,3341,723,1604,781,233,1106,1200,606,429,1135,189,352,292,302,1035,100
39060,0,0,0,0,0,0,0,0,0,0,0,0,0,0,0,0,0
39061,40,36,0,23,13,0,6,24,0,6,4,0,4,0,0,4,0
39062,157,107,16,43,36,12,25,49,19,14,50,2,13,16,19,46,4
39063,1442,1017,233,406,293,85,278,315,231,193,425,49,124,106,146,395,30
39066,1623,1223,193,643,329,58,302,372,282,267,400,36,115,137,112,358,42
39067,579,411,121,146,133,11,143,177,64,27,168,33,38,44,53,153,15
39069,2105,1471,293,733,307,138,355,320,467,329,634,104,267,151,112,588,46
39071,1550,1196,270,631,234,61,404,493,195,104,354,40,139,101,74,305,49
39073,6366,4966,1074,2418,1230,244,1861,2068,562,475,1400,228,505,433,234,1205,195
39074,5857,4330,1067,1857,1097,309,1308,1498,866,658,1527,160,433,588,346,1318,209
39078,326,233,53,94,64,22,79,55,35,64,93,9,29,50,5,91,2
39079,531,405,108,172,83,42,105,123,94,83,126,21,29,42,34,118,8
39082,490,373,90,154,112,17,122,171,32,48,117,18,18,60,21,109,8
39083,3663,2691,448,1326,710,207,731,886,534,540,972,78,341,332,221,878,94
39086,818,592,129,284,165,14,222,159,136,75,226,35,37,63,91,220,6
39088,34,26,9,4,13,0,4,22,0,0,8,8,0,0,0,0,8
39090,5206,3686,861,1535,957,333,1140,1356,612,578,1520,135,337,540,508,1425,95
39092,914,694,171,287,209,27,200,292,124,78,220,38,49,67,66,209,11
39094,1299,1021,197,415,351,58,286,401,143,191,278,27,85,93,73,277,1
39095,2842,1998,369,952,516,161,407,544,593,454,844,59,275,277,233,775,69
39096,831,533,75,219,168,71,136,192,106,99,298,65,76,69,88,282,16
39097,409,292,61,141,81,9,94,78,59,61,117,20,33,46,18,111,6
39098,73,62,8,39,15,0,20,21,21,0,11,0,0,0,11,11,0
39107,61,54,10,27,17,0,25,17,6,6,7,0,0,0,7,7,0
39108,836,624,94,287,182,61,165,343,80,36,212,21,26,92,73,208,4
39109,22,15,0,15,0,0,15,0,0,0,7,0,0,7,0,7,0
39110,8178,6897,1179,4177,1356,185,3472,2686,438,301,1281,153,577,359,192,1143,138
39111,3925,2792,613,1328,651,200,905,1138,414,335,1133,148,290,433,262,1044,89
39112,8,8,8,0,0,0,0,0,8,0,0,0,0,0,0,0,0
39113,303,196,65,72,49,10,59,45,56,36,107,13,27,43,24,95,12
39114,3574,2728,590,1273,689,176,892,1084,404,348,846,146,233,306,161,779,67
39115,56,31,8,12,5,6,20,11,0,0,25,0,10,15,0,25,0
39116,930,694,212,298,139,45,288,297,41,68,236,24,51,88,73,218,18
39117,3727,2819,633,1298,726,162,962,1159,331,367,908,139,265,284,220,778,130
39119,2054,1489,345,577,453,114,484,588,240,177,565,54,167,235,109,512,53
39120,13791,9581,1786,4359,2700,736,2454,3429,2028,1670,4210,511,1366,1524,809,3835,375
39140,877,625,105,289,164,67,274,240,58,53,252,46,62,90,54,242,10
39144,429,304,56,165,72,11,95,81,79,49,125,16,28,36,45,122,3
39145,1828,1412,288,657,414,53,540,540,170,162,416,34,87,193,102,383,33
39146,1063,837,179,393,206,59,220,195,237,185,226,23,72,62,69,199,27
39148,17,12,6,6,0,0,6,0,6,0,5,0,5,0,0,5,0
39149,669,482,86,211,170,15,167,194,59,62,187,21,66,64,36,175,12
39150,2302,1602,268,808,415,111,400,504,381,317,700,100,221,201,178,615,85
39151,7,7,2,2,1,2,2,2,2,1,0,0,0,0,0,0,0
39152,466,401,74,198,120,9,105,194,52,50,65,0,7,38,20,65,0
39153,1322,985,221,434,283,47,385,399,86,115,337,18,94,135,90,321,16
39154,2986,2301,342,1158,601,200,750,1081,232,238,685,138,254,183,110,584,101
39156,129,101,23,28,24,26,10,46,10,35,28,7,0,12,9,28,0
39157,9364,5108,1630,2559,737,182,1939,1887,781,501,4256,1875,1515,455,411,3617,639
39159,1204,881,144,395,269,73,203,282,192,204,323,38,101,105,79,284,39
39160,1004,729,170,309,192,58,238,255,115,121,275,23,63,132,57,253,22
39161,30,21,0,7,14,0,7,14,0,0,9,0,0,9,0,9,0
39162,84,59,8,27,18,6,25,20,10,4,25,0,7,9,9,23,2
39166,310,222,34,95,64,29,54,53,49,66,88,4,34,23,27,84,4
39168,2252,1744,370,810,422,142,635,599,274,236,508,77,95,239,97,499,9
39169,1218,882,225,374,224,59,170,150,317,245,336,31,115,118,72,313,23
39170,2580,2228,268,1197,663,100,789,1092,149,198,352,45,105,130,72,339,13
39174,168,122,34,57,26,5,28,21,56,17,46,16,16,14,0,46,0
39175,1627,1194,225,570,262,137,327,452,177,238,433,54,123,126,130,374,59
39176,877,645,115,229,252,49,150,271,98,126,232,27,51,105,49,213,19
39177,71,61,5,43,8,5,22,25,5,9,10,0,6,0,4,10,0
39179,440,339,53,161,81,44,66,75,91,107,101,16,20,27,38,88,13
39180,12569,8845,1913,4393,1950,589,2844,3130,1668,1203,3724,663,1193,1105,763,3325,399
39183,6085,4385,1015,2200,939,231,1308,1514,963,600,1700,272,549,630,249,1480,220
39189,1221,882,171,445,212,54,322,355,110,95,339,20,134,121,64,300,39
39191,2566,1954,454,903,500,97,737,803,246,168,612,101,182,190,139,565,47
39192,792,577,104,264,174,35,185,219,90,83,215,22,46,95,52,187,28
39194,6601,4726,1060,2184,1193,289,1162,1532,1337,695,1875,198,556,650,471,1701,174
39201,222,84,21,27,31,5,0,37,0,47,138,66,13,45,14,134,4
39202,3948,1604,473,782,239,110,391,409,426,378,2344,848,845,402,249,1898,446
39203,2824,1816,550,750,377,139,207,270,776,563,1008,144,375,313,176,870,138
39204,7447,4811,1651,2177,708,275,1301,1107,1599,804,2636,837,723,683,393,2272,364
39206,10592,7028,2019,3561,1173,275,2044,1852,1766,1366,3564,1140,1141,845,438,2890,674
39208,11551,7709,2163,3450,1800,296,2655,2884,1267,903,3842,1403,1233,878,328,3150,692
39209,11559,8472,2378,4273,1504,317,1973,1735,3070,1694,3087,642,1226,777,442,2665,422
39210,0,0,0,0,0,0,0,0,0,0,0,0,0,0,0,0,0
39211,10603,6658,1161,2952,1887,658,2179,3398,593,488,3945,1010,1323,916,696,3340,605
39212,14049,10609,2935,5199,2034,441,3773,3589,2154,1093,3440,709,1443,843,445,2962,478
39213,9569,6713,1272,2776,2019,646,1016,1810,1710,2177,2856,303,896,1105,552,2557,299
39216,1539,714,231,294,69,120,229,264,115,106,825,235,260,144,186,703,122
39218,2362,1761,532,817,329,83,699,684,235,143,601,137,204,174,86,501,100
39269,0,0,0,0,0,0,0,0,0,0,0,0,0,0,0,0,0
39301,11375,7575,2078,3176,1825,496,1965,2707,1776,1127,3800,785,1081,1164,770,3372,428
39305,7670,5313,1086,2610,1311,306,1984,2307,555,467,2357,445,521,749,642,2114,243
39307,6792,4495,1216,1772,1102,405,1103,1593,1111,688,2297,369,685,733,510,2061,236
39320,763,591,131,276,134,50,250,274,20,47,172,10,29,79,54,165,7
39322,717,550,142,224,145,39,212,204,53,81,167,10,57,71,29,156,11
39323,379,300,88,102,99,11,126,128,16,30,79,9,27,16,27,72,7
39325,1849,1528,312,822,332,62,713,599,113,103,321,22,58,139,102,319,2
39326,321,250,68,125,50,7,92,62,45,51,71,5,31,17,18,71,0
39327,1481,1078,282,451,261,84,356,447,146,129,403,85,99,91,128,391,12
39328,1785,1274,263,525,351,135,366,503,212,193,511,66,147,131,167,476,35
39330,1056,745,155,328,201,61,256,344,95,50,311,14,92,130,75,288,23
39332,669,501,90,237,143,31,147,243,53,58,168,25,45,52,46,156,12
39335,1322,968,232,389,323,24,243,403,161,161,354,117,106,92,39,294,60
39336,463,376,58,192,90,36,122,153,35,66,87,12,30,27,18,87,0
39337,776,618,164,235,186,33,250,270,44,54,158,13,50,57,38,152,6
39338,1287,904,208,410,195,91,309,292,161,142,383,73,96,100,114,361,22
39339,6163,4510,895,2040,1252,323,1343,1712,828,627,1653,296,401,588,368,1531,122
39341,2956,2121,479,985,475,182,592,686,459,384,835,111,246,293,185,770,65
39345,2518,1763,414,701,492,156,561,674,288,240,755,76,238,275,166,701,54
39346,1075,757,168,310,240,39,225,300,111,121,318,23,90,105,100,300,18
39347,524,364,92,156,68,48,85,106,91,82,160,22,19,61,58,160,0
39348,165,120,37,25,48,10,0,51,53,16,45,11,9,14,11,45,0
39350,8218,6019,1498,2567,1519,435,1898,2323,1115,683,2199,349,619,740,491,1995,204
39352,352,247,65,93,89,0,47,112,73,15,105,11,11,24,59,96,9
39354,786,594,107,178,229,80,115,321,84,74,192,38,29,48,77,175,17
39355,2923,2126,392,1066,499,169,684,905,299,238,797,93,257,271,176,725,72
39356,335,262,63,104,80,15,92,86,49,35,73,13,24,12,24,69,4
39358,601,421,114,188,83,36,123,118,97,83,180,17,77,60,26,171,9
39359,140,97,18,53,21,5,24,38,21,14,43,8,6,13,16,40,3
39360,1557,1151,209,544,306,92,330,427,187,207,406,62,101,155,88,382,24
39361,652,446,111,187,100,48,134,159,85,68,206,35,61,54,56,203,3
39362,1041,745,193,364,155,33,264,254,134,93,296,44,59,133,60,284,12
39363,797,565,153,222,152,38,134,257,127,47,232,24,64,98,46,216,16
39364,1081,816,131,413,214,58,318,215,119,164,265,5,142,47,71,260,5
39365,3156,2279,484,947,677,171,787,1033,242,217,877,63,269,312,233,823,54
39366,633,464,93,181,154,36,124,94,97,149,169,0,95,54,20,158,11
39367,5949,4485,1115,1994,1100,276,1553,1677,737,518,1464,211,419,551,283,1381,83
39401,15594,9246,2980,3759,1913,594,2201,3079,2380,1586,6348,2793,1469,1301,785,4967,1381
39402,11974,8117,1872,4013,1866,366,3224,3405,808,680,3857,1672,987,751,447,2895,962
39421,1216,941,176,473,231,61,277,291,211,162,275,45,66,68,96,265,10
39422,2233,1697,388,725,447,137,514,685,310,188,536,40,98,251,147,506,30
39423,957,770,204,369,158,39,321,255,91,103,187,14,58,55,60,185,2
39425,379,322,85,152,79,6,108,156,26,32,57,6,13,24,14,50,7
39426,4857,3934,812,1944,1029,149,1447,1893,345,249,923,69,332,354,168,835,88
39427,539,384,92,172,96,24,125,166,46,47,155,5,43,67,40,151,4
39428,3457,2584,600,1161,682,141,778,885,500,421,873,131,185,283,274,807,66
39429,6335,4610,1043,2009,1226,332,1519,1816,745,530,1725,193,477,606,449,1610,115
39436,30,25,8,8,9,0,8,17,0,0,5,0,5,0,0,5,0
39437,4132,3119,634,1429,824,232,1106,1370,322,321,1013,138,310,342,223,915,98
39439,1724,1345,256,613,350,126,469,408,231,237,379,45,136,110,88,369,10
39440,8266,5439,1209,2366,1310,554,1291,2024,1209,915,2827,461,832,904,630,2530,297
39443,7770,5980,1312,2715,1554,399,2080,2728,605,567,1790,299,488,659,344,1568,222
39451,1497,1089,256,463,305,65,424,496,93,76,408,54,96,157,101,382,26
39452,8014,6392,1668,2757,1608,359,2579,2753,605,455,1622,216,441,641,324,1440,182
39455,2609,1964,487,885,489,103,695,857,271,141,645,80,182,254,129,594,51
39456,549,402,118,194,78,12,132,125,97,48,147,28,39,56,24,137,10
39459,1268,939,189,373,326,51,268,504,107,60,329,55,44,122,108,321,8
39461,158,107,41,42,21,3,58,32,14,3,51,5,8,32,6,48,3
39462,470,358,65,164,110,19,148,128,32,50,112,21,49,32,10,98,14
39464,906,686,168,332,169,17,272,279,66,69,220,18,91,66,45,198,22
39465,6344,4814,1111,2336,1143,224,1857,1800,622,535,1530,274,396,510,350,1335,195
39466,9221,6776,1482,3040,1886,368,2115,2971,1023,667,2445,459,764,783,439,2154,291
39470,4134,3129,605,1433,898,193,1076,1346,411,296,1005,144,266,371,224,919,86
39474,2566,1844,385,796,499,164,471,719,345,309,722,115,218,173,216,649,73
39475,3402,2639,620,1266,620,133,1115,1107,239,178,763,156,208,265,134,701,62
39476,2668,2070,507,952,483,128,778,933,180,179,598,62,164,226,146,524,74
39477,388,283,74,132,68,9,109,123,37,14,105,6,21,45,33,100,5
39478,656,490,91,240,123,36,181,207,40,62,166,19,44,64,39,159,7
39479,2146,1673,442,682,426,123,613,773,152,135,473,113,91,192,77,429,44
39480,933,717,149,328,169,71,264,336,64,53,216,27,31,78,80,214,2
39481,914,719,185,314,177,43,233,389,57,40,195,40,38,57,60,195,0
39482,2715,2174,544,1051,473,106,954,845,187,188,541,76,131,178,156,509,32
39483,2005,1554,404,752,312,86,572,632,195,155,451,22,141,178,110,431,20
39501,9529,5958,1585,2612,1363,398,1465,1830,1501,1162,3571,587,1413,1006,565,3007,564
39503,12817,9796,2670,4793,2045,288,3616,3806,1564,810,3021,606,1155,931,329,2295,726
39507,8436,4957,1092,2181,1388,296,1314,2196,805,642,3479,914,1115,910,540,2836,643
39520,6850,4511,789,2204,1198,320,1367,1980,703,461,2339,349,821,834,335,1918,421
39525,2557,1907,168,744,783,212,486,1179,102,140,650,64,181,264,141,546,104
39530,6294,3457,849,1481,821,306,920,1236,675,626,2837,531,859,849,598,2416,421
39531,8313,5223,1858,2225,857,283,1806,1873,1056,488,3090,852,1027,757,454,2515,575
39532,12334,9399,1922,4795,2399,283,3364,4111,1193,731,2935,552,1099,932,352,2421,514
39553,6005,4614,1193,2163,1141,117,1479,1921,847,367,1391,289,477,502,123,1155,236
39556,1541,1182,305,535,323,19,454,468,150,110,359,92,116,124,27,289,70
39560,7373,5348,1022,2786,1278,262,1995,2051,861,441,2025,428,809,531,257,1628,397
39561,457,365,92,203,61,9,194,112,37,22,92,8,29,28,27,81,11
39562,5767,4665,1066,2221,1264,114,1849,2018,416,382,1102,197,395,373,137,953,149
39563,5875,4289,673,1944,1348,324,992,1696,846,755,1586,163,610,500,313,1400,186
39564,11995,8872,1658,4459,2263,492,3527,3739,956,650,3123,704,1070,891,458,2552,571
39565,4738,3891,896,2054,848,93,1642,1579,436,234,847,136,309,263,139,660,187
39567,5325,3455,819,1427,902,307,956,1472,652,375,1870,231,587,544,508,1658,212
39571,6384,4636,1002,2096,1286,252,1464,2080,609,483,1748,288,595,595,270,1431,317
39572,729,524,109,239,135,41,208,186,78,52,205,7,71,83,44,152,53
39573,2267,1759,389,821,459,90,692,824,151,92,508,107,153,140,108,442,66
39574,3761,3065,921,1491,593,60,1297,1163,370,235,696,136,317,167,76,537,159
39576,2806,1865,338,855,516,156,626,719,282,238,941,154,308,340,139,811,130
39577,3892,2962,635,1407,718,202,1146,1211,343,262,930,107,314,282,227,807,123
39581,4437,3247,1056,1453,587,151,1078,1035,707,427,1190,271,485,318,116,928,262
39601,8598,6084,1510,2738,1421,415,2062,2436,899,687,2514,325,772,827,590,2302,212
39629,2261,1761,449,799,392,121,600,797,181,183,500,40,142,230,88,461,39
39630,359,256,60,123,53,20,88,62,63,43,103,8,28,47,20,97,6
39631,1370,1004,187,497,237,83,265,341,211,187,366,44,101,120,101,349,17
39632,0,0,0,0,0,0,0,0,0,0,0,0,0,0,0,0,0
39633,396,281,59,132,70,20,120,70,47,44,115,8,30,42,35,115,0
39635,38,30,0,8,5,17,0,22,0,8,8,8,0,0,0,8,0
39638,1446,1005,235,372,293,105,276,397,176,156,441,28,114,198,101,406,35
39641,1563,1185,216,548,330,91,416,508,134,127,378,72,74,144,88,364,14
39643,479,405,93,180,111,21,136,167,46,56,74,5,33,24,12,67,7
39645,1991,1445,240,617,439,149,412,658,153,222,546,67,108,200,171,520,26
39647,531,407,98,185,85,39,152,216,11,28,124,5,8,60,51,117,7
39648,8279,5770,1312,2679,1322,457,1474,2044,1375,877,2509,373,751,695,690,2325,184
39652,2975,2203,417,1009,647,130,652,849,375,327,772,90,254,268,160,714,58
39653,1207,790,158,347,208,77,275,338,106,71,417,25,93,156,143,406,11
39654,2142,1600,337,742,420,101,508,636,260,196,542,61,167,203,111,512,30
39656,357,272,23,132,102,15,45,134,62,31,85,9,28,26,22,77,8
39657,952,708,120,328,226,34,202,304,97,105,244,36,72,94,42,215,29
39661,1120,883,173,445,227,38,302,347,120,114,237,13,105,66,53,230,7
39662,307,283,48,119,116,0,101,147,9,26,24,0,24,0,0,16,8
39663,1246,940,230,410,223,77,288,374,165,113,306,41,97,106,62,291,15
39664,861,676,100,332,197,47,212,386,45,33,185,18,61,60,46,161,24
39665,412,313,74,163,57,19,136,134,16,27,99,22,17,38,22,88,11
39666,3656,2732,468,1292,812,160,855,1251,324,302,924,99,308,331,186,862,62
39667,4494,3292,724,1448,886,234,1089,1323,538,342,1202,111,353,455,283,1109,93
39668,269,209,11,125,56,17,87,58,32,32,60,19,35,0,6,60,0
39669,2163,1536,221,717,415,183,351,518,339,328,627,88,157,214,168,573,54
39701,6848,4689,1063,2179,1068,379,1148,1424,1215,902,2159,455,726,590,388,1900,259
39702,8111,6241,1681,3063,1267,230,2218,2325,1193,505,1870,211,620,612,427,1750,120
39704,50,45,18,22,2,3,15,19,9,2,5,0,0,3,2,5,0
39705,5812,4049,1233,1821,850,145,1593,1709,486,261,1763,584,667,324,188,1466,297
39730,4777,3528,784,1625,966,153,991,1226,759,552,1249,219,321,383,326,1125,124
39735,2134,1465,375,648,370,72,490,567,257,151,669,63,200,198,208,621,48
39736,65,51,12,25,13,1,13,11,11,16,14,0,2,7,5,14,0
39739,888,682,143,306,205,28,150,222,173,137,206,24,71,47,64,194,12
39740,534,393,84,220,56,33,153,168,29,43,141,16,19,67,39,139,2
39741,612,485,109,216,126,34,181,192,31,81,127,8,26,59,34,119,8
39743,708,516,132,239,124,21,152,137,139,88,192,36,54,74,28,172,20
39744,2617,1858,366,814,495,183,624,826,215,193,759,94,150,280,235,704,55
39745,202,154,20,70,60,4,63,72,7,12,48,2,15,24,7,40,8
39746,1278,953,267,376,260,50,367,420,93,73,325,54,72,113,86,302,23
39747,941,728,182,264,224,58,241,276,110,101,213,18,55,70,70,205,8
39750,947,704,193,278,204,29,235,272,115,82,243,50,65,90,38,186,57
39751,307,257,49,126,66,16,51,121,37,48,50,9,10,19,12,50,0
39752,708,523,116,205,145,57,185,257,48,33,185,23,59,52,51,166,19
39755,540,385,55,215,78,37,91,151,105,38,155,41,43,33,38,144,11
39756,621,453,119,215,86,33,112,142,135,64,168,18,37,49,64,159,9
39759,14643,8411,2545,3699,1658,509,2642,3249,1515,1005,6232,3650,1198,780,604,4082,2150
39762,0,0,0,0,0,0,0,0,0,0,0,0,0,0,0,0,0
39766,1036,728,151,330,219,28,256,378,41,53,308,62,130,70,46,252,56
39767,190,128,34,56,38,0,42,55,9,22,62,5,6,26,25,62,0
39769,872,653,123,276,186,68,220,268,104,61,219,35,29,89,66,201,18
39771,10,10,0,7,0,3,7,3,0,0,0,0,0,0,0,0,0
39772,915,731,115,324,215,77,189,344,95,103,184,28,40,61,55,152,32
39773,6594,4716,1101,2202,1151,262,1257,1706,1022,731,1878,243,640,515,480,1741,137
39776,797,560,101,299,146,14,187,232,88,53,237,11,51,122,53,221,16
40003,739,579,122,269,145,43,242,264,16,57,160,10,55,77,18,144,16
40004,8946,6507,1675,3316,1207,309,2494,2470,1046,497,2439,578,846,649,366,2073,366
40006,1863,1398,341,674,320,63,476,625,154,143,465,66,210,123,66,401,64
40007,122,87,34,29,24,0,34,38,10,5,35,6,5,7,17,35,0
40008,1356,1020,199,527,252,42,362,481,107,70,336,50,62,138,86,293,43
40009,500,341,76,162,73,30,131,123,40,47,159,11,47,64,37,146,13
40010,110,93,8,59,20,6,52,27,8,6,17,0,9,8,0,17,0
40011,1448,1104,225,462,330,87,352,555,118,79,344,23,144,104,73,308,36
40012,215,172,23,72,43,34,53,81,6,32,43,0,12,17,14,43,0
40013,1601,1290,200,683,336,71,421,660,130,79,311,61,141,77,32,285,26
40014,5072,4330,766,2619,882,63,2055,1751,308,216,742,121,316,217,88,637,105
40019,1402,987,249,437,241,60,254,428,188,117,415,45,139,134,97,367,48
40020,5,2,0,0,0,2,0,2,0,0,3,0,0,0,3,3,0
40022,262,205,26,137,42,0,93,100,6,6,57,13,10,20,14,44,13
40023,655,564,43,351,146,24,254,260,0,50,91,7,28,43,13,83,8
40026,1550,1351,204,896,233,18,685,525,90,51,199,22,94,65,18,179,20
40031,5342,4245,878,2258,960,149,1736,1944,353,212,1097,210,355,339,193,958,139
40033,4264,3040,601,1519,717,203,1030,1188,504,318,1224,241,313,422,248,1102,122
40036,110,80,31,32,17,0,50,17,13,0,30,0,25,0,5,22,8
40037,954,750,150,386,178,36,282,296,110,62,204,28,55,76,45,178,26
40040,244,167,26,86,46,9,60,84,21,2,77,6,15,30,26,68,9
40045,1196,857,214,388,197,58,360,392,58,47,339,42,116,103,78,282,57
40046,555,442,85,215,128,14,167,205,22,48,113,31,40,34,8,105,8
40047,4975,4039,1060,2024,838,117,1602,1778,448,211,936,223,281,287,145,790,146
40050,550,371,92,175,94,10,123,138,56,54,179,20,44,77,38,145,34
40051,1580,1152,265,561,263,63,468,444,144,96,428,89,134,139,66,381,47
40052,175,124,20,72,26,6,18,57,36,13,51,0,20,19,12,43,8
40055,353,279,49,115,88,27,102,152,12,13,74,24,9,22,19,68,6
40056,1150,908,164,465,236,43,378,408,84,38,242,44,99,61,38,195,47
40057,1237,928,185,438,237,68,327,397,108,96,309,52,97,91,69,236,73
40058,34,27,0,15,11,1,12,12,0,3,7,0,1,6,0,7,0
40059,3976,3248,242,1980,903,123,1396,1515,216,121,728,69,292,259,108,640,88
40060,398,276,59,125,79,13,95,126,37,18,122,58,36,17,11,92,30
40062,165,103,49,34,20,0,37,44,18,4,62,5,36,10,11,57,5
40065,8176,5980,1577,2658,1447,298,2101,2624,736,519,2196,421,762,580,433,1822,374
40067,1238,997,160,559,236,42,366,467,122,42,241,32,115,51,43,195,46
40068,775,565,116,297,115,37,251,246,35,33,210,37,116,32,25,160,50
40069,2789,2026,357,963,531,175,706,938,228,154,763,130,172,237,224,710,53
40070,271,218,23,115,52,28,60,117,20,21,53,8,30,0,15,38,15
40071,3487,2804,689,1406,603,106,1221,1248,224,111,683,100,267,206,110,586,97
40076,888,709,136,335,194,44,213,367,99,30,179,31,84,30,34,145,34
40077,222,164,16,112,29,7,50,31,76,7,58,0,23,29,6,41,17
40078,856,638,129,330,146,33,241,310,53,34,218,40,59,57,62,185,33
40104,395,289,48,149,86,6,89,134,22,44,106,10,30,41,25,92,14
40107,737,557,133,240,161,23,243,192,55,67,180,21,80,54,25,148,32
40108,3856,2912,715,1361,752,84,1081,1303,375,153,944,128,359,286,171,821,123
40109,854,665,109,364,181,11,251,313,29,72,189,22,115,42,10,137,52
40111,741,509,101,242,133,33,126,264,58,61,232,21,72,70,69,222,10
40115,470,398,31,196,146,25,141,202,38,17,72,12,35,7,18,66,6
40117,791,631,148,331,132,20,253,271,70,37,160,31,80,33,16,135,25
40118,3592,2634,675,1168,671,120,911,986,404,333,958,208,307,305,138,748,210
40119,770,532,90,246,170,26,192,266,29,45,238,21,95,76,46,209,29
40121,2771,2667,1676,989,2,0,1913,527,215,12,104,81,23,0,0,88,16
40140,87,57,7,17,27,6,19,32,0,6,30,10,13,7,0,30,0
40142,657,539,69,306,145,19,176,266,39,58,118,12,34,22,50,101,17
40143,2051,1426,258,653,398,117,482,723,124,97,625,64,173,215,173,577,48
40144,675,522,118,251,138,15,198,261,40,23,153,3,40,71,39,134,19
40145,268,199,56,77,51,15,75,96,17,11,69,6,6,37,20,59,10
40146,1386,1046,244,450,282,70,342,496,128,80,340,40,102,156,42,320,20
40150,1967,1480,310,757,360,53,590,621,138,131,487,72,156,176,83,437,50
40152,219,169,29,70,41,29,52,103,0,14,50,13,21,8,8,50,0
40155,507,307,109,157,25,16,92,99,85,31,200,47,86,51,16,154,46
40157,501,389,69,222,56,42,147,161,57,24,112,0,22,54,36,101,11
40160,9081,6368,1653,3267,1273,175,2266,2413,1294,395,2713,667,1149,673,224,2287,426
40162,1509,1254,306,643,229,76,544,556,104,50,255,33,62,118,42,230,25
40164,52,38,0,23,15,0,7,7,16,8,14,0,0,8,6,14,0
40165,9843,7984,1914,3986,1834,250,2979,3614,892,499,1859,394,570,674,221,1550,309
40170,114,91,38,41,9,3,66,12,13,0,23,0,17,6,0,18,5
40171,108,81,27,34,20,0,27,43,7,4,27,4,5,18,0,22,5
40175,3513,2689,561,1476,529,123,1172,1045,288,184,824,121,268,364,71,676,148
40176,345,276,67,115,86,8,93,131,31,21,69,0,31,14,24,69,0
40177,636,421,114,192,105,10,122,177,60,62,215,36,76,85,18,176,39
40178,190,130,18,47,44,21,38,65,21,6,60,9,16,35,0,39,21
40202,2291,775,475,190,86,24,35,134,522,84,1516,348,516,497,155,1369,147
40203,9606,4116,1821,1596,484,215,441,696,2172,807,5490,916,1922,1352,1300,4921,569
40204,7743,3179,812,1562,620,185,804,1362,539,474,4564,1887,1488,774,415,3659,905
40205,10774,6017,827,3070,1496,624,2050,2971,471,525,4757,1355,1424,1038,940,3994,763
40206,9417,4331,929,2089,939,374,1124,1994,674,539,5086,1940,1748,922,476,4159,927
40207,14123,8193,1306,3716,2187,984,2688,4161,663,681,5930,1579,1640,1347,1364,5140,790
40208,5572,2460,763,1157,441,99,563,793,612,492,3112,1271,1036,551,254,2433,679
40209,205,113,10,53,36,14,7,59,30,17,92,18,20,36,18,92,0
40210,6425,4090,1078,1679,1081,252,530,932,1458,1170,2335,327,856,735,417,2121,214
40211,9012,6122,1457,2491,1517,657,821,1564,2071,1666,2890,339,935,1026,590,2546,344
40212,7426,5119,1231,2410,1155,323,976,1297,1631,1215,2307,267,848,873,319,1966,341
40213,7714,4878,1033,2181,1210,454,1274,1894,890,820,2836,731,850,689,566,2389,447
40214,18554,11753,3027,5199,2723,804,3549,4426,2187,1591,6801,1466,2454,1813,1068,5573,1228
40215,10390,6389,2218,2681,1047,443,1397,1789,2221,982,4001,731,1455,1061,754,3411,590
40216,16726,11210,2285,4959,3076,890,3045,5055,1799,1311,5516,859,1800,1644,1213,4845,671
40217,6079,3243,754,1456,637,396,904,1375,474,490,2836,822,943,585,486,2277,559
40218,12809,7413,2031,3358,1543,481,2029,2560,1620,1204,5396,1494,1780,1229,893,4641,755
40219,14781,10239,2470,4441,2873,455,2886,4249,1904,1200,4542,1036,1655,1196,655,3865,677
40220,14187,8759,1559,4379,2061,760,2945,4031,912,871,5428,1376,1690,1338,1024,4673,755
40222,9296,5643,1169,2351,1651,472,1911,2979,399,354,3653,1127,1045,848,633,3126,527
40223,8832,5891,901,3231,1400,359,2224,2684,582,401,2941,668,996,800,477,2519,422
40228,4202,3314,618,1554,980,162,1134,1555,314,311,888,154,290,271,173,780,108
40229,10706,8398,2477,3941,1814,166,3184,3339,1192,683,2308,604,933,606,165,1803,505
40241,9576,6969,1219,3791,1602,357,3012,3094,469,394,2607,689,966,540,412,2167,440
40242,4386,2865,503,1303,801,258,959,1438,235,233,1521,404,456,426,235,1277,244
40243,3615,2675,387,1280,836,172,994,1249,183,249,940,150,249,370,171,825,115
40245,5669,4690,959,2851,833,47,2319,1816,340,215,979,239,436,245,59,818,161
40258,9584,6895,1440,3262,1821,372,2107,2879,1060,849,2689,565,826,840,458,2190,499
40272,12871,9817,2063,4523,2662,569,3172,4218,1249,1178,3054,513,953,1018,570,2589,465
40291,10694,7984,1568,4296,1795,325,3083,3637,749,515,2710,892,914,602,302,2117,593
40299,12189,9016,1897,4501,2180,438,3501,4071,811,633,3173,720,1192,812,449,2706,467
40310,134,97,26,35,30,6,35,36,16,10,37,6,10,10,11,33,4
40311,2711,1939,445,822,513,159,678,837,197,227,772,87,219,262,204,681,91
40312,2169,1636,427,710,406,93,592,725,203,116,533,91,182,208,52,473,60
40313,942,593,154,279,115,45,178,229,86,100,349,133,78,114,24,304,45
40316,172,141,26,83,32,0,50,73,6,12,31,12,14,5,0,31,0
40322,1215,934,217,436,229,52,296,478,99,61,281,47,76,95,63,250,31
40324,10352,7691,2196,3754,1452,289,3113,3047,946,585,2661,820,907,553,381,2214,447
40328,502,395,83,185,112,15,141,204,22,28,107,13,24,61,9,87,20
40330,7702,5537,1214,2524,1441,358,1866,2620,595,456,2165,298,543,779,545,1948,217
40334,32,10,0,10,0,0,0,5,5,0,22,0,15,7,0,15,7
40336,5549,4017,1101,1619,1006,291,1343,1726,528,420,1532,176,524,514,318,1400,132
40337,1723,1351,360,599,319,73,534,628,102,87,372,86,100,124,62,309,63
40339,33,16,0,10,6,0,10,6,0,0,17,0,6,11,0,17,0
40342,7167,5472,1316,2664,1233,259,2127,2431,545,369,1695,288,603,346,458,1449,246
40346,441,324,76,174,74,0,113,157,44,10,117,6,26,65,20,100,17
40347,988,689,125,351,173,40,242,333,64,50,299,61,93,66,79,254,45
40348,386,267,68,109,66,24,74,128,40,25,119,22,21,41,35,107,12
40350,123,114,20,71,23,0,21,69,0,24,9,0,0,0,9,9,0
40351,7142,4784,1184,2085,1239,276,1784,2129,473,398,2358,759,547,687,365,1877,481
40353,7116,5058,1257,2278,1214,309,1639,2305,686,428,2058,312,601,631,514,1805,253
40355,31,26,4,12,5,5,6,10,6,4,5,0,0,5,0,5,0
40356,11462,8918,2341,4365,1782,430,3406,3731,1111,670,2544,520,874,727,423,2071,473
40358,280,223,38,107,57,21,58,123,24,18,57,16,12,22,7,57,0
40359,2739,1935,397,887,501,150,680,927,185,143,804,112,221,258,213,700,104
40360,2430,1762,436,774,414,138,653,735,216,158,668,107,217,168,176,614,54
40361,6962,4951,1050,2329,1236,336,1594,2188,738,431,2011,318,612,656,425,1723,288
40363,88,58,10,15,27,6,16,42,0,0,30,7,7,16,0,30,0
40370,1065,829,144,445,210,30,329,425,55,20,236,55,81,64,36,174,62
40371,1050,741,175,334,201,31,252,388,60,41,309,67,66,143,33,273,36
40372,789,633,114,315,190,14,228,348,20,37,156,0,48,56,52,151,5
40374,742,525,125,216,151,33,201,264,28,32,217,14,74,63,66,197,20
40376,29,19,0,8,11,0,8,11,0,0,10,0,10,0,0,0,10
40379,1059,819,153,444,183,39,316,370,60,73,240,47,64,70,59,206,34
40380,2843,2124,518,1009,532,65,749,917,292,166,719,112,232,245,130,638,81
40383,7843,5954,1215,3085,1400,254,2252,2630,577,495,1889,354,744,474,317,1609,280
40385,1131,887,187,365,300,35,276,515,59,37,244,30,81,78,55,234,10
40387,716,500,95,196,181,28,193,242,42,23,216,21,92,82,21,183,33
40390,2187,1652,575,690,320,67,732,726,116,78,535,199,149,74,113,450,85
40391,12949,9459,2098,4549,2183,629,3278,4235,1133,813,3490,536,1151,1202,601,2951,539
40402,1109,822,224,364,188,46,335,359,60,68,287,42,77,102,66,268,19
40403,7826,5677,1532,2736,1198,211,2183,2425,695,374,2149,514,601,660,374,1846,303
40409,1428,1037,313,429,273,22,318,539,117,63,391,55,109,117,110,370,21
40419,1740,1292,329,574,303,86,503,582,105,102,448,79,112,159,98,394,54
40422,8758,6032,1281,2737,1638,376,2021,2735,741,535,2726,463,761,910,592,2406,320
40437,1601,1177,238,490,381,68,366,618,83,110,424,60,127,143,94,371,53
40440,799,606,192,262,139,13,194,236,113,63,193,21,77,63,32,171,22
40442,411,296,59,140,60,37,131,131,7,27,115,20,23,16,56,115,0
40444,4880,3676,846,1699,916,215,1262,1763,441,210,1204,173,340,387,304,1036,168
40445,470,355,69,174,78,34,134,137,29,55,115,11,32,42,30,107,8
40447,3308,2397,642,1029,578,148,887,985,321,204,911,174,322,274,141,816,95
40448,27,16,0,12,4,0,5,11,0,0,11,0,0,6,5,11,0
40456,3710,2646,649,1149,730,118,874,1212,335,225,1064,158,315,349,242,961,103
40460,243,181,29,91,55,6,45,98,28,10,62,6,15,26,15,56,6
40461,838,689,114,331,218,26,214,417,19,39,149,48,23,21,57,136,13
40464,445,309,70,122,77,40,101,155,17,36,136,17,46,22,51,118,18
40468,611,417,88,188,114,27,133,212,25,47,194,13,32,85,64,184,10
40472,547,434,78,190,111,55,94,254,53,33,113,2,30,46,35,109,4
40475,18515,11941,3510,5304,2609,518,4117,5207,1541,1076,6574,3028,1505,1286,755,4838,1736
40481,84,61,33,10,13,5,26,30,0,5,23,0,10,13,0,23,0
40484,4405,3293,891,1526,725,151,1170,1457,414,252,1112,156,310,404,242,1005,107
40486,839,682,194,273,182,33,242,308,72,60,157,20,23,61,53,149,8
40488,85,73,18,38,17,0,34,34,5,0,12,12,0,0,0,12,0
40489,1867,1384,310,615,376,83,488,683,117,96,483,56,78,253,96,424,59
40502,12868,6817,1190,3126,1939,562,1971,3611,665,570,6051,2502,1611,960,978,4846,1205
40503,11575,7297,1468,3454,1806,569,2561,3466,578,692,4278,1425,1273,848,732,3349,929
40504,10976,5708,1697,2243,1285,483,1398,2473,1095,742,5268,1865,1643,1047,713,4131,1137
40505,11153,7179,1621,3134,1901,523,1882,3260,1068,969,3974,825,1571,1064,514,3253,721
40507,1053,157,31,90,36,0,10,75,33,39,896,264,277,201,154,798,98
40508,9810,3963,1403,1587,732,241,741,1192,1193,837,5847,3105,1383,970,389,4083,1764
40509,8877,5372,2042,2399,742,189,1923,2474,619,356,3505,1604,1119,447,335,2650,855
40510,335,241,6,108,101,26,53,161,21,6,94,10,19,45,20,77,17
40511,6526,4263,996,1841,1202,224,966,1956,799,542,2263,595,840,596,232,1867,396
40513,3166,2380,269,1444,582,85,1117,1014,135,114,786,283,310,122,71,663,123
40514,3900,3294,642,2152,445,55,1859,1106,199,130,606,138,295,123,50,499,107
40515,11525,7833,2072,4617,1045,99,3510,3014,909,400,3692,1741,1385,429,137,2754,938
40516,924,694,174,292,203,25,291,310,61,32,230,49,88,78,15,188,42
40517,16029,8676,3231,3773,1391,281,2792,3328,1772,784,7353,3876,1934,1060,483,5208,2145
40601,20186,13096,2954,6256,3150,736,4232,5967,1762,1135,7090,1478,2412,1886,1314,6106,984
40701,10757,7670,1873,3347,1961,489,2643,3435,956,636,3087,502,861,1077,647,2792,295
40729,2073,1561,393,670,434,64,578,694,153,136,512,90,153,114,155,448,64
40730,119,87,17,49,7,14,26,33,21,7,32,0,0,32,0,32,0
40734,1606,1206,265,537,321,83,399,542,136,129,400,17,173,98,112,368,32
40737,316,261,68,117,66,10,130,110,21,0,55,0,14,32,9,38,17
40740,810,628,149,341,119,19,271,234,80,43,182,49,50,52,31,164,18
40741,7674,5737,1397,2661,1399,280,2163,2576,511,487,1937,266,562,616,493,1769,168
40744,6391,4968,1388,2282,1081,217,1851,2242,538,337,1423,209,543,494,177,1269,154
40759,924,753,236,291,169,57,291,325,86,51,171,29,22,92,28,153,18
40763,239,185,79,49,35,22,76,50,34,25,54,0,11,34,9,40,14
40769,7005,4960,1265,2166,1209,320,1631,2040,733,556,2045,303,553,738,451,1851,194
40771,689,543,169,183,150,41,228,226,22,67,146,46,43,28,29,118,28
40801,78,55,18,11,20,6,20,35,0,0,23,0,3,20,0,20,3
40803,63,58,8,32,8,10,9,21,8,20,5,0,5,0,0,5,0
40806,1474,1103,239,546,258,60,395,486,78,144,371,58,93,149,71,334,37
40807,147,94,2,64,17,11,28,54,0,12,53,0,6,19,28,53,0
40808,95,65,20,27,11,7,32,24,9,0,30,0,16,14,0,30,0
40810,581,446,118,199,115,14,130,202,74,40,135,16,16,53,50,118,17
40813,265,177,27,92,37,21,50,92,16,19,88,15,23,34,16,85,3
40815,608,431,82,257,82,10,162,127,87,55,177,12,40,95,30,162,15
40816,22,7,0,7,0,0,0,0,0,7,15,0,6,9,0,15,0
40818,165,133,26,76,28,3,56,51,4,22,32,6,10,9,7,28,4
40819,300,197,40,114,29,14,72,74,26,25,103,10,44,26,23,93,10
40820,233,169,46,64,48,11,71,66,0,32,64,0,21,31,12,58,6
40823,1827,1298,326,577,333,62,395,595,192,116,529,54,126,195,154,503,26
40824,163,117,29,69,8,11,40,38,24,15,46,9,19,13,5,37,9
40826,455,345,80,172,82,11,111,171,27,36,110,0,36,31,43,96,14
40827,450,398,84,188,126,0,155,166,50,27,52,10,20,6,16,52,0
40828,1995,1488,321,734,344,89,489,570,223,206,507,49,139,195,124,445,62
40830,118,60,17,24,9,10,20,25,15,0,58,6,0,30,22,50,8
40831,2265,1472,216,767,372,117,462,708,135,167,793,86,212,313,182,754,39
40840,282,234,44,107,62,21,57,127,15,35,48,7,11,14,16,48,0
40843,102,68,9,25,27,7,20,34,0,14,34,0,21,6,7,34,0
40844,100,58,0,26,32,0,0,37,7,14,42,0,10,24,8,42,0
40845,270,191,37,64,80,10,45,92,14,40,79,9,19,35,16,79,0
40847,94,88,31,12,33,12,31,45,0,12,6,0,6,0,0,6,0
40849,36,18,6,12,0,0,6,12,0,0,18,11,7,0,0,18,0
40854,456,309,57,125,92,35,89,161,26,33,147,31,34,45,37,145,2
40855,444,256,41,116,73,26,64,113,42,37,188,17,52,67,52,184,4
40856,264,196,50,98,37,11,76,100,0,20,68,6,32,20,10,62,6
40858,124,75,38,30,7,0,13,31,31,0,49,9,17,14,9,49,0
40862,192,160,29,64,61,6,58,65,22,15,32,18,6,8,0,32,0
40863,230,176,40,96,33,7,44,83,13,36,54,0,11,31,12,54,0
40865,91,74,5,55,8,6,36,26,6,6,17,0,0,10,7,17,0
40867,165,121,46,30,45,0,43,66,0,12,44,22,2,13,7,42,2
40868,366,266,97,111,44,14,90,82,80,14,100,0,27,55,18,94,6
40870,204,145,20,109,16,0,45,52,24,24,59,6,15,12,26,59,0
40873,1225,905,203,423,198,81,371,353,71,110,320,38,88,113,81,300,20
40874,166,126,45,40,34,7,59,20,17,30,40,5,25,10,0,40,0
40902,446,355,82,183,84,6,138,163,22,32,91,8,33,31,19,82,9
40903,336,246,80,66,92,8,71,116,46,13,90,37,13,35,5,65,25
40906,4021,2784,753,1200,697,134,932,1124,409,319,1237,160,319,422,336,1133,104
40913,153,98,20,20,51,7,22,58,18,0,55,5,16,34,0,55,0
40914,248,164,28,96,34,6,68,66,13,17,84,25,40,12,7,77,7
40915,365,262,74,105,75,8,97,122,28,15,103,23,44,31,5,70,33
40921,76,49,18,13,12,6,24,15,0,10,27,10,13,0,4,13,14
40923,363,268,60,149,27,32,117,121,10,20,95,9,31,32,23,75,20
40927,257,178,55,61,54,8,73,98,5,2,79,24,24,11,20,72,7
40930,37,23,0,15,8,0,15,8,0,0,14,0,8,6,0,14,0
40935,1028,804,211,383,155,55,324,323,81,76,224,20,27,119,58,196,28
40940,266,188,40,70,63,15,61,82,16,29,78,8,27,32,11,78,0
40941,91,84,18,45,21,0,59,16,9,0,7,0,0,7,0,7,0
40943,530,450,87,208,114,41,141,200,67,42,80,7,33,14,26,80,0
40946,43,24,0,10,14,0,10,7,0,7,19,0,10,9,0,19,0
40949,149,86,22,30,34,0,36,42,8,0,63,0,27,36,0,63,0
40953,255,201,75,84,29,13,72,88,28,13,54,0,11,33,10,54,0
40958,137,110,31,55,18,6,58,22,6,24,27,13,0,7,7,27,0
40962,7238,5499,1342,2436,1345,376,2129,2088,604,678,1739,242,520,705,272,1566,173
40965,5900,4044,1074,1649,1015,306,1100,1623,715,606,1856,236,571,674,375,1727,129
40972,830,598,129,304,116,49,249,271,62,16,232,34,83,69,46,211,21
40977,4241,3169,752,1486,747,184,1097,1335,418,319,1072,91,298,439,244,1010,62
40979,36,36,8,19,9,0,18,14,4,0,0,0,0,0,0,0,0
40982,279,182,73,84,11,14,95,46,19,22,97,32,24,32,9,97,0
40983,104,73,13,18,14,28,6,24,14,29,31,0,9,22,0,23,8
40988,311,202,41,87,63,11,57,102,31,12,109,18,25,42,24,105,4
40995,136,100,17,64,19,0,34,55,0,11,36,15,5,16,0,36,0
40997,134,97,30,52,15,0,62,14,16,5,37,6,4,27,0,33,4
40999,255,195,81,55,56,3,90,49,41,15,60,0,14,39,7,60,0
41001,5870,4711,992,2438,1076,205,2052,2038,364,257,1159,215,441,293,210,1058,101
41002,916,666,171,287,171,37,233,286,93,54,250,34,67,76,73,225,25
41003,994,751,206,326,158,61,276,338,73,64,243,49,89,73,32,215,28
41004,1645,1197,232,557,338,70,388,561,136,112,448,82,126,119,121,397,51
41005,5599,4422,1128,2394,818,82,2092,1723,323,284,1177,372,381,288,136,965,212
41006,1720,1435,343,684,361,47,700,554,111,70,285,50,88,95,52,239,46
41007,901,744,103,411,194,36,326,345,49,24,157,23,82,43,9,135,22
41008,2865,1991,530,830,517,114,637,850,313,191,874,137,285,248,204,763,111
41010,1164,952,180,502,221,49,376,412,84,80,212,33,70,64,45,212,0
41011,12930,6540,1703,2828,1591,418,1669,2470,1444,957,6390,1765,2148,1421,1056,5286,1104
41014,3159,1825,534,744,419,128,487,570,402,366,1334,340,529,319,146,1123,211
41015,8015,5495,1380,2512,1251,352,2027,2165,701,602,2520,513,903,634,470,2109,411
41016,2391,1533,397,736,335,65,501,531,294,207,858,182,237,271,168,723,135
41017,14851,10574,2021,5679,2371,503,4540,4388,918,728,4277,1269,1394,963,651,3566,711
41018,10243,7054,1958,3311,1474,311,2794,2608,946,706,3189,956,1046,733,454,2631,558
41030,2084,1685,488,847,297,53,712,642,205,126,399,98,156,104,41,297,102
41031,5848,4158,1006,1902,1025,225,1536,1835,482,305,1690,211,469,482,528,1472,218
41033,734,575,126,330,102,17,238,233,48,56,159,38,24,61,36,146,13
41034,384,298,57,172,51,18,96,151,37,14,86,5,34,17,30,77,9
41035,3416,2632,748,1178,590,116,1003,1007,426,196,784,143,293,205,143,633,151
41039,950,725,150,338,203,34,297,309,70,49,225,36,70,58,61,189,36
41040,2610,1936,429,952,450,105,730,847,235,124,674,110,186,248,130,600,74
41041,2795,2016,499,852,524,141,723,894,229,170,779,131,192,273,183,707,72
41042,16110,11149,3107,5430,2280,332,4435,4361,1453,900,4961,1275,1606,1348,732,4063,898
41043,558,415,98,194,106,17,168,208,18,21,143,23,43,27,50,114,29
41044,273,199,39,91,49,20,83,90,11,15,74,6,11,33,24,70,4
41045,412,308,42,202,55,9,146,85,53,24,104,35,29,25,15,81,23
41046,464,348,115,159,68,6,142,153,37,16,116,10,38,54,14,112,4
41048,2578,2233,564,1182,420,67,1049,821,235,128,345,86,131,77,51,281,64
41049,799,566,177,237,109,43,219,234,61,52,233,31,59,94,49,197,36
41051,6057,4991,1217,2607,993,174,2013,1918,592,468,1066,251,368,314,133,844,222
41052,46,38,16,22,0,0,24,7,0,7,8,0,8,0,0,8,0
41055,631,490,89,224,123,54,205,204,25,56,141,15,48,37,41,129,12
41056,5715,3882,909,1736,970,267,1335,1673,444,430,1833,262,563,614,394,1648,185
41059,904,670,94,355,189,32,226,392,12,40,234,57,97,44,36,209,25
41063,1340,1046,190,601,210,45,517,429,51,49,294,62,82,87,63,201,93
41064,846,602,105,264,190,43,193,294,68,47,244,31,72,76,65,215,29
41071,9253,5445,1705,2391,1099,250,1567,1782,1165,931,3808,896,1357,1020,535,3245,563
41073,2658,1615,440,662,355,158,571,551,281,212,1043,239,345,241,218,894,149
41074,2099,1441,438,613,318,72,415,541,323,162,658,106,220,228,104,542,116
41075,7100,4574,834,2281,1107,352,1846,1921,455,352,2526,781,630,591,524,2186,340
41076,5619,3764,682,1786,1084,212,1216,1822,371,355,1855,526,455,503,371,1581,274
41080,544,437,56,271,103,7,189,217,5,26,107,25,46,24,12,95,12
41083,393,286,78,114,81,13,98,112,42,34,107,25,50,14,18,85,22
41085,287,211,64,96,44,7,88,72,31,20,76,17,18,31,10,73,3
41086,850,726,159,407,124,36,335,304,56,31,124,29,23,38,34,101,23
41091,3748,3210,508,1934,712,56,1641,1332,137,100,538,47,262,192,37,442,96
41092,731,572,85,286,168,33,204,317,18,33,159,48,60,37,14,119,40
41093,845,663,114,377,140,32,272,297,58,36,182,19,68,68,27,161,21
41094,2326,1850,378,1016,394,62,789,775,204,82,476,76,178,160,62,417,59
41095,1626,1139,306,470,293,70,380,448,153,158,487,75,164,156,92,402,85
41097,2333,1681,459,665,433,124,574,778,174,155,652,114,179,197,162,582,70
41098,666,493,100,218,141,34,164,232,53,44,173,20,107,33,13,146,27
41101,8418,5502,1214,2362,1424,502,1566,2721,748,467,2916,391,819,930,776,2701,215
41102,8193,6154,968,2994,1729,463,1782,3235,652,485,2039,267,513,796,463,1862,177
41121,545,416,106,161,140,9,198,177,24,17,129,10,55,49,15,117,12
41124,451,349,80,155,91,23,115,166,34,34,102,7,23,42,30,89,13
41129,3886,2978,524,1435,887,132,943,1569,250,216,908,127,236,337,208,818,90
41132,118,82,20,34,24,4,18,30,20,14,36,9,13,3,11,32,4
41135,134,98,47,30,21,0,34,51,9,4,36,0,4,26,6,32,4
41137,114,95,43,23,14,15,60,35,0,0,19,0,6,6,7,13,6
41139,3636,2745,519,1208,793,225,940,1308,233,264,891,122,186,415,168,821,70
41141,1050,819,248,311,189,71,351,340,65,63,231,39,64,102,26,210,21
41142,38,33,0,21,12,0,18,10,0,5,5,0,5,0,0,0,5
41143,5244,3983,988,1812,972,211,1400,1855,433,295,1261,201,269,480,311,1121,140
41144,4021,3007,682,1322,847,156,946,1500,259,302,1014,138,285,412,179,930,84
41146,226,164,60,39,51,14,66,78,16,4,62,0,16,21,25,62,0
41149,231,166,45,69,52,0,80,75,6,5,65,0,12,39,14,65,0
41159,228,197,73,76,42,6,101,76,10,10,31,0,0,22,9,31,0
41164,5025,3756,815,1692,995,254,1374,1703,297,382,1269,180,312,511,266,1115,154
41166,263,220,26,93,83,18,69,115,11,25,43,0,7,28,8,43,0
41168,1010,778,217,367,151,43,345,338,60,35,232,22,47,134,29,195,37
41169,1874,1448,230,651,426,141,436,780,125,107,426,69,107,139,111,391,35
41170,72,43,12,26,5,0,19,8,11,5,29,0,0,14,15,22,7
41171,1508,1050,230,481,267,72,320,494,135,101,458,64,109,206,79,445,13
41174,309,234,31,116,63,24,68,137,6,23,75,12,15,42,6,70,5
41175,2338,1812,482,773,459,98,732,804,165,111,526,37,105,222,162,503,23
41179,3123,2342,626,1056,567,93,826,1038,284,194,781,71,256,276,178,701,80
41180,437,329,59,138,90,42,120,157,29,23,108,8,45,49,6,85,23
41183,694,536,81,255,162,38,171,266,48,51,158,2,46,71,39,144,14
41189,869,635,117,285,176,57,197,340,61,37,234,35,52,98,49,203,31
41201,66,45,0,18,15,12,8,32,0,5,21,17,0,4,0,21,0
41203,234,154,41,78,35,0,77,64,13,0,80,9,38,18,15,80,0
41204,321,258,56,127,62,13,94,134,14,16,63,5,19,18,21,58,5
41214,248,189,47,85,47,10,48,98,13,30,59,7,9,23,20,52,7
41216,440,355,120,127,95,13,132,177,46,0,85,0,24,51,10,85,0
41219,748,603,110,257,187,49,234,266,23,80,145,13,43,28,61,133,12
41222,718,544,111,265,135,33,218,258,33,35,174,7,78,67,22,160,14
41224,1978,1495,273,774,394,54,605,619,177,94,483,52,174,156,101,441,42
41226,112,86,45,25,16,0,32,40,14,0,26,0,8,0,18,26,0
41228,273,207,42,113,36,16,96,70,13,28,66,18,21,17,10,57,9
41230,4350,3267,711,1504,875,177,1233,1415,291,328,1083,176,275,370,262,990,93
41231,736,587,154,265,143,25,226,225,77,59,149,32,47,35,35,127,22
41232,195,164,27,65,46,26,45,105,0,14,31,11,11,5,4,20,11
41234,37,31,9,17,5,0,13,18,0,0,6,6,0,0,0,6,0
41238,345,293,81,105,101,6,96,162,21,14,52,0,31,21,0,45,7
41240,2827,2000,379,975,470,176,663,864,288,185,827,105,235,343,144,772,55
41250,337,273,55,153,54,11,131,88,21,33,64,0,22,30,12,57,7
41254,250,198,19,135,38,6,85,88,15,10,52,11,16,12,13,38,14
41255,362,250,69,125,49,7,103,89,39,19,112,19,28,41,24,101,11
41256,959,728,173,301,207,47,252,367,61,48,231,36,66,78,51,224,7
41257,80,56,14,22,20,0,27,29,0,0,24,0,0,17,7,24,0
41260,342,255,83,118,43,11,93,139,23,0,87,20,33,24,10,87,0
41262,553,429,111,252,50,16,159,173,83,14,124,36,31,42,15,116,8
41263,153,121,42,40,35,4,55,45,10,11,32,8,12,12,0,32,0
41264,250,194,38,99,48,9,97,89,0,8,56,16,0,36,4,56,0
41265,792,635,127,330,127,51,175,333,85,42,157,28,55,69,5,132,25
41267,531,390,131,139,76,44,100,148,87,55,141,25,57,48,11,134,7
41268,164,125,15,59,37,14,41,65,13,6,39,0,20,13,6,39,0
41274,271,202,79,72,37,14,54,76,50,22,69,29,16,15,9,61,8
41301,2298,1590,375,777,366,72,596,617,217,160,708,123,244,230,111,671,37
41310,19,19,12,7,0,0,7,12,0,0,0,0,0,0,0,0,0
41311,2704,1952,411,921,485,135,616,926,250,160,752,61,191,273,227,710,42
41314,1806,1314,215,625,359,115,427,571,160,156,492,33,124,223,112,457,35
41317,189,138,25,61,28,24,46,58,21,13,51,18,14,19,0,44,7
41332,948,763,174,349,196,44,276,363,82,42,185,24,34,73,54,168,17
41339,4802,3505,760,1666,871,208,1212,1444,435,414,1297,224,333,540,200,1183,114
41344,150,115,41,34,34,6,31,35,25,24,35,11,14,10,0,31,4
41348,588,423,87,216,97,23,120,198,45,60,165,32,44,59,30,151,14
41360,190,152,25,79,42,6,56,54,14,28,38,0,11,21,6,38,0
41364,153,109,50,38,21,0,16,45,42,6,44,0,4,40,0,34,10
41365,242,187,32,92,63,0,47,93,19,28,55,0,17,24,14,55,0
41367,101,75,30,24,8,13,16,26,19,14,26,0,20,0,6,26,0
41377,45,45,8,23,5,9,14,20,5,6,0,0,0,0,0,0,0
41385,162,129,36,39,54,0,39,63,0,27,33,5,9,8,11,28,5
41386,18,18,0,12,6,0,12,6,0,0,0,0,0,0,0,0,0
41390,31,31,7,15,5,4,6,4,7,14,0,0,0,0,0,0,0
41397,105,61,21,17,23,0,27,34,0,0,44,15,18,11,0,34,10
41408,70,49,16,26,0,7,17,25,0,7,21,0,0,21,0,21,0
41421,48,48,24,24,0,0,17,26,5,0,0,0,0,0,0,0,0
41425,555,420,152,195,56,17,217,173,17,13,135,26,22,60,27,123,12
41426,33,28,13,0,6,9,13,15,0,0,5,0,5,0,0,5,0
41464,31,31,0,23,0,8,9,13,4,5,0,0,0,0,0,0,0
41465,4798,3671,1000,1707,804,160,1455,1450,403,363,1127,160,341,400,226,1047,80
41472,3571,2649,595,1244,645,165,932,1257,274,186,922,135,219,393,175,818,104
41501,9891,7014,1777,3251,1569,417,2480,2950,893,691,2877,399,913,1049,516,2642,235
41503,307,205,43,79,83,0,43,106,26,30,102,9,11,55,27,102,0
41512,431,315,65,149,91,10,135,141,21,18,116,11,33,46,26,106,10
41513,315,265,51,91,92,31,80,142,12,31,50,0,5,25,20,50,0
41514,1422,1104,242,538,232,92,360,527,113,104,318,27,121,129,41,307,11
41519,164,119,49,49,12,9,63,40,16,0,45,8,7,26,4,37,8
41522,2518,1873,416,889,470,98,630,844,210,189,645,81,182,241,141,586,59
41524,105,74,23,36,7,8,31,30,13,0,31,6,14,6,5,24,7
41527,349,266,34,148,54,30,98,136,0,32,83,21,5,37,20,67,16
41528,338,259,44,126,71,18,97,111,23,28,79,0,30,44,5,79,0
41531,643,441,117,243,61,20,188,169,47,37,202,31,63,80,28,195,7
41534,54,39,0,24,8,7,8,24,0,7,15,0,0,10,5,15,0
41535,270,221,53,77,83,8,80,122,14,5,49,0,7,19,23,49,0
41537,1939,1423,270,678,362,113,417,713,172,121,516,56,141,206,113,483,33
41538,99,71,9,32,19,11,28,38,5,0,28,8,0,20,0,28,0
41539,871,639,209,295,124,11,293,285,31,30,232,42,35,108,47,227,5
41540,101,79,22,42,7,8,45,34,0,0,22,0,14,8,0,15,7
41543,197,129,8,46,53,22,34,72,6,17,68,0,20,33,15,62,6
41544,227,187,46,78,63,0,78,75,8,26,40,5,12,18,5,29,11
41546,159,129,22,46,48,13,36,57,8,28,30,6,8,11,5,24,6
41547,98,83,9,29,45,0,32,37,0,14,15,7,0,0,8,15,0
41548,544,460,111,189,155,5,178,185,58,39,84,12,31,20,21,72,12
41549,19,13,13,0,0,0,0,0,13,0,6,0,0,6,0,6,0
41553,1383,993,268,465,202,58,322,452,141,78,390,56,121,150,63,348,42
41554,504,362,68,229,65,0,138,156,22,46,142,0,31,71,40,135,7
41555,82,60,18,28,0,14,18,7,15,20,22,0,0,11,11,22,0
41557,538,429,47,243,117,22,134,244,31,20,109,0,45,52,12,109,0
41558,431,368,113,186,56,13,133,128,56,51,63,13,7,28,15,56,7
41559,264,187,47,101,33,6,78,91,18,0,77,6,32,32,7,70,7
41560,80,50,17,27,6,0,23,15,5,7,30,0,6,24,0,30,0
41562,1097,838,213,396,204,25,320,339,102,77,259,41,65,116,37,242,17
41563,211,182,40,117,25,0,40,63,51,28,29,0,22,0,7,29,0
41564,588,443,91,229,92,31,170,176,63,34,145,30,32,55,28,136,9
41566,252,206,59,72,75,0,82,84,17,23,46,10,20,8,8,46,0
41567,280,190,31,91,68,0,68,81,25,16,90,6,24,23,37,77,13
41568,291,228,67,127,34,0,107,57,35,29,63,15,25,15,8,63,0
41569,31,13,0,8,5,0,8,5,0,0,18,0,0,18,0,18,0
41571,216,180,45,81,54,0,80,58,22,20,36,0,18,10,8,36,0
41572,1596,1206,359,491,269,87,452,538,71,145,390,61,115,132,82,347,43
41601,338,240,43,107,68,22,75,117,20,28,98,6,30,34,28,93,5
41602,310,211,41,57,96,17,44,121,22,24,99,0,18,26,55,99,0
41603,117,84,5,44,27,8,10,58,10,6,33,7,6,7,13,33,0
41604,120,95,9,51,35,0,30,34,5,26,25,0,17,8,0,25,0
41605,305,216,39,95,82,0,107,95,0,14,89,8,32,34,15,89,0
41606,282,242,43,125,64,10,87,92,28,35,40,0,10,17,13,40,0
41607,182,111,26,63,22,0,52,32,27,0,71,7,42,16,6,60,11
41612,69,66,26,21,13,6,22,19,25,0,3,0,0,3,0,3,0
41615,436,361,84,207,70,0,192,143,8,18,75,17,23,23,12,75,0
41616,177,125,32,58,35,0,63,48,14,0,52,0,34,12,6,52,0
41619,205,176,8,89,41,38,53,61,23,39,29,0,7,15,7,29,0
41621,90,84,32,16,26,10,33,13,15,23,6,0,0,6,0,6,0
41622,41,23,0,0,14,9,0,16,0,7,18,0,0,0,18,18,0
41630,735,537,88,237,133,79,193,258,26,60,198,17,65,87,29,176,22
41631,411,359,137,133,70,19,154,121,50,34,52,16,10,7,19,52,0
41632,182,157,19,53,80,5,31,34,38,54,25,12,9,0,4,25,0
41635,1447,1026,240,521,202,63,316,527,113,70,421,73,137,142,69,403,18
41636,589,436,101,166,129,40,145,210,19,62,153,28,69,45,11,143,10
41640,586,445,106,229,91,19,151,196,41,57,141,21,43,43,34,128,13
41642,278,171,56,74,35,6,38,88,45,0,107,0,38,50,19,107,0
41645,847,621,158,257,139,67,210,289,50,72,226,5,37,128,56,226,0
41647,524,372,93,152,91,36,157,133,36,46,152,17,42,69,24,147,5
41649,1136,825,204,334,255,32,270,349,105,101,311,44,111,114,42,274,37
41650,334,201,43,93,45,20,83,67,18,33,133,11,31,81,10,131,2
41651,120,108,47,22,27,12,33,24,32,19,12,0,5,7,0,7,5
41653,5147,3737,975,1748,825,189,1248,1751,463,275,1410,164,540,438,268,1303,107
41655,542,368,111,176,75,6,93,210,45,20,174,17,64,48,45,162,12
41659,135,110,39,42,17,12,42,57,11,0,25,0,9,8,8,16,9
41660,386,300,91,151,48,10,124,140,21,15,86,0,28,48,10,86,0
41663,258,208,36,126,46,0,96,74,24,14,50,22,0,17,11,50,0
41666,318,232,56,103,68,5,64,120,28,20,86,0,34,32,20,79,7
41667,239,187,59,73,49,6,79,68,12,28,52,17,6,8,21,47,5
41669,291,197,53,72,54,18,57,77,33,30,94,8,31,34,21,91,3
41701,6745,4948,1170,2486,1099,193,1701,2047,672,528,1797,225,538,624,410,1677,120
41712,79,30,12,18,0,0,13,0,10,7,49,0,26,23,0,49,0
41714,154,138,30,69,35,4,47,41,23,27,16,0,4,9,3,16,0
41719,381,276,50,178,48,0,126,97,21,32,105,28,25,33,19,91,14
41721,206,167,59,60,29,19,64,87,9,7,39,11,9,11,8,37,2
41722,849,613,198,281,102,32,234,268,40,71,236,4,65,116,51,214,22
41723,662,500,120,247,117,16,152,257,64,27,162,8,7,91,56,145,17
41725,10,5,5,0,0,0,0,5,0,0,5,0,0,5,0,5,0
41727,169,149,33,77,33,6,40,71,3,35,20,11,0,9,0,20,0
41729,45,6,0,6,0,0,0,0,6,0,39,8,8,16,7,39,0
41730,86,70,8,32,30,0,24,38,0,8,16,0,0,16,0,16,0
41731,340,259,33,148,58,20,88,116,28,27,81,19,27,19,16,58,23
41735,108,98,15,61,16,6,36,36,5,21,10,5,0,5,0,10,0
41736,121,108,33,37,31,7,21,51,30,6,13,0,0,13,0,13,0
41739,50,33,0,26,7,0,13,14,0,6,17,5,7,0,5,17,0
41740,256,193,53,85,55,0,59,64,36,34,63,13,22,10,18,51,12
41745,119,92,24,36,31,1,30,45,2,15,27,6,2,11,8,27,0
41746,184,161,29,77,41,14,57,61,15,28,23,0,7,16,0,23,0
41749,1313,940,237,444,229,30,396,398,76,70,373,22,107,144,100,329,44
41751,85,62,13,14,30,5,10,40,7,5,23,0,8,8,7,23,0
41754,101,93,29,39,12,13,52,25,0,16,8,0,0,0,8,8,0
41759,240,196,55,71,51,19,61,81,22,32,44,0,18,16,10,44,0
41760,53,19,0,19,0,0,8,8,0,3,34,0,18,10,6,28,6
41762,76,54,33,15,6,0,22,18,8,6,22,0,17,0,5,17,5
41763,239,207,44,73,56,34,62,105,8,32,32,0,19,8,5,32,0
41764,286,210,45,91,67,7,87,88,10,25,76,11,35,17,13,72,4
41766,80,67,22,28,17,0,37,23,7,0,13,8,5,0,0,8,5
41772,165,96,26,30,40,0,18,47,16,15,69,12,10,27,20,59,10
41773,783,599,124,272,187,16,211,260,76,52,184,20,61,84,19,166,18
41774,1261,1008,198,552,230,28,399,453,71,85,253,34,49,156,14,245,8
41775,66,52,0,22,0,30,15,20,0,17,14,0,0,14,0,14,0
41776,702,537,174,213,136,14,176,192,57,112,165,22,64,59,20,138,27
41777,397,296,48,172,67,9,90,161,30,15,101,11,55,15,20,94,7
41778,75,60,19,28,13,0,40,20,0,0,15,0,15,0,0,8,7
41804,237,182,37,108,32,5,89,62,12,19,55,7,12,7,29,48,7
41810,283,212,45,101,53,13,58,129,12,13,71,13,29,21,8,65,6
41812,102,71,8,53,10,0,34,27,2,8,31,12,2,12,5,31,0
41815,222,196,77,69,39,11,83,79,0,34,26,0,6,17,3,26,0
41817,88,64,22,22,13,7,22,27,15,0,24,6,12,6,0,18,6
41819,163,155,23,65,59,8,61,84,6,4,8,0,0,8,0,8,0
41821,432,326,82,165,68,11,130,148,11,37,106,5,53,29,19,105,1
41822,983,717,160,341,179,37,268,293,86,70,266,47,70,102,47,240,26
41824,441,331,75,188,50,18,106,152,68,5,110,54,10,27,19,98,12
41825,208,168,33,95,21,19,62,62,22,22,40,9,6,24,1,34,6
41826,431,315,66,122,120,7,93,167,26,29,116,30,29,36,21,106,10
41828,340,294,48,162,72,12,107,126,22,39,46,0,21,13,12,46,0
41831,461,315,100,135,59,21,130,142,36,7,146,0,70,43,33,146,0
41832,158,119,21,75,18,5,64,42,0,13,39,2,3,34,0,37,2
41833,94,76,9,53,14,0,42,34,0,0,18,0,10,0,8,18,0
41834,244,172,27,64,64,17,47,83,17,25,72,5,31,33,3,65,7
41835,378,267,49,123,77,18,93,94,55,25,111,18,30,41,22,102,9
41836,182,137,40,71,19,7,37,62,25,13,45,12,15,0,18,39,6
41837,554,430,81,232,93,24,173,170,27,60,124,4,46,56,18,119,5
41838,311,245,54,79,99,13,39,140,25,41,66,14,22,14,16,66,0
41839,379,236,77,78,75,6,66,121,37,12,143,11,52,42,38,132,11
41840,590,433,100,197,94,42,133,194,37,69,157,14,46,66,31,133,24
41843,500,383,73,184,96,30,119,205,29,30,117,29,44,29,15,117,0
41844,321,231,47,131,53,0,85,98,34,14,90,27,10,43,10,83,7
41845,172,108,20,60,11,17,24,43,6,35,64,0,9,27,28,48,16
41847,263,183,29,105,22,27,58,82,27,16,80,13,14,48,5,75,5
41849,35,26,3,14,9,0,3,21,2,0,9,0,0,9,0,9,0
41855,23,23,9,14,0,0,0,14,9,0,0,0,0,0,0,0,0
41858,3358,2430,554,1123,618,135,842,1040,273,275,928,104,258,357,209,902,26
41859,186,149,17,84,29,19,49,71,10,19,37,0,20,5,12,32,5
41861,210,153,43,75,29,6,69,40,22,22,57,4,16,6,31,53,4
41862,378,315,76,150,55,34,132,127,22,34,63,11,9,25,18,63,0
42001,12217,7888,1513,3720,2017,638,2439,3665,1081,703,4329,729,1371,1163,1066,3864,465
42003,12571,8315,1890,3725,2125,575,2501,3778,1260,776,4256,673,1345,1342,896,3789,467
42020,689,545,117,259,121,48,216,246,44,39,144,25,44,55,20,129,15
42021,767,504,109,202,137,56,157,241,67,39,263,15,77,89,82,244,19
42022,73,57,10,20,14,13,18,32,0,7,16,4,0,0,12,16,0
42023,1044,761,164,304,217,76,212,390,94,65,283,25,101,91,66,263,20
42024,661,453,119,200,90,44,192,204,43,14,208,19,61,75,53,199,9
42025,7640,5575,1001,2382,1755,437,1831,3124,342,278,2065,182,539,685,659,1904,161
42027,1059,832,201,351,247,33,275,438,77,42,227,47,44,93,43,200,27
42028,278,170,27,61,58,24,52,76,10,32,108,10,25,49,24,103,5
42029,2491,1787,332,793,531,131,568,950,187,82,704,141,236,204,123,645,59
42031,1487,1057,207,455,291,104,295,520,159,83,430,63,128,146,93,398,32
42032,131,88,17,37,26,8,21,45,10,12,43,12,13,10,8,43,0
42035,347,264,53,88,108,15,103,123,14,24,83,12,30,31,10,76,7
42036,487,346,123,127,71,25,142,134,46,24,141,45,50,32,14,104,37
42038,1731,1195,196,488,408,103,334,652,109,100,536,89,120,202,125,486,50
42039,665,448,106,226,90,26,166,193,60,29,217,34,39,86,58,217,0
42040,415,297,38,170,89,0,114,164,7,12,118,15,28,45,30,118,0
42041,2212,1465,329,598,403,135,392,716,269,88,747,54,226,249,218,703,44
42044,1333,1011,147,402,365,97,211,662,86,52,322,35,75,113,99,286,36
42045,864,672,105,270,259,38,185,405,18,64,192,37,59,44,52,138,54
42047,121,75,5,38,25,7,23,52,0,0,46,10,14,0,22,31,15
42048,848,581,154,224,160,43,195,257,92,37,267,58,66,90,53,240,27
42049,755,550,139,231,131,49,240,251,42,17,205,52,53,49,51,187,18
42050,1440,973,224,396,283,70,270,403,172,128,467,71,114,182,100,434,33
42051,1115,893,206,404,241,42,345,443,80,25,222,28,67,38,89,196,26
42053,1909,1448,282,698,382,86,514,715,158,61,461,83,133,141,104,421,40
42054,372,331,96,138,84,13,136,151,24,20,41,0,14,21,6,33,8
42055,1038,760,103,336,282,39,211,445,54,50,278,33,80,91,74,261,17
42056,760,514,110,238,155,11,197,218,61,38,246,27,50,72,97,226,20
42058,897,663,185,292,151,35,255,291,66,51,234,24,120,61,29,210,24
42060,69,43,18,19,6,0,6,19,18,0,26,0,0,21,5,26,0
42061,20,12,4,8,0,0,0,8,4,0,8,0,0,8,0,8,0
42064,3518,2469,468,1061,767,173,805,1243,250,171,1049,126,314,296,313,975,74
42066,9287,6469,1528,2671,1655,615,1958,2991,905,615,2818,308,794,840,876,2559,259
42069,316,242,50,128,52,12,99,122,4,17,74,9,29,36,0,65,9
42071,10996,6472,1332,2714,1825,601,2028,3387,579,478,4524,1815,983,866,860,3541,983
42076,405,323,41,127,133,22,66,195,35,27,82,5,16,40,21,68,14
42078,748,580,102,232,192,54,136,350,58,36,168,9,31,69,59,159,9
42079,580,431,58,236,113,24,196,188,23,24,149,37,46,24,42,131,18
42081,972,664,156,311,152,45,255,287,72,50,308,11,85,128,84,290,18
42082,762,523,90,256,147,30,169,288,30,36,239,0,78,94,67,239,0
42083,166,119,19,83,17,0,72,39,8,0,47,0,12,35,0,47,0
42084,29,19,6,5,8,0,6,13,0,0,10,0,4,0,6,4,6
42085,453,350,41,178,74,57,102,203,35,10,103,6,42,24,31,102,1
42086,1389,1069,245,487,252,85,312,540,138,79,320,36,119,122,43,259,61
42087,1042,762,152,336,233,41,257,417,50,38,280,39,79,77,85,242,38
42088,1067,809,192,335,206,76,300,379,79,51,258,36,89,62,71,232,26
42101,18202,11545,3411,5249,2462,423,3790,4644,1913,1198,6657,2516,1697,1501,943,5083,1574
42103,6283,4277,792,2161,1013,311,1600,2031,362,284,2006,596,593,456,361,1648,358
42104,8180,5735,1351,2829,1292,263,2089,2650,712,284,2445,871,690,539,345,1952,493
42120,827,641,147,320,149,25,284,256,82,19,186,54,32,53,47,168,18
42122,1149,963,222,468,240,33,448,408,47,60,186,44,64,53,25,173,13
42123,370,302,98,128,68,8,109,147,27,19,68,0,19,25,24,60,8
42127,2214,1639,371,733,436,99,512,827,168,132,575,71,124,246,134,512,63
42129,2874,2073,578,857,516,122,733,964,248,128,801,85,212,358,146,733,68
42131,17,9,0,4,5,0,4,5,0,0,8,0,0,0,8,8,0
42133,610,447,124,136,143,44,152,236,22,37,163,8,41,61,53,156,7
42134,6310,4526,1133,2035,1027,331,1539,2110,514,363,1784,194,538,656,396,1548,236
42140,541,419,72,201,116,30,152,201,27,39,122,17,27,42,36,119,3
42141,11141,7943,1799,3528,2164,452,2744,3773,858,568,3198,570,817,1041,770,2922,276
42151,81,65,18,21,17,9,32,17,7,9,16,0,16,0,0,16,0
42153,150,110,22,48,31,9,40,58,0,12,40,0,13,13,14,40,0
42154,171,134,24,33,64,13,27,82,19,6,37,6,13,12,6,37,0
42157,143,99,22,21,51,5,22,58,7,12,44,5,15,17,7,40,4
42159,337,298,67,119,74,38,93,173,19,13,39,14,2,20,3,34,5
42160,772,517,98,237,152,30,139,294,46,38,255,17,102,60,76,219,36
42164,5640,4179,994,1779,1160,246,1394,1996,469,320,1461,211,473,436,341,1346,115
42166,1092,787,142,402,170,73,251,373,73,90,305,40,84,126,55,286,19
42167,3539,2542,539,1138,666,199,823,1098,315,306,997,129,256,387,225,922,75
42170,429,310,64,174,70,2,156,121,7,26,119,29,36,27,27,111,8
42171,2361,1840,448,883,409,100,825,823,98,94,521,54,115,203,149,481,40
42202,955,716,177,313,181,45,264,326,74,52,239,22,79,81,57,235,4
42204,215,141,23,52,49,17,46,82,4,9,74,11,23,23,17,60,14
42206,1799,1394,367,633,304,90,541,560,176,117,405,42,93,137,133,359,46
42207,517,412,88,126,169,29,121,212,10,69,105,20,29,37,19,93,12
42210,1838,1290,273,602,344,71,476,576,158,80,548,42,164,241,101,496,52
42211,4909,3544,747,1428,1141,228,1095,1898,324,227,1365,132,389,484,360,1224,141
42214,118,89,13,26,45,5,30,37,5,17,29,0,6,6,17,29,0
42215,486,358,64,110,137,47,76,209,22,51,128,13,28,76,11,107,21
42217,1353,1075,219,491,304,61,412,502,92,69,278,25,65,120,68,251,27
42220,2408,1810,425,839,437,109,615,765,253,177,598,82,125,231,160,564,34
42223,3894,3832,2882,950,0,0,3140,385,301,6,62,31,31,0,0,62,0
42232,318,218,45,73,100,0,87,127,4,0,100,7,35,46,12,93,7
42234,959,706,199,292,154,61,283,230,105,88,253,46,74,84,49,217,36
42236,306,238,42,104,79,13,90,119,15,14,68,18,40,8,2,61,7
42240,15932,11067,2941,4800,2578,748,3291,4624,1931,1221,4865,835,1422,1553,1055,4334,531
42254,85,59,27,23,8,1,28,16,6,9,26,3,14,5,4,23,3
42256,2014,1485,301,690,364,130,485,771,164,65,529,69,127,206,127,463,66
42259,505,367,51,174,105,37,86,199,49,33,138,15,47,46,30,128,10
42261,4071,2933,796,1335,664,138,1130,1299,291,213,1138,163,295,424,256,1040,98
42262,2825,2052,1559,385,69,39,1151,593,277,31,773,498,224,46,5,508,265
42265,455,384,87,154,111,32,144,173,42,25,71,14,24,16,17,66,5
42266,867,639,191,275,133,40,273,253,93,20,228,27,55,72,74,204,24
42273,235,165,8,52,67,38,29,119,0,17,70,5,15,25,25,62,8
42274,601,501,79,295,107,20,255,188,28,30,100,15,60,5,20,90,10
42275,366,268,64,95,92,17,122,123,9,14,98,23,25,30,20,64,34
42276,5848,4117,976,1812,1128,201,1293,1836,597,391,1731,239,519,555,418,1548,183
42280,167,132,42,46,29,15,50,63,9,10,35,0,15,11,9,35,0
42285,82,54,23,12,15,4,16,24,7,7,28,0,7,16,5,28,0
42286,457,328,72,160,72,24,108,154,39,27,129,12,34,37,46,115,14
42287,91,78,11,25,42,0,12,53,6,7,13,0,7,6,0,13,0
42301,16444,11038,2525,4971,2749,793,3627,4925,1477,1009,5406,849,1599,1701,1257,4916,490
42303,14276,9668,2303,4448,2333,584,3571,4097,1227,773,4608,956,1518,1314,820,3975,633
42320,3064,2303,580,958,614,151,733,1088,298,184,761,63,235,229,234,682,79
42321,208,147,39,75,28,5,61,61,20,5,61,6,8,40,7,57,4
42323,305,265,54,139,72,0,99,118,24,24,40,0,0,25,15,37,3
42324,469,348,46,187,85,30,158,157,28,5,121,7,30,60,24,118,3
42325,768,597,138,274,154,31,221,284,58,34,171,40,38,46,47,151,20
42326,139,92,25,27,40,0,25,54,4,9,47,0,8,32,7,42,5
42327,1395,1023,218,464,264,77,309,555,99,60,372,51,113,119,89,337,35
42328,559,444,112,199,107,26,169,212,29,34,115,20,17,43,35,106,9
42330,4010,2864,584,1201,836,243,913,1348,345,258,1146,168,359,328,291,1031,115
42332,114,76,28,32,16,0,49,17,5,5,38,0,7,17,14,28,10
42333,330,234,55,76,62,41,80,122,19,13,96,11,21,34,30,87,9
42337,862,627,126,281,154,66,202,281,72,72,235,37,58,59,81,212,23
42338,61,54,0,46,8,0,27,22,5,0,7,0,7,0,0,7,0
42339,372,304,89,110,98,7,96,173,27,8,68,0,9,33,26,63,5
42343,760,506,113,197,164,32,164,262,38,42,254,22,77,100,55,232,22
42344,412,336,58,186,82,10,119,171,7,39,76,11,20,16,29,61,15
42345,4404,3198,575,1417,955,251,1009,1677,258,254,1206,188,226,407,385,1129,77
42347,2255,1650,391,692,432,135,618,740,193,99,605,59,150,236,160,553,52
42348,1716,1322,324,635,311,52,546,596,134,46,394,97,105,100,92,327,67
42349,621,455,52,234,143,26,130,232,42,51,166,7,47,83,29,146,20
42350,677,471,81,263,107,20,169,233,52,17,206,26,48,84,48,192,14
42351,1379,1054,283,530,186,55,409,473,101,71,325,65,89,96,75,293,32
42352,866,617,139,280,173,25,225,244,94,54,249,29,58,104,58,231,18
42354,132,103,32,40,19,12,43,37,9,14,29,9,7,8,5,27,2
42355,738,541,137,273,116,15,215,215,62,49,197,17,92,75,13,146,51
42361,163,140,31,40,42,27,53,81,0,6,23,0,0,13,10,23,0
42365,28,13,7,0,6,0,0,13,0,0,15,7,0,0,8,15,0
42366,2050,1663,301,874,431,57,675,801,127,60,387,85,94,122,86,335,52
42368,441,365,97,175,69,24,175,146,21,23,76,12,14,38,12,68,8
42369,127,99,29,38,27,5,37,42,7,13,28,0,9,17,2,26,2
42370,14,7,0,7,0,0,0,0,0,7,7,0,0,7,0,7,0
42371,165,118,40,44,21,13,50,47,12,9,47,0,20,19,8,42,5
42372,773,603,133,267,159,44,207,279,48,69,170,20,36,54,60,152,18
42374,77,54,13,18,18,5,17,18,11,8,23,11,7,2,3,19,4
42376,2240,1780,392,822,466,100,686,843,118,133,460,96,159,140,65,411,49
42378,1202,970,197,468,251,54,431,346,93,100,232,23,75,62,72,207,25
42403,13,4,4,0,0,0,0,0,4,0,9,0,0,9,0,9,0
42404,1112,848,156,392,235,65,286,453,41,68,264,27,86,85,66,234,30
42406,1013,783,160,400,171,52,307,365,71,40,230,4,116,69,41,205,25
42408,2901,2141,548,864,515,214,726,1001,229,185,760,122,166,311,161,709,51
42409,1060,792,165,379,193,55,298,397,47,50,268,24,73,105,66,253,15
42410,687,467,101,183,119,64,115,180,87,85,220,28,55,86,51,187,33
42411,713,549,108,200,171,70,187,308,16,38,164,18,43,71,32,162,2
42413,1176,962,170,492,258,42,381,491,47,43,214,34,69,59,52,184,30
42420,15232,10390,2353,4858,2568,611,3437,4649,1540,764,4842,973,1592,1355,922,4248,594
42431,10996,7482,1713,3327,1922,520,2475,3302,946,759,3514,553,1031,1177,753,3151,363
42436,114,104,11,52,41,0,45,41,6,12,10,7,3,0,0,7,3
42437,2886,2078,415,1045,498,120,758,909,244,167,808,133,208,270,197,714,94
42440,434,322,73,127,83,39,97,165,23,37,112,12,38,32,30,105,7
42441,723,563,91,289,177,6,214,290,42,17,160,16,77,37,30,149,11
42442,1393,1062,247,491,263,61,347,510,109,96,331,30,96,112,93,311,20
42444,21,9,0,9,0,0,0,9,0,0,12,0,6,0,6,12,0
42445,4726,3314,617,1403,1013,281,1015,1764,321,214,1412,177,406,412,417,1319,93
42450,1784,1278,264,557,389,68,387,541,192,158,506,64,118,195,129,482,24
42451,347,259,50,120,89,0,100,126,24,9,88,9,29,24,26,81,7
42452,832,692,136,365,174,17,351,265,34,42,140,10,60,36,34,113,27
42453,51,37,3,16,18,0,6,28,3,0,14,0,0,14,0,7,7
42455,1264,916,245,381,247,43,348,422,87,59,348,52,103,87,106,295,53
42456,495,403,89,162,110,42,151,202,25,25,92,2,37,24,29,80,12
42457,75,58,11,24,23,0,8,33,8,9,17,9,0,8,0,17,0
42458,365,286,35,133,94,24,85,201,0,0,79,38,20,15,6,74,5
42459,1875,1285,257,618,315,95,397,623,147,118,590,69,114,239,168,550,40
42461,724,545,127,237,148,33,192,216,76,61,179,39,42,66,32,163,16
42462,470,350,93,184,56,17,149,152,29,20,120,21,43,23,33,101,19
42463,65,44,6,22,14,2,8,27,7,2,21,0,14,7,0,18,3
42464,735,564,122,278,144,20,212,255,48,49,171,31,59,34,47,168,3
42501,7041,4703,1024,2054,1235,390,1397,2112,726,468,2338,385,632,778,543,2129,209
42503,7400,5517,1233,2504,1442,338,1873,2704,594,346,1883,299,614,691,279,1682,201
42516,160,121,20,62,28,11,34,69,8,10,39,6,17,9,7,39,0
42518,1204,869,221,373,226,49,276,429,106,58,335,75,87,127,46,287,48
42519,1337,969,190,376,344,59,318,452,76,123,368,47,174,93,54,311,57
42528,566,450,83,201,129,37,170,171,44,65,116,12,32,60,12,96,20
42533,181,127,42,55,23,7,46,59,13,9,54,12,11,20,11,37,17
42539,4009,2765,627,1213,753,172,952,1276,296,241,1244,186,299,456,303,1148,96
42541,252,208,58,77,51,22,80,80,29,19,44,7,23,14,0,39,5
42544,2368,1820,442,696,556,126,598,993,170,59,548,53,125,214,156,529,19
42553,1583,1231,223,582,383,43,432,632,96,71,352,83,86,103,80,299,53
42565,281,185,36,78,71,0,69,85,25,6,96,0,39,18,39,96,0
42566,217,159,26,67,48,18,59,89,5,6,58,0,24,11,23,39,19
42567,2136,1596,339,645,484,128,571,819,87,119,540,105,153,156,126,506,34
42602,3957,2681,618,1150,731,182,892,1338,285,166,1276,123,349,505,299,1154,122
42603,355,282,103,109,47,23,123,120,28,11,73,13,16,39,5,73,0
42629,2033,1392,238,616,428,110,419,728,137,108,641,103,187,239,112,582,59
42631,116,107,23,66,7,11,39,32,28,8,9,0,9,0,0,9,0
42632,12,6,0,0,6,0,0,6,0,0,6,0,0,0,6,6,0
42633,7340,5412,1333,2394,1308,377,1875,2460,623,454,1928,242,512,802,372,1760,168
42634,582,405,129,134,129,13,173,167,25,40,177,34,73,56,14,163,14
42635,1459,1014,316,372,267,59,333,402,179,100,445,104,151,117,73,404,41
42638,117,68,9,52,7,0,29,24,15,0,49,0,10,20,19,49,0
42642,4927,3442,796,1543,868,235,1162,1619,359,302,1485,140,405,592,348,1365,120
42647,1554,1221,306,539,315,61,497,514,95,115,333,38,136,135,24,283,50
42649,720,569,188,287,69,25,231,193,101,44,151,20,55,54,22,122,29
42653,1861,1295,379,527,322,67,397,540,209,149,566,72,160,212,122,545,21
42701,15214,10901,2409,5319,2584,589,4013,4775,1349,764,4313,1087,1396,1057,773,3844,469
42711,100,55,0,28,27,0,12,39,0,4,45,0,0,26,19,45,0
42712,680,501,149,193,123,36,219,225,26,31,179,12,52,52,63,152,27
42713,666,469,77,208,144,40,156,207,42,64,197,38,67,61,31,176,21
42715,189,122,16,78,28,0,59,42,9,12,67,0,17,29,21,63,4
42716,598,438,122,152,139,25,117,227,88,6,160,8,63,66,23,149,11
42717,2760,1929,378,845,615,91,583,925,227,194,831,80,235,293,223,785,46
42718,9217,6586,1376,2992,1751,467,2058,3113,811,604,2631,391,700,804,736,2344,287
42721,1458,1065,259,541,186,79,397,475,111,82,393,54,107,141,91,348,45
42722,265,191,51,62,56,22,55,114,3,19,74,7,14,42,11,67,7
42724,1433,1160,190,508,362,100,386,636,58,80,273,67,75,87,44,230,43
42726,1916,1379,273,565,445,96,403,807,91,78,537,59,171,187,120,473,64
42728,5592,3877,979,1614,1012,272,1334,1869,382,292,1715,160,509,557,489,1548,167
42729,573,416,54,175,173,14,181,213,8,14,157,28,17,82,30,147,10
42731,87,64,9,18,37,0,26,31,0,7,23,0,5,4,14,23,0
42732,676,563,111,290,136,26,182,302,53,26,113,17,34,28,34,113,0
42733,645,442,86,230,114,12,180,180,29,53,203,24,23,90,66,198,5
42740,678,558,62,335,135,26,249,235,43,31,120,53,29,18,20,109,11
42741,162,144,22,73,37,12,43,93,2,6,18,0,11,0,7,18,0
42742,61,53,10,10,26,7,10,30,0,13,8,0,0,0,8,8,0
42743,3890,2768,563,1168,799,238,883,1413,227,245,1122,110,229,430,353,1016,106
42746,728,546,104,256,172,14,205,261,48,32,182,29,54,51,48,147,35
42748,3263,2386,473,1100,634,179,788,1160,275,163,877,165,264,256,192,766,111
42749,2181,1515,310,670,422,113,454,661,222,178,666,109,199,221,137,616,50
42753,68,61,9,30,17,5,12,34,9,6,7,7,0,0,0,7,0
42754,5901,4267,1116,1759,1117,275,1431,2026,540,270,1634,223,580,515,316,1454,180
42757,1282,949,205,447,233,64,360,428,107,54,333,29,90,139,75,289,44
42759,22,22,9,6,7,0,6,7,9,0,0,0,0,0,0,0,0
42761,130,102,35,33,28,6,40,46,9,7,28,0,13,7,8,28,0
42762,84,52,8,23,14,7,23,26,0,3,32,6,6,12,8,32,0
42765,1907,1320,351,556,302,111,449,609,155,107,587,74,169,216,128,519,68
42776,779,626,129,294,172,31,221,349,39,17,153,21,46,51,35,138,15
42782,439,358,74,187,59,38,107,201,40,10,81,24,25,32,0,81,0
42784,1076,791,158,358,226,49,280,386,55,70,285,49,96,57,83,260,25
42788,83,73,8,65,0,0,33,32,0,8,10,0,0,10,0,10,0
43001,637,512,84,244,149,35,199,289,4,20,125,22,35,31,37,83,42
43002,593,387,76,182,111,18,86,251,22,28,206,22,87,97,0,175,31
43003,915,669,152,360,149,8,291,268,72,38,246,32,82,70,62,219,27
43004,3549,2442,1056,956,340,90,949,988,352,153,1107,433,428,207,39,875,232
43005,46,42,24,14,0,4,13,29,0,0,4,0,0,0,4,4,0
43006,216,187,51,85,39,12,55,99,23,10,29,4,10,6,9,27,2
43008,793,519,142,219,142,16,168,204,95,52,274,45,106,82,41,178,96
43009,643,538,97,287,137,17,205,275,46,12,105,22,24,30,29,90,15
43010,35,33,16,17,0,0,16,5,9,3,2,0,2,0,0,2,0
43011,2121,1671,372,900,351,48,727,727,139,78,450,77,139,118,116,397,53
43013,352,292,53,133,78,28,99,126,33,34,60,4,23,26,7,54,6
43014,1181,862,207,393,215,47,347,353,80,82,319,70,54,91,104,294,25
43015,13632,9794,2391,4731,2249,423,3643,4473,1125,553,3838,928,1273,996,641,3107,731
43016,7604,4732,1309,2857,484,82,2493,1641,417,181,2872,1547,899,211,215,2206,666
43017,12756,9340,1799,5743,1557,241,4805,3379,692,464,3416,1418,1172,478,348,2675,741
43018,83,63,27,18,7,11,27,36,0,0,20,0,0,20,0,7,13
43019,3157,2410,521,1207,549,133,928,1150,153,179,747,98,247,240,162,628,119
43021,2038,1718,154,1038,465,61,697,899,67,55,320,45,122,91,62,274,46
43022,646,475,51,298,88,38,200,182,60,33,171,28,73,47,23,133,38
43023,3458,2733,270,1545,770,148,1217,1251,156,109,725,77,253,228,167,678,47
43025,2342,1712,345,850,437,80,551,837,221,103,630,92,169,250,119,569,61
43026,17753,12802,4061,6763,1749,229,6385,4493,1317,607,4951,2078,1785,721,367,3853,1098
43028,2106,1668,300,741,563,64,531,930,119,88,438,62,149,134,93,390,48
43029,135,106,7,91,0,8,75,31,0,0,29,16,5,8,0,8,21
43031,3786,2955,477,1592,746,140,1182,1373,255,145,831,89,323,267,152,695,136
43032,22,10,0,10,0,0,10,0,0,0,12,0,0,12,0,12,0
43033,103,84,28,40,12,4,30,33,18,3,19,5,7,3,4,19,0
43035,4256,3167,1299,1501,322,45,1504,1251,335,77,1089,523,388,152,26,795,294
43036,50,33,4,22,7,0,9,20,4,0,17,3,5,3,6,16,1
43037,167,125,12,62,31,20,30,60,13,22,42,3,15,13,11,32,10
43040,8709,6426,1697,3275,1180,274,2823,2629,688,286,2283,653,709,543,378,1892,391
43044,2043,1530,342,716,410,62,517,739,149,125,513,122,140,171,80,422,91
43045,584,453,87,216,110,40,175,229,22,27,131,22,45,32,32,115,16
43046,1418,1002,160,471,304,67,362,478,88,74,416,73,167,129,47,334,82
43050,10707,7231,1676,3189,1854,512,2475,3332,857,567,3476,644,996,1014,822,2985,491
43054,2965,2399,419,1370,536,74,1127,1041,164,67,566,130,269,120,47,455,111
43055,23726,15747,3847,7071,3814,1015,5231,6672,2340,1504,7979,1534,2603,2225,1617,6788,1191
43056,5804,4250,908,1927,1176,239,1529,1967,435,319,1554,258,596,422,278,1255,299
43060,967,752,216,376,143,17,317,282,98,55,215,41,94,42,38,183,32
43061,1114,902,129,547,211,15,346,449,83,24,212,51,86,38,37,151,61
43062,7057,5643,1164,3082,1296,101,2105,2654,625,259,1414,229,510,452,223,1157,257
43064,3739,2836,563,1385,733,155,1138,1253,239,206,903,159,293,306,145,738,165
43065,8546,6810,1268,4292,1156,94,3611,2518,443,238,1736,595,764,305,72,1308,428
43066,414,337,44,202,80,11,157,152,14,14,77,10,48,8,11,74,3
43067,485,418,94,230,60,34,194,163,42,19,67,0,57,10,0,60,7
43068,18387,12399,3183,6169,2484,563,4614,4956,1863,966,5988,2212,1864,1364,548,4843,1145
43070,32,25,11,0,14,0,25,0,0,0,7,0,0,0,7,7,0
43071,805,648,113,286,201,48,253,279,51,65,157,27,71,34,25,127,30
43072,2107,1623,370,757,425,71,628,743,170,82,484,54,172,134,124,425,59
43074,3316,2684,402,1530,650,102,1099,1189,170,226,632,62,237,186,147,494,138
43076,3024,2294,398,1081,656,159,891,1157,158,88,730,100,230,239,161,584,146
43077,99,71,20,21,26,4,29,36,0,6,28,4,11,10,3,25,3
43078,8344,5802,1196,2662,1547,397,2074,2748,607,373,2542,448,720,732,642,2203,339
43080,1887,1414,287,664,383,80,525,668,135,86,473,102,139,113,119,385,88
43081,19777,13702,2919,7723,2683,377,5626,5617,1591,868,6075,2312,2003,1108,652,4838,1237
43082,5886,5093,835,3144,999,115,2701,2091,179,122,793,113,373,176,131,673,120
43084,282,195,53,87,43,12,77,82,36,0,87,7,52,6,22,80,7
43085,9709,6539,1219,3335,1582,403,2553,2941,670,375,3170,843,1146,749,432,2593,577
43101,131,101,33,30,35,3,44,34,13,10,30,6,6,10,8,25,5
43102,1362,1142,267,544,259,72,420,537,126,59,220,34,67,65,54,203,17
43103,3509,2708,623,1313,698,74,1050,1131,319,208,801,138,228,301,134,638,163
43105,2848,2236,344,1165,605,122,823,1069,205,139,612,82,186,169,175,507,105
43106,580,453,111,237,89,16,163,203,63,24,127,32,40,21,34,103,24
43107,1007,766,126,366,217,57,271,402,71,22,241,20,93,51,77,205,36
43109,26,18,0,12,4,2,8,8,2,0,8,3,0,0,5,8,0
43110,6986,5210,1461,2579,996,174,2009,2171,747,283,1776,686,535,310,245,1307,469
43111,63,48,6,29,6,7,15,20,6,7,15,5,0,6,4,15,0
43112,1295,1086,123,619,296,48,357,628,81,20,209,36,58,82,33,185,24
43113,8831,6383,1309,2839,1798,437,2114,3066,805,398,2448,555,597,694,602,2159,289
43115,466,326,61,178,66,21,126,145,32,23,140,3,39,48,50,125,15
43116,139,112,18,55,37,2,31,64,11,6,27,5,6,9,7,21,6
43119,7852,6043,2026,3090,794,133,2542,2240,1010,251,1809,932,593,248,36,1329,480
43123,17092,13012,3180,6464,2865,503,4967,5692,1453,900,4080,930,1235,1402,513,3401,679
43125,3912,2671,560,1302,702,107,947,1268,279,177,1241,298,381,317,245,1080,161
43126,99,75,9,39,25,2,22,35,7,11,24,2,9,7,6,22,2
43127,18,12,7,0,0,5,0,12,0,0,6,0,0,6,0,6,0
43128,938,669,149,348,138,34,218,258,146,47,269,42,74,73,80,210,59
43130,21729,15326,3292,6770,4278,986,5171,7258,1756,1141,6403,1232,1800,1940,1431,5524,879
43135,1664,1259,319,542,347,51,517,519,142,81,405,79,156,98,72,330,75
43136,89,67,10,39,10,8,30,22,9,6,22,10,6,4,2,18,4
43137,885,659,136,355,148,20,211,318,80,50,226,48,97,37,44,153,73
43138,6964,4911,1114,2155,1289,353,1746,2312,558,295,2053,319,722,617,395,1793,260
43140,6968,5102,1202,2370,1245,285,1853,2302,642,305,1866,333,559,628,346,1569,297
43142,43,37,9,13,7,8,7,24,4,2,6,0,4,2,0,6,0
43143,2158,1630,349,786,411,84,595,742,180,113,528,89,174,137,128,439,89
43144,190,128,37,50,34,7,45,49,19,15,62,5,20,28,9,54,8
43145,781,622,129,276,167,50,220,329,37,36,159,28,23,50,58,140,19
43146,2658,2238,379,1155,649,55,961,1084,94,99,420,67,188,103,62,329,91
43147,9383,7915,1295,5045,1441,134,4091,3003,531,290,1468,324,622,396,126,1213,255
43148,694,537,159,236,120,22,184,197,111,45,157,26,25,62,44,136,21
43149,978,720,121,380,204,15,241,370,70,39,258,40,110,65,43,219,39
43150,652,506,117,266,100,23,206,246,33,21,146,27,39,33,47,111,35
43151,111,90,11,50,19,10,27,40,14,9,21,2,5,10,4,21,0
43152,428,359,60,172,120,7,99,192,44,24,69,0,18,46,5,55,14
43153,359,295,34,152,75,34,101,149,27,18,64,12,19,27,6,55,9
43154,859,714,200,356,153,5,313,307,52,42,145,18,48,50,29,126,19
43155,845,664,122,378,155,9,285,298,37,44,181,22,60,43,56,152,29
43156,105,67,11,45,11,0,36,21,7,3,38,2,9,18,9,36,2
43157,132,100,29,40,27,4,36,40,19,5,32,2,10,17,3,27,5
43158,53,47,11,24,12,0,13,25,9,0,6,0,0,0,6,6,0
43160,8628,6034,1348,2754,1527,405,1981,2759,786,508,2594,485,639,887,583,2224,370
43162,2585,1967,366,1001,525,75,740,914,177,136,618,107,133,193,185,524,94
43164,813,662,135,362,141,24,230,245,105,82,151,18,65,44,24,112,39
43201,15033,3576,1908,1127,438,103,516,942,1211,907,11457,9001,1725,586,145,6103,5354
43202,10034,3536,1519,1422,475,120,1121,1341,387,687,6498,4062,1650,445,341,3994,2504
43203,4565,2132,788,944,299,101,310,298,1093,431,2433,314,647,982,490,2207,226
43204,16632,9880,2871,4352,2090,567,3109,3826,1781,1164,6752,1665,2536,1535,1016,5262,1490
43205,6136,3159,986,1361,607,205,442,599,1339,779,2977,669,1284,793,231,2447,530
43206,10468,5599,1615,2495,1203,286,1113,1751,1612,1123,4869,1589,1925,996,359,3677,1192
43207,17029,11738,2900,4922,3217,699,2985,4695,2327,1731,5291,920,1810,1906,655,4366,925
43209,11967,7325,1699,3396,1611,619,2387,2874,1413,651,4642,1315,1554,908,865,3893,749
43210,441,354,259,95,0,0,144,189,21,0,87,55,32,0,0,60,27
43211,9191,6373,1720,2919,1334,400,1104,1490,2349,1430,2818,515,1112,906,285,2318,500
43212,9556,3688,1074,1723,632,259,1194,1682,362,450,5868,3055,1593,636,584,4745,1123
43213,13726,7841,2290,3200,1781,570,1894,3165,1733,1049,5885,1681,2193,1264,747,4879,1006
43214,12391,6163,1211,2883,1376,693,1830,3228,479,626,6228,1957,2055,1143,1073,4964,1264
43215,5712,930,428,308,134,60,107,441,273,109,4782,2431,1295,670,386,3924,858
43217,844,623,225,347,43,8,314,103,132,74,221,132,89,0,0,134,87
43219,7940,5249,1324,2191,1405,329,1009,1576,1675,989,2691,302,987,819,583,2361,330
43220,11653,6088,1068,2625,1796,599,1926,3208,404,550,5565,2602,1383,954,626,4369,1196
43221,12330,8165,1208,4516,1827,614,3471,3392,707,595,4165,1020,1391,943,811,3517,648
43222,2230,1266,454,549,223,40,260,322,437,247,964,271,332,247,114,721,243
43223,9737,6541,1923,3002,1294,322,1987,2127,1497,930,3196,530,1193,961,512,2661,535
43224,17393,10377,3065,4705,1987,620,2805,3435,2502,1635,7016,1991,2536,1455,1034,5740,1276
43227,9966,6126,1561,2643,1506,416,1368,2151,1642,965,3840,691,1475,1131,543,3215,625
43228,19458,12082,4405,5047,2195,435,3766,4440,2480,1396,7376,2779,2574,1405,618,5837,1539
43229,20400,11255,3699,4487,2496,573,3263,4538,2020,1434,9145,3977,2974,1422,772,7123,2022
43230,19205,13083,2847,7594,2160,482,5675,5005,1485,918,6122,2178,2034,1300,610,5057,1065
43231,7107,4251,1394,2049,631,177,1403,1577,860,411,2856,1041,1035,452,328,2239,617
43232,16887,10061,3176,4695,1971,219,3099,3456,2290,1216,6826,2453,2610,1219,544,5517,1309
43235,16409,9577,2155,4980,1998,444,3641,4224,908,804,6832,3179,1975,935,743,5233,1599
43240,674,243,139,68,36,0,62,143,18,20,431,262,107,49,13,326,105
43302,20113,13921,3183,6304,3487,947,4463,6198,2002,1258,6192,1243,1899,1714,1336,5332,860
43310,1222,910,189,423,242,56,357,413,86,54,312,35,108,94,75,270,42
43311,7374,5137,1319,2356,1172,290,1758,2190,836,353,2237,473,752,576,436,1897,340
43314,1251,988,213,498,205,72,380,456,97,55,263,46,78,96,43,213,50
43315,2360,1824,390,933,415,86,721,754,225,124,536,75,193,191,77,454,82
43316,2478,1813,457,754,477,125,639,819,192,163,665,130,185,200,150,597,68
43317,33,25,5,15,5,0,16,7,2,0,8,0,0,3,5,8,0
43318,1167,925,208,461,212,44,387,377,109,52,242,34,91,41,76,214,28
43319,369,269,60,154,48,7,119,113,32,5,100,34,18,38,10,71,29
43320,498,378,59,218,84,17,158,155,40,25,120,35,44,30,11,98,22
43321,140,93,17,39,28,9,28,48,12,5,47,7,16,12,12,44,3
43322,141,112,34,39,32,7,32,62,5,13,29,4,2,8,15,27,2
43323,298,244,31,109,85,19,70,153,12,9,54,5,18,11,20,42,12
43324,1031,723,104,372,210,37,211,420,81,11,308,40,136,81,51,275,33
43326,5549,3791,810,1818,929,234,1315,1733,471,272,1758,351,418,471,518,1546,212
43331,2393,1611,310,625,497,179,385,909,190,127,782,105,185,343,149,659,123
43332,832,616,88,359,133,36,273,262,54,27,216,24,54,57,81,197,19
43333,309,183,16,110,45,12,67,103,9,4,126,28,40,22,36,109,17
43334,1954,1637,345,769,474,49,628,855,88,66,317,44,82,125,66,271,46
43336,22,8,0,4,0,4,4,4,0,0,14,0,6,8,0,14,0
43337,385,309,44,130,98,37,114,168,15,12,76,14,16,25,21,56,20
43338,3592,2696,436,1300,802,158,958,1371,230,137,896,124,256,231,285,803,93
43340,571,458,107,176,112,63,150,227,37,44,113,21,30,28,34,102,11
43341,337,268,60,127,77,4,80,146,28,14,69,13,12,33,11,32,37
43342,1229,996,203,483,240,70,418,464,72,42,233,34,90,58,51,202,31
43343,591,464,112,220,76,56,159,199,60,46,127,23,50,37,17,102,25
43344,2026,1580,393,758,310,119,648,710,152,70,446,73,86,164,123,387,59
43345,328,271,40,149,59,23,121,112,24,14,57,12,15,18,12,44,13
43347,481,384,89,210,58,27,127,188,46,23,97,11,25,27,34,89,8
43348,1086,696,145,241,268,42,188,341,106,61,390,38,116,166,70,338,52
43350,21,15,7,5,0,3,9,0,3,3,6,2,4,0,0,6,0
43351,4095,2790,615,1238,711,226,969,1389,301,131,1305,259,355,363,328,1199,106
43356,415,298,54,154,62,28,99,177,22,0,117,21,24,40,32,115,2
43357,1591,1221,266,634,255,66,524,529,106,62,370,61,106,93,110,335,35
43358,934,720,145,365,176,34,311,339,43,27,214,45,93,36,40,173,41
43359,301,260,51,117,65,27,85,126,31,18,41,4,28,4,5,39,2
43360,516,381,82,182,97,20,154,177,33,17,135,42,56,20,17,107,28
43402,12434,6291,1394,3176,1357,364,2185,2899,782,425,6143,3920,1091,599,533,3782,2361
43406,800,565,103,286,138,38,178,249,73,65,235,49,90,59,37,211,24
43407,222,189,20,104,58,7,74,90,15,10,33,9,11,9,4,31,2
43408,108,93,27,42,22,2,34,43,8,8,15,3,5,3,4,11,4
43410,3782,2815,579,1294,728,214,1017,1177,332,289,967,192,336,236,203,812,155
43412,1575,1277,136,680,379,82,382,675,125,95,298,47,109,93,49,247,51
43413,565,422,90,199,119,14,152,177,54,39,143,25,48,26,44,116,27
43416,1152,890,171,398,234,87,309,461,69,51,262,25,63,79,95,238,24
43420,12560,8683,1896,3977,2200,610,2798,3760,1384,741,3877,729,1227,1091,830,3246,631
43430,1886,1389,214,707,348,120,505,674,110,100,497,45,156,129,167,473,24
43431,1679,1227,316,557,290,64,471,514,173,69,452,48,154,117,133,391,61
43432,456,395,48,215,120,12,179,161,17,38,61,0,48,13,0,61,0
43435,558,459,46,241,138,34,197,226,7,29,99,15,25,25,34,95,4
43437,73,54,9,33,7,5,9,28,7,10,19,3,9,4,3,17,2
43438,176,105,8,39,50,8,23,79,1,2,71,2,18,33,18,68,3
43439,30,15,6,9,0,0,6,0,9,0,15,0,7,8,0,15,0
43440,1920,1260,78,554,488,140,286,781,81,112,660,67,227,198,168,580,80
43442,412,321,49,157,76,39,84,208,12,17,91,5,22,22,42,87,4
43443,582,443,91,246,93,13,195,184,44,20,139,7,56,48,28,123,16
43445,373,298,29,191,54,24,146,137,15,0,75,17,29,20,9,69,6
43447,1313,1020,132,554,265,69,358,515,96,51,293,64,85,100,44,255,38
43449,3206,2383,374,1222,625,162,864,1148,230,141,823,117,252,284,170,697,126
43450,1350,991,129,537,233,92,392,461,101,37,359,34,88,98,139,326,33
43451,429,333,46,204,68,15,149,153,12,19,96,4,38,29,25,88,8
43452,6058,4088,673,1722,1325,368,1091,2127,443,427,1970,253,572,656,489,1689,281
43456,343,206,9,111,83,3,61,117,7,21,137,23,47,54,13,126,11
43457,593,474,89,211,150,24,179,231,48,16,119,28,23,57,11,102,17
43458,125,91,26,45,18,2,39,25,21,6,34,7,10,10,7,34,0
43460,2678,1728,398,788,435,107,645,741,170,172,950,268,166,253,263,835,115
43462,429,312,48,176,60,28,84,127,49,52,117,6,53,30,28,90,27
43464,554,419,81,249,80,9,146,181,59,33,135,36,58,30,11,101,34
43465,2181,1451,242,649,468,92,402,710,180,159,730,149,211,249,121,636,94
43466,717,587,116,307,136,28,227,255,46,59,130,33,37,33,27,96,34
43467,7,5,3,1,1,0,4,1,0,0,2,0,0,2,0,2,0
43468,91,65,18,25,22,0,23,30,12,0,26,4,7,7,8,22,4
43469,1121,828,145,423,186,74,380,333,77,38,293,44,69,92,88,255,38
43501,315,248,35,119,80,14,101,114,14,19,67,5,31,22,9,49,18
43502,2668,1948,315,954,493,186,822,880,115,131,720,136,193,141,250,649,71
43504,362,266,37,162,55,12,100,147,18,1,96,7,12,46,31,85,11
43506,6186,4219,857,1892,1184,286,1445,1969,477,328,1967,420,605,439,503,1670,297
43511,320,248,28,136,80,4,86,138,17,7,72,19,6,9,38,60,12
43512,11450,8218,1668,3983,2056,511,2848,3757,1057,556,3232,771,1024,778,659,2741,491
43515,3047,2362,449,1173,607,133,854,1149,214,145,685,185,200,171,129,626,59
43516,1149,863,177,411,202,73,301,434,85,43,286,50,67,76,93,267,19
43517,1389,1039,249,464,243,83,404,473,104,58,350,47,107,97,99,297,53
43518,1042,790,151,395,201,43,314,356,90,30,252,83,73,41,55,197,55
43521,1104,779,190,344,199,46,282,355,98,44,325,69,97,68,91,270,55
43522,1312,953,142,548,232,31,420,433,61,39,359,60,128,116,55,295,64
43524,506,403,106,161,102,34,171,177,42,13,103,7,30,37,29,96,7
43525,219,165,32,109,18,6,84,49,20,12,54,14,15,13,12,47,7
43526,2291,1627,367,719,432,109,609,736,197,85,664,124,195,183,162,561,103
43527,916,684,148,322,156,58,259,304,75,46,232,45,71,52,64,208,24
43528,5291,3870,696,2009,907,258,1415,1787,345,323,1421,339,483,323,276,1241,180
43529,101,83,27,33,9,14,34,14,16,19,18,1,8,9,0,9,9
43531,62,26,5,14,7,0,12,14,0,0,36,6,15,5,10,31,5
43532,1432,1069,231,543,243,52,459,468,89,53,363,64,109,97,93,279,84
43533,552,428,100,178,135,15,158,206,54,10,124,19,13,54,38,117,7
43534,634,500,96,244,130,30,204,231,36,29,134,15,41,51,27,121,13
43535,302,235,52,93,69,21,81,106,32,16,67,5,19,24,19,60,7
43536,138,101,8,62,31,0,50,30,6,15,37,0,20,9,8,37,0
43537,9934,6732,1246,3555,1652,279,2533,3072,667,460,3202,1049,828,832,493,2793,409
43540,435,356,38,226,67,25,160,148,26,22,79,16,11,15,37,76,3
43541,69,45,11,21,13,0,19,15,3,8,24,8,7,2,7,14,10
43542,882,728,91,345,236,56,238,321,55,114,154,16,85,33,20,89,65
43543,3190,2307,455,1098,563,191,820,1064,289,134,883,170,242,218,253,779,104
43545,5656,4043,874,1929,975,265,1569,1850,425,199,1613,337,403,477,396,1423,190
43547,55,33,13,13,7,0,14,19,0,0,22,10,0,8,4,18,4
43548,274,210,20,115,63,12,80,117,9,4,64,8,21,17,18,62,2
43549,519,427,78,179,155,15,135,225,39,28,92,14,22,23,33,85,7
43551,12716,9185,1631,5150,1940,464,3881,3983,825,496,3531,836,1111,798,786,3035,496
43553,45,43,7,21,13,2,19,17,5,2,2,2,0,0,0,0,2
43554,1038,765,196,323,188,58,273,374,78,40,273,67,88,66,52,249,24
43555,82,61,0,32,11,18,19,36,6,0,21,0,0,12,9,21,0
43556,672,515,84,243,159,29,188,269,36,22,157,45,39,37,36,127,30
43557,1011,770,163,378,172,57,290,356,98,26,241,33,84,72,52,213,28
43558,4919,3948,670,2044,1062,172,1512,1815,325,296,971,238,306,236,191,803,168
43560,10389,7789,1165,4410,1830,384,3593,3171,646,379,2600,465,818,621,696,2328,272
43565,122,95,21,60,13,1,50,29,15,1,27,1,7,13,6,26,1
43566,2408,1891,222,1074,470,125,791,939,76,85,517,98,142,195,82,457,60
43567,4737,3518,791,1761,774,192,1457,1542,346,173,1219,225,394,295,305,1071,148
43569,1063,774,211,379,151,33,326,300,98,50,289,55,112,68,54,219,70
43570,1311,965,221,455,208,81,403,394,104,64,346,77,129,57,83,313,33
43571,1886,1506,134,967,350,55,640,665,109,92,380,31,163,92,94,321,59
43602,1472,938,486,336,62,54,93,108,617,120,534,122,197,127,88,477,57
43604,2573,1036,418,447,146,25,213,171,461,191,1537,279,589,494,175,1396,141
43605,11887,7685,2772,3212,1350,351,2258,2207,2230,990,4202,891,1532,1132,647,3416,786
43606,11102,6139,1323,2870,1430,516,1893,2297,1135,814,4963,1578,1437,930,1018,3959,1004
43607,10958,6332,1568,2539,1751,474,1088,1890,1918,1436,4626,1235,1278,1468,645,3684,942
43608,6921,4688,1309,2198,826,355,1020,1193,1579,896,2233,363,722,589,559,1896,337
43609,10471,6535,2125,2975,1126,309,2018,2020,1776,721,3936,1348,1246,830,512,2997,939
43610,2408,1600,401,822,332,45,321,373,518,388,808,166,344,242,56,662,146
43611,8500,5908,1470,2627,1476,335,1770,2327,1099,712,2592,448,909,740,495,2201,391
43612,13165,8183,2426,3655,1550,552,2915,2988,1433,847,4982,1286,1780,1153,763,4132,850
43613,14308,8980,2291,3993,1837,859,3073,3554,1441,912,5328,1326,1832,1168,1002,4489,839
43614,13669,7992,1797,3444,1940,811,2385,4103,822,682,5677,1486,1526,1379,1286,4823,854
43615,17457,10436,2722,4478,2446,790,2957,4724,1648,1107,7021,2605,2198,1470,748,5751,1270
43616,6713,4650,694,2357,1306,293,1574,2254,492,330,2063,422,529,567,545,1812,251
43617,2792,2210,243,1335,505,127,990,943,160,117,582,55,191,228,108,475,107
43618,1089,829,99,437,242,51,332,405,29,63,260,32,70,74,84,224,36
43619,2824,2141,422,1222,416,81,780,886,333,142,683,117,240,228,98,574,109
43620,2809,1393,462,619,272,40,259,332,523,279,1416,255,519,492,150,1177,239
43623,9000,5689,1064,2316,1807,502,1672,2904,629,484,3311,636,1100,791,784,2884,427
43624,997,269,132,63,67,7,23,84,113,49,728,136,181,221,190,691,37
43701,22181,14964,3541,6575,3788,1060,4870,6560,2267,1267,7217,1306,1874,2282,1755,6073,1144
43713,2937,2035,417,942,513,163,636,887,288,224,902,114,166,309,313,827,75
43716,833,606,82,285,198,41,259,264,28,55,227,29,73,60,65,194,33
43717,63,50,5,31,10,4,17,17,12,4,13,0,6,2,5,10,3
43718,1266,973,158,541,200,74,335,471,104,63,293,46,90,113,44,274,19
43719,1089,811,163,383,226,39,326,340,80,65,278,40,79,80,79,243,35
43720,418,338,100,159,58,21,169,137,22,10,80,13,21,26,20,63,17
43721,76,36,6,19,11,0,0,30,6,0,40,0,10,0,30,40,0
43722,146,113,23,65,18,7,32,64,13,4,33,0,10,6,17,28,5
43723,2128,1464,421,636,309,98,517,548,280,119,664,105,210,215,134,564,100
43724,2573,1780,359,855,453,113,652,837,173,118,793,108,184,304,197,724,69
43725,8645,5774,1266,2615,1512,381,1865,2470,984,455,2871,499,788,888,696,2539,332
43727,439,334,25,196,86,27,121,182,13,18,105,8,53,35,9,81,24
43728,514,421,108,196,108,9,129,202,29,61,93,9,24,41,19,85,8
43730,879,646,132,284,169,61,205,309,68,64,233,41,36,75,81,199,34
43731,2243,1613,416,763,389,45,668,686,162,97,630,99,132,215,184,552,78
43732,673,526,83,261,145,37,160,258,48,60,147,14,55,53,25,139,8
43734,465,330,76,173,56,25,104,155,46,25,135,12,23,76,24,125,10
43735,139,128,45,39,15,29,51,44,18,15,11,5,0,6,0,11,0
43738,75,40,4,31,2,3,14,18,6,2,35,15,6,14,0,19,16
43739,689,571,125,295,123,28,306,194,41,30,118,32,39,25,22,93,25
43740,73,55,10,22,11,12,21,17,5,12,18,4,2,7,5,14,4
43746,507,360,44,207,77,32,118,166,42,34,147,40,100,0,7,109,38
43747,409,301,46,156,67,32,88,139,41,33,108,10,44,26,28,99,9
43748,1008,790,205,408,115,62,334,315,89,52,218,46,66,71,35,168,50
43749,931,690,133,311,211,35,209,345,74,62,241,25,104,74,38,207,34
43754,540,409,91,144,130,44,115,222,35,37,131,7,24,57,43,125,6
43755,714,532,107,238,163,24,167,287,49,29,182,14,58,65,45,155,27
43756,2236,1541,293,685,450,113,501,771,188,81,695,97,186,225,187,614,81
43758,1182,933,189,394,275,75,279,436,123,95,249,28,97,59,65,215,34
43760,582,513,79,274,132,28,184,269,42,18,69,13,19,19,18,61,8
43762,1591,1149,218,592,257,82,466,492,105,86,442,148,82,103,109,382,60
43764,2993,2232,556,1024,542,110,847,884,339,162,761,80,254,261,166,666,95
43766,595,420,115,170,114,21,136,199,59,26,175,11,52,66,46,158,17
43767,493,440,73,195,132,40,151,233,48,8,53,3,23,27,0,50,3
43768,85,61,2,34,19,6,20,32,6,3,24,1,7,7,9,24,0
43771,735,563,134,252,151,26,251,244,46,22,172,15,52,56,49,152,20
43772,760,565,98,286,161,20,175,293,48,49,195,8,70,66,51,163,32
43773,1040,833,195,330,254,54,335,408,50,40,207,26,54,79,48,176,31
43777,1729,1328,364,572,313,79,441,543,228,116,401,46,150,104,101,313,88
43778,392,332,94,172,55,11,162,113,48,9,60,15,17,18,10,49,11
43779,347,250,34,100,105,11,84,134,24,8,97,15,30,34,18,85,12
43780,878,651,126,269,207,49,197,332,37,85,227,17,77,85,48,194,33
43782,262,194,55,86,47,6,73,66,29,26,68,8,27,12,21,63,5
43783,1580,1128,193,549,329,57,400,575,79,74,452,36,161,135,120,417,35
43787,1199,816,186,375,204,51,328,368,88,32,383,37,142,101,103,330,53
43788,344,279,54,151,50,24,110,94,33,42,65,11,21,27,6,56,9
43791,5,5,0,0,0,5,0,5,0,0,0,0,0,0,0,0,0
43793,2128,1547,299,619,498,131,535,780,127,105,581,68,152,201,160,539,42
43802,345,260,98,78,83,1,127,93,17,23,85,30,33,12,10,51,34
43804,900,753,209,342,144,58,444,250,27,32,147,17,33,44,53,138,9
43811,330,251,60,96,79,16,117,109,14,11,79,12,8,29,30,75,4
43812,8263,5553,1049,2635,1463,406,1924,2662,614,353,2710,437,644,884,745,2426,284
43821,1537,1162,252,576,303,31,492,545,77,48,375,65,108,104,98,329,46
43822,1503,1191,233,613,295,50,402,631,109,49,312,65,79,94,74,267,45
43824,1073,851,212,367,226,46,379,373,55,44,222,35,77,76,34,183,39
43830,1932,1558,367,814,284,93,691,672,115,80,374,60,135,131,48,327,47
43832,3034,2192,420,979,637,156,712,1064,292,124,842,138,192,272,240,713,129
43837,699,549,114,270,140,25,166,278,60,45,150,19,62,41,28,125,25
43840,331,241,50,105,71,15,93,124,14,10,90,8,10,40,32,69,21
43842,122,87,28,20,39,0,26,42,14,5,35,7,16,12,0,35,0
43843,345,268,30,139,85,14,124,117,0,27,77,6,20,26,25,71,6
43844,1407,1071,220,511,295,45,410,511,96,54,336,42,96,110,88,286,50
43845,1897,1382,268,655,375,84,438,665,166,113,515,79,131,157,148,429,86
43901,950,688,107,321,177,83,213,346,53,76,262,29,70,91,72,234,28
43902,60,40,17,0,23,0,17,23,0,0,20,8,12,0,0,16,4
43903,973,750,108,376,195,71,248,376,68,58,223,18,36,85,84,202,21
43905,78,45,16,12,10,7,11,5,7,22,33,6,5,13,9,27,6
43906,4050,2800,481,1283,749,287,731,1206,471,392,1250,91,401,367,391,1130,120
43907,2350,1596,296,733,462,105,508,840,159,89,754,130,173,181,270,662,92
43908,610,429,97,210,97,25,140,184,54,51,181,23,51,57,50,157,24
43909,36,18,0,6,12,0,0,15,0,3,18,0,0,0,18,18,0
43910,1452,1140,151,549,397,43,346,669,70,55,312,45,92,112,63,274,38
43912,3003,1877,376,797,512,192,576,848,243,210,1126,118,335,334,339,1021,105
43913,738,496,91,233,141,31,157,253,59,27,242,34,33,105,70,221,21
43914,35,26,11,15,0,0,5,15,6,0,9,0,0,0,9,9,0
43915,813,575,102,243,160,70,206,281,31,57,238,34,94,70,40,209,29
43917,1282,995,116,449,316,114,290,532,74,99,287,21,64,83,119,260,27
43920,10291,7154,1405,3242,1958,549,2255,3289,1022,588,3137,389,867,1043,838,2777,360
43925,27,22,14,8,0,0,4,0,18,0,5,5,0,0,0,0,5
43926,127,85,24,40,17,4,25,24,15,21,42,7,15,17,3,40,2
43927,14,14,6,5,3,0,5,9,0,0,0,0,0,0,0,0,0
43928,33,14,0,9,5,0,9,5,0,0,19,0,7,0,12,19,0
43930,286,219,36,123,45,15,99,96,17,7,67,11,10,35,11,53,14
43932,395,304,38,148,98,20,102,145,31,26,91,19,19,30,23,89,2
43933,741,562,112,289,109,52,233,288,27,14,179,13,34,53,79,146,33
43934,201,131,34,27,45,25,43,52,10,26,70,3,20,12,35,63,7
43935,4064,2665,503,1162,737,263,696,1240,395,334,1399,131,345,486,437,1299,100
43938,2721,1944,356,830,574,184,549,903,239,253,777,102,214,226,235,696,81
43939,143,119,18,58,29,14,51,49,8,11,24,0,6,8,10,24,0
43940,156,87,23,29,29,6,20,35,32,0,69,15,8,27,19,60,9
43942,1100,776,126,342,236,72,210,414,84,68,324,46,77,130,71,286,38
43943,1712,1265,173,612,363,117,400,652,88,125,447,43,110,167,127,417,30
43944,1049,814,93,397,237,87,218,479,43,74,235,37,43,106,49,210,25
43945,1282,901,202,419,248,32,355,387,86,73,381,70,90,137,84,329,52
43946,850,631,68,264,239,60,164,408,23,36,219,28,86,67,38,201,18
43947,2316,1509,247,689,445,128,490,851,91,77,807,72,138,292,305,750,57
43948,227,153,37,64,41,11,56,67,19,11,74,10,27,25,12,67,7
43950,5255,3630,481,1792,1023,334,1306,1890,206,228,1625,238,398,551,438,1469,156
43951,92,43,9,11,13,10,6,28,9,0,49,9,8,22,10,49,0
43952,8614,5220,971,2202,1571,476,1363,2257,805,795,3394,393,1060,1001,940,3085,309
43953,4592,3130,407,1492,934,297,964,1634,204,328,1462,211,406,521,324,1245,217
43961,142,68,12,21,25,10,15,28,5,20,74,5,21,29,19,72,2
43962,18,12,2,7,0,3,3,7,2,0,6,0,0,4,2,6,0
43963,597,372,59,141,106,66,84,200,48,40,225,20,46,63,96,209,16
43964,4297,3066,538,1437,828,263,864,1585,372,245,1231,188,365,410,268,1103,128
43967,13,8,0,0,8,0,0,8,0,0,5,0,0,0,5,5,0
43968,3272,2288,484,1075,559,170,752,1028,294,214,984,143,235,277,329,851,133
43971,569,346,49,157,99,41,97,159,59,31,223,38,53,57,75,202,21
43972,38,38,12,22,4,0,20,14,0,4,0,0,0,0,0,0,0
43973,801,577,62,264,220,31,204,300,38,35,224,31,70,68,55,194,30
43974,49,22,0,11,6,5,11,7,2,2,27,3,7,12,5,20,7
43976,544,398,54,196,118,30,134,227,17,20,146,14,34,53,45,120,26
43977,981,716,118,330,192,76,210,353,92,61,265,61,73,80,51,223,42
43981,151,98,13,36,43,6,24,58,5,11,53,7,14,14,18,41,12
43983,126,71,3,35,27,6,9,58,4,0,55,0,8,40,7,47,8
43986,813,613,109,251,211,42,213,293,48,59,200,23,66,66,45,164,36
43988,1106,757,121,362,207,67,252,379,69,57,349,33,80,140,96,320,29
44001,7711,5934,815,3128,1569,422,2353,2816,423,342,1777,255,629,502,391,1602,175
44003,1708,1243,241,589,324,89,458,572,131,82,465,62,112,182,109,395,70
44004,14567,9850,2173,4322,2521,834,2937,4353,1605,955,4717,810,1371,1446,1090,4024,693
44010,686,498,39,309,142,8,122,294,64,18,188,35,58,65,30,169,19
44011,4080,3138,555,1712,709,162,1460,1295,138,245,942,117,388,297,140,806,136
44012,6807,5244,753,2978,1274,239,2333,2293,335,283,1563,216,458,454,435,1384,179
44017,7195,4486,777,2149,1272,288,1503,1963,495,525,2709,564,1045,606,494,2373,336
44021,2392,1812,330,923,418,141,754,816,130,112,580,119,225,140,96,434,146
44022,6856,5156,300,2724,1718,414,2129,2469,261,297,1700,186,464,536,514,1511,189
44023,4810,3965,275,2437,1070,183,1773,1833,221,138,845,112,300,284,149,694,151
44024,8263,6272,802,3467,1656,347,2489,2974,438,371,1991,272,701,526,492,1644,347
44026,4440,3628,290,1749,1296,293,1264,1884,195,285,812,151,285,217,159,700,112
44028,2930,2413,264,1368,687,94,827,1178,241,167,517,79,208,149,81,414,103
44030,6370,4546,915,2005,1224,402,1476,2105,567,398,1824,279,523,493,529,1620,204
44032,464,419,106,155,130,28,166,181,22,50,45,0,34,11,0,29,16
44035,26271,17803,4255,7909,4390,1249,5433,7624,2860,1886,8468,1806,2941,2091,1630,7196,1272
44039,8258,6352,1099,3283,1717,253,2277,3131,403,541,1906,301,664,666,275,1621,285
44040,1071,872,29,439,327,77,329,489,28,26,199,26,42,76,55,172,27
44041,5994,4079,859,1935,1030,255,1426,1779,538,336,1915,429,554,562,370,1566,349
44044,4057,3421,455,1807,973,186,1261,1671,223,266,636,81,175,209,171,529,107
44046,642,528,121,267,118,22,243,227,47,11,114,15,55,30,14,76,38
44047,3448,2587,434,1332,652,169,971,1166,268,182,861,139,263,221,238,760,101
44048,843,616,59,371,137,49,220,283,39,74,227,36,59,88,44,187,40
44049,27,23,5,13,5,0,5,11,1,6,4,0,3,0,1,1,3
44050,2023,1698,334,940,344,80,706,781,134,77,325,27,136,100,62,253,72
44052,12774,8564,2356,3578,1922,708,2321,3060,2090,1093,4210,671,1503,1127,909,3596,614
44053,7226,4747,923,2007,1285,532,1287,2273,652,535,2479,472,863,690,454,2154,325
44054,4418,3323,548,1779,872,124,1269,1560,240,254,1095,226,425,322,122,892,203
44055,8098,5900,1461,2714,1358,367,1598,1997,1476,829,2198,345,705,685,463,1923,275
44056,3264,2665,370,1505,681,109,1123,1238,148,156,599,79,262,179,79,531,68
44057,7017,5253,1156,2592,1295,210,1997,2280,559,417,1764,292,618,572,282,1469,295
44060,24126,17940,2661,9619,4649,1011,6930,8174,1422,1414,6186,1075,2111,1843,1157,5239,947
44062,3830,3050,882,1352,716,100,1605,979,230,236,780,126,207,229,218,690,90
44064,552,450,68,221,119,42,146,253,18,33,102,5,23,44,30,96,6
44065,1414,1103,144,575,354,30,394,509,114,86,311,42,93,116,60,257,54
44067,7183,5009,843,2398,1495,273,1726,2548,328,407,2174,533,829,486,326,1808,366
44070,13601,9474,1206,4738,2907,623,3311,4585,777,801,4127,1011,1216,1062,838,3593,534
44072,1538,1240,56,664,405,115,446,662,67,65,298,26,115,91,66,267,31
44074,4027,2492,307,1308,698,179,797,1255,246,194,1535,418,313,390,414,1195,340
44076,1582,1181,297,538,290,56,475,513,126,67,401,60,106,127,108,345,56
44077,19249,13638,2768,6873,3250,747,4800,5997,1728,1113,5611,1365,1826,1496,924,4653,958
44080,47,19,0,19,0,0,19,0,0,0,28,7,8,8,5,28,0
44081,2277,1863,251,1035,502,75,771,827,161,104,414,44,163,136,71,356,58
44082,490,379,78,171,104,26,183,138,11,47,111,10,26,57,18,92,19
44084,1268,1031,170,538,289,34,365,507,67,92,237,43,90,60,44,191,46
44085,1058,823,152,438,195,38,332,314,102,75,235,51,87,68,29,202,33
44086,817,610,81,374,141,14,245,294,51,20,207,40,90,50,27,157,50
44087,7059,5038,1000,2760,1070,208,2293,1999,314,432,2021,445,669,539,368,1728,293
44089,6258,4681,726,2325,1379,251,1671,2333,400,277,1577,282,495,479,321,1344,233
44090,4009,3095,552,1565,819,159,1200,1410,259,226,914,138,302,236,238,810,104
44092,7615,4915,774,1993,1569,579,1496,2510,299,610,2700,643,784,689,584,2358,342
44093,607,432,92,188,121,31,208,187,23,14,175,19,78,41,37,159,16
44094,14936,9307,1499,4414,2568,826,2898,4491,1011,907,5629,1155,1830,1438,1206,4884,745
44095,14479,9856,1526,4594,2881,855,3145,4637,956,1118,4623,915,1359,1383,966,3976,647
44099,469,365,110,150,88,17,146,158,40,21,104,8,66,14,16,79,25
44102,20515,11615,4152,4937,2044,482,3111,3013,3613,1878,8900,2620,3470,1817,993,7244,1656
44103,9724,5779,1611,2614,1216,338,1097,1227,2098,1357,3945,590,1306,1311,738,3502,443
44104,10848,7038,2587,2661,1444,346,846,1106,3478,1608,3810,556,1312,1365,577,3376,434
44105,20743,13871,3587,6096,3438,750,2627,3854,4183,3207,6872,1262,2339,2104,1167,5848,1024
44106,13522,5684,1572,2238,1472,402,955,1812,1550,1367,7838,2937,1994,1655,1252,6510,1328
44107,26767,12533,3277,6171,2325,760,4223,4875,1954,1481,14234,5411,4266,2686,1871,11707,2527
44108,13534,9171,2079,3657,2425,1010,1324,2025,3072,2750,4363,578,1381,1572,832,3880,483
44109,18187,10910,3333,4793,2036,748,3439,3459,2412,1600,7277,1745,2750,1763,1019,6020,1257
44110,11214,6318,2065,2802,1084,367,1214,1359,2443,1302,4896,844,1837,1370,845,4313,583
44111,17986,10689,2880,4890,2232,687,3552,3928,1635,1574,7297,1602,3017,1528,1150,6083,1214
44112,13224,8043,2038,3409,2224,372,1223,2106,2885,1829,5181,803,2033,1702,643,4699,482
44113,7404,3316,1180,1393,611,132,677,950,1056,633,4088,1465,1595,744,284,3430,658
44114,1969,577,213,207,128,29,120,242,126,89,1392,315,360,467,250,1287,105
44115,3063,1652,1059,473,106,14,84,99,1265,204,1411,536,547,256,72,1275,136
44116,9835,5522,785,2403,1671,663,1798,2876,363,485,4313,570,1185,1106,1452,3985,328
44117,5871,2882,430,1331,750,371,707,1149,548,478,2989,265,889,1058,777,2782,207
44118,17684,11155,2290,5460,2526,879,3772,4498,1549,1336,6529,2101,1988,1404,1036,5236,1293
44119,6264,3321,798,1557,630,336,1025,1268,580,448,2943,640,1047,466,790,2550,393
44120,20048,11990,2761,5625,2689,915,2611,3165,3573,2641,8058,1936,2750,2240,1132,7271,787
44121,14527,9538,1646,4911,2086,895,3221,3688,1372,1257,4989,1051,1793,1169,976,4339,650
44122,14621,9510,892,4607,2865,1146,3082,4670,1002,756,5111,721,1163,1482,1745,4623,488
44123,8389,4801,1182,2258,771,590,1429,1585,974,813,3588,819,1170,838,761,3210,378
44124,18539,11192,1599,4516,3318,1759,3410,5995,678,1109,7347,1310,1625,1830,2582,6708,639
44125,12112,8076,1427,3782,1966,901,2599,3530,891,1056,4036,683,1043,1057,1253,3601,435
44126,7727,4669,680,2191,1237,561,1721,2083,360,505,3058,696,903,716,743,2755,303
44127,3038,1895,562,874,356,103,436,417,686,356,1143,195,453,359,136,940,203
44128,13370,8796,1508,3586,2902,800,1454,3119,2031,2192,4574,568,1562,1841,603,4105,469
44129,12206,7973,1614,3530,1988,841,2766,3623,708,876,4233,908,1183,782,1360,3726,507
44130,23346,14748,2384,6117,4540,1707,4183,7479,1250,1836,8598,1898,2214,2286,2200,7584,1014
44131,8129,6205,414,2677,2147,967,1861,3502,274,568,1924,167,410,676,671,1718,206
44132,6860,4011,1034,1595,964,418,1039,1548,783,641,2849,676,1080,564,529,2518,331
44133,11274,7740,1069,4309,1920,442,3092,3529,454,665,3534,1035,1152,840,507,3001,533
44134,16596,11092,1916,4778,3074,1324,3736,5208,906,1242,5504,903,1474,1512,1615,4859,645
44135,11904,7240,2018,3005,1707,510,2235,2735,1252,1018,4664,851,1761,1220,832,4000,664
44136,16207,12428,1429,7074,3418,507,5130,5881,686,731,3779,849,1162,1080,688,3215,564
44137,10477,7010,1284,3466,1627,633,2161,2662,1162,1025,3467,592,1175,841,859,3133,334
44138,7322,4915,775,2585,1205,350,1881,2312,330,392,2407,382,673,786,566,2124,283
44139,7760,6310,558,3912,1449,391,3074,2442,410,384,1450,129,576,484,261,1259,191
44140,6183,4645,579,2457,1247,362,1847,2206,315,277,1538,151,463,529,395,1366,172
44141,5118,3847,244,2051,1220,332,1551,1949,147,200,1271,127,506,304,334,1131,140
44142,8156,5964,810,2659,2100,395,1831,2982,509,642,2192,379,624,755,434,1917,275
44143,9694,6629,774,3108,2061,686,2274,3095,492,768,3065,742,1009,673,641,2665,400
44144,10015,5886,1265,2254,1549,818,1739,2602,592,953,4129,814,1299,1115,901,3654,475
44145,12916,8348,1030,4442,2305,571,3278,4201,399,470,4568,1004,1355,1025,1184,4062,506
44146,14068,8348,1502,3795,2319,732,2140,3902,1296,1010,5720,1240,1879,1486,1115,5014,706
44147,6407,4378,599,2206,1233,340,1711,1953,347,367,2029,565,718,377,369,1757,272
44201,2435,1952,290,1045,520,97,751,999,119,83,483,86,160,156,81,395,88
44202,6395,4961,620,2620,1405,316,1897,2400,316,348,1434,315,502,332,285,1235,199
44203,16885,11642,2411,5388,2784,1059,3666,5173,1623,1180,5243,859,1450,1727,1207,4481,762
44212,13645,10671,2156,5779,2389,347,4458,4502,906,805,2974,813,1071,748,342,2436,538
44214,751,631,143,305,161,22,231,309,35,56,120,29,39,31,21,86,34
44215,740,482,94,253,101,34,164,205,60,53,258,65,102,65,26,203,55
44216,3297,2671,306,1414,798,153,979,1401,168,123,626,84,210,182,150,485,141
44217,1495,1138,231,542,305,60,418,597,52,71,357,91,81,107,78,297,60
44221,13713,8239,2012,3713,1888,626,2761,3684,1016,778,5474,1612,1800,1069,993,4584,890
44223,7676,4988,1038,2235,1197,518,1691,2499,454,344,2688,456,773,727,732,2359,329
44224,13862,9779,1817,5040,2410,512,4056,4450,710,563,4083,1148,1259,870,806,3382,701
44230,2998,2217,319,1146,619,133,759,1120,193,145,781,161,251,218,151,676,105
44231,3034,2263,465,1127,565,106,899,1010,194,160,771,104,342,188,137,646,125
44233,2348,1968,122,1099,623,124,804,1021,20,123,380,43,201,96,40,296,84
44234,1262,972,160,472,266,74,342,493,87,50,290,50,127,80,33,234,56
44235,529,458,72,247,139,0,234,193,14,17,71,18,18,29,6,61,10
44236,8030,6871,526,4451,1560,334,3584,2780,213,294,1159,119,282,367,391,1023,136
44240,14610,8302,2085,3961,1799,457,2723,3416,1486,677,6308,3463,1338,933,574,4269,2039
44241,5196,3641,999,1667,875,100,1294,1654,386,307,1555,476,602,358,119,1264,291
44243,0,0,0,0,0,0,0,0,0,0,0,0,0,0,0,0,0
44250,368,306,80,128,74,24,99,110,53,44,62,15,16,23,8,47,15
44251,128,115,16,59,32,8,47,51,16,1,13,2,6,3,2,10,3
44253,1111,950,85,550,266,49,400,449,48,53,161,27,77,30,27,127,34
44254,2059,1400,233,682,403,82,490,673,165,72,659,103,266,173,117,553,106
44255,3083,2251,401,1299,427,124,901,957,191,202,832,179,243,200,210,733,99
44256,18585,14421,2912,7805,3112,592,6457,6031,1080,853,4164,954,1318,1066,826,3581,583
44260,5319,4181,581,2165,1211,224,1498,2072,285,326,1138,178,361,358,241,925,213
44262,2038,1594,188,799,535,72,648,784,92,70,444,116,160,101,67,374,70
44264,972,677,77,356,198,46,196,369,68,44,295,57,135,64,39,235,60
44266,13200,9233,2072,4390,2284,487,3172,4005,1210,846,3967,838,1392,1083,654,3238,729
44270,3207,2373,445,1180,634,114,892,1047,258,176,834,147,200,299,188,744,90
44272,1508,1215,135,673,285,122,422,611,107,75,293,45,107,56,85,240,53
44273,2505,2048,324,1025,593,106,772,990,118,168,457,80,173,122,82,399,58
44275,979,806,178,393,182,53,324,398,50,34,173,37,62,41,33,126,47
44276,653,553,107,300,102,44,253,285,15,0,100,0,42,30,28,89,11
44278,6645,4896,583,2421,1419,473,1802,2329,398,367,1749,319,465,557,408,1488,261
44280,1387,1208,99,688,366,55,375,675,43,115,179,4,81,33,61,151,28
44281,10097,7511,1221,3846,1901,543,3042,3516,501,452,2586,457,688,725,716,2241,345
44286,1847,1481,122,817,472,70,557,748,87,89,366,17,97,146,106,295,71
44287,2521,2011,371,1015,568,57,780,930,179,122,510,106,166,173,65,446,64
44288,1533,1227,286,582,280,79,395,450,250,132,306,57,125,93,31,260,46
44301,6887,4453,1253,1966,792,442,1282,1625,936,610,2434,438,891,530,575,2034,400
44302,2923,1377,505,597,200,75,358,384,382,253,1546,415,603,326,202,1261,285
44303,3724,1811,307,875,459,170,589,755,237,230,1913,644,546,352,371,1611,302
44304,2401,808,393,250,130,35,136,252,244,176,1593,1063,275,136,119,998,595
44305,9841,6477,1754,2980,1325,418,1919,2402,1263,893,3364,861,1081,831,591,2727,637
44306,10127,6608,2236,2754,1062,556,1475,1957,2157,1019,3519,688,1285,931,615,2912,607
44307,4071,2264,746,838,448,232,360,508,912,484,1807,289,510,651,357,1559,248
44308,606,55,0,31,24,0,0,37,0,18,551,85,288,143,35,517,34
44310,10201,6006,1575,2739,1283,409,1837,2104,1201,864,4195,968,1470,954,803,3552,643
44311,3461,1901,688,835,282,96,400,405,708,388,1560,756,455,225,124,954,606
44312,13303,8729,1728,3996,2271,734,2720,4098,981,930,4574,877,1283,1389,1025,3895,679
44313,11426,6480,1390,2819,1561,710,1806,3274,839,561,4946,1610,1447,1071,818,4206,740
44314,8354,5444,1365,2442,1230,407,1649,2202,893,700,2910,702,973,737,498,2434,476
44319,9078,6278,1002,2911,1794,571,1912,3353,479,534,2800,489,974,897,440,2389,411
44320,9320,6146,1251,2781,1682,432,1268,2116,1576,1186,3174,421,1104,1099,550,2803,371
44321,3976,2973,397,1735,698,143,1319,1260,238,156,1003,337,354,215,97,825,178
44322,126,86,29,37,20,0,12,30,24,20,40,16,0,8,16,24,16
44333,7215,5245,370,2789,1545,541,1960,2746,290,249,1970,312,499,553,606,1690,280
44401,1211,967,106,538,288,35,336,556,41,34,244,47,144,27,26,191,53
44402,1202,968,180,459,265,64,308,525,55,80,234,19,93,77,45,215,19
44403,1663,1179,141,485,354,199,336,699,70,74,484,27,108,175,174,434,50
44404,636,530,103,235,152,40,194,250,46,40,106,20,19,39,28,86,20
44405,3739,2645,584,1024,718,319,643,1010,479,513,1094,81,226,468,319,1039,55
44406,7652,5754,521,3142,1639,452,2292,2783,362,317,1898,297,686,525,390,1683,215
44408,3930,2755,426,1273,795,261,855,1500,210,190,1175,140,289,406,340,1109,66
44410,7015,5081,739,2620,1415,307,1754,2549,422,356,1934,324,631,633,346,1660,274
44411,955,780,186,354,198,42,287,355,89,49,175,39,65,49,22,147,28
44412,967,806,127,419,224,36,267,391,90,58,161,27,37,66,31,131,30
44413,3147,2264,382,999,687,196,706,1107,224,227,883,149,204,260,270,772,111
44417,631,549,57,275,185,32,177,304,39,29,82,12,26,37,7,63,19
44418,496,389,38,220,119,12,138,178,43,30,107,9,37,41,20,103,4
44420,6897,4657,931,1940,1337,449,1313,2130,624,590,2240,340,601,754,545,1984,256
44423,904,691,166,356,131,38,280,312,61,38,213,29,84,69,31,180,33
44425,6355,4533,633,2264,1278,358,1515,2203,380,435,1822,278,412,601,531,1695,127
44427,566,452,88,212,130,22,147,254,35,16,114,22,53,17,22,94,20
44428,1295,958,166,399,309,84,302,506,87,63,337,51,140,80,66,298,39
44429,1075,782,161,374,217,30,240,383,90,69,293,45,109,95,44,242,51
44430,1622,1283,234,624,353,72,386,569,175,153,339,45,106,143,45,280,59
44431,1755,1356,217,716,340,83,550,566,144,96,399,52,144,100,103,361,38
44432,4414,3216,605,1442,982,187,1085,1580,301,250,1198,192,357,355,294,1013,185
44436,1653,1178,125,582,359,112,404,581,65,128,475,45,96,168,166,438,37
44437,1733,1327,213,658,360,96,577,548,39,163,406,88,71,158,89,383,23
44438,2344,1578,268,775,423,112,488,714,173,203,766,108,276,199,183,672,94
44440,1578,1088,248,533,253,54,415,494,131,48,490,84,211,119,76,404,86
44441,568,387,71,174,131,11,109,224,33,21,181,56,72,33,20,112,69
44442,1403,1086,115,526,352,93,338,589,87,72,317,22,55,144,96,289,28
44443,847,629,100,299,199,31,229,291,66,43,218,33,45,63,77,198,20
44444,4327,3049,566,1348,918,217,905,1489,394,261,1278,191,485,266,336,1114,164
44445,1258,995,154,591,214,36,372,444,101,78,263,43,64,84,72,247,16
44446,9716,6219,1278,2755,1662,524,1778,2903,912,626,3497,654,1066,935,842,3118,379
44449,489,346,100,144,80,22,134,164,28,20,143,14,81,41,7,116,27
44450,688,510,98,246,112,54,232,175,39,64,178,24,59,51,44,148,30
44451,1131,871,105,475,251,40,319,452,30,70,260,25,121,55,59,205,55
44452,932,768,128,377,198,65,289,376,72,31,164,15,35,66,48,148,16
44454,418,317,67,193,45,12,180,122,15,0,101,12,38,31,20,84,17
44455,636,502,98,249,149,6,160,224,62,56,134,3,60,37,34,122,12
44460,10642,7612,1439,3528,2037,608,2718,3565,657,672,3030,436,924,907,763,2737,293
44470,1318,1054,177,488,319,70,333,540,75,106,264,30,76,100,58,199,65
44471,4782,3304,518,1437,952,397,1125,1434,315,430,1478,216,321,446,495,1311,167
44473,1712,1262,184,605,385,88,381,716,72,93,450,34,127,155,134,400,50
44481,4620,3270,432,1665,996,177,1065,1682,254,269,1350,165,472,473,240,1179,171
44483,11857,7594,1704,3093,2037,760,2228,3270,1184,912,4263,766,1312,1121,1064,3781,482
44484,9625,6838,1084,3358,1895,501,2049,3139,943,707,2787,415,892,905,575,2467,320
44485,7890,5271,1550,1988,1263,470,1247,1859,1353,812,2619,348,754,1026,491,2328,291
44490,304,230,43,104,67,16,46,117,55,12,74,14,29,23,8,62,12
44491,1036,839,192,431,203,13,372,393,42,32,197,29,85,56,27,154,43
44502,4789,2994,622,1184,778,410,636,1163,613,582,1795,267,554,559,415,1539,256
44503,401,0,0,0,0,0,0,0,0,0,401,0,112,197,92,387,14
44504,2263,1197,219,534,359,85,250,423,251,273,1066,278,245,274,269,918,148
44505,8126,5196,1057,2260,1341,538,1129,1882,1209,976,2930,328,1008,1114,480,2610,320
44506,1403,964,225,386,265,88,163,237,266,298,439,31,186,136,86,387,52
44507,3324,2116,669,901,447,99,397,485,834,400,1208,190,414,355,249,1084,124
44509,5693,3647,914,1478,847,408,983,1426,672,566,2046,267,601,532,646,1844,202
44510,1278,795,247,263,219,66,83,172,322,218,483,66,192,148,77,437,46
44511,9722,6550,1137,2649,2021,743,1470,2875,1163,1042,3172,364,1035,1023,750,2866,306
44512,15353,9689,1382,4611,2586,1110,3042,4676,866,1105,5664,1199,1586,1467,1412,5073,591
44514,8904,6502,802,3085,1883,732,2222,3302,395,583,2402,328,585,768,721,2218,184
44515,12023,8012,1506,3671,2232,603,2305,3868,1025,814,4011,909,1289,932,881,3583,428
44601,14027,9580,1933,4212,2665,770,2966,4240,1291,1083,4447,816,1263,1245,1123,3743,704
44606,2108,1755,435,822,437,61,901,641,85,128,353,79,111,106,57,320,33
44608,1009,757,164,312,206,75,251,371,62,73,252,28,74,93,57,216,36
44609,1536,1177,143,631,300,103,396,565,110,106,359,63,161,81,54,314,45
44610,91,58,6,20,32,0,6,39,8,5,33,0,0,9,24,33,0
44611,660,547,136,211,182,18,269,204,27,47,113,21,62,14,16,92,21
44612,1964,1520,270,812,355,83,590,751,118,61,444,97,158,113,76,374,70
44613,867,650,135,308,165,42,244,277,58,71,217,36,49,57,75,186,31
44614,4144,3297,581,1787,805,124,1387,1461,303,146,847,131,324,201,191,712,135
44615,4259,3099,560,1596,784,159,1096,1487,303,213,1160,163,286,403,308,994,166
44618,2156,1785,375,896,432,82,805,800,108,72,371,75,111,104,81,307,64
44619,11,5,0,0,5,0,0,5,0,0,6,6,0,0,0,0,6
44620,572,424,87,203,110,24,172,199,30,23,148,49,30,33,36,138,10
44621,1912,1462,316,669,408,69,491,654,189,128,450,65,127,142,116,387,63
44622,7081,4946,863,2306,1350,427,1798,2325,423,400,2135,317,595,608,615,1859,276
44624,1264,1091,298,565,189,39,547,433,47,64,173,11,65,54,43,172,1
44625,609,516,103,263,89,61,225,210,61,20,93,19,28,32,14,74,19
44626,1207,920,117,452,281,70,292,501,47,80,287,31,95,92,69,251,36
44627,1333,1206,349,519,289,49,725,373,32,76,127,33,27,47,20,124,3
44628,494,344,65,170,89,20,133,195,12,4,150,22,53,54,21,104,46
44629,831,627,126,273,175,53,232,312,52,31,204,30,40,63,71,187,17
44632,3411,2743,420,1512,624,187,1117,1258,228,140,668,173,166,186,143,569,99
44633,690,611,134,297,162,18,302,235,33,41,79,8,44,23,4,70,9
44634,725,583,98,314,152,19,278,228,33,44,142,20,37,34,51,136,6
44637,975,694,156,324,158,56,210,291,117,76,281,49,102,78,52,219,62
44638,536,378,80,184,97,17,139,172,50,17,158,37,49,48,24,136,22
44640,34,30,2,15,12,1,10,16,4,0,4,0,4,0,0,4,0
44641,7251,5541,931,2674,1485,451,2115,2612,412,402,1710,292,485,536,397,1452,258
44643,1219,936,137,412,307,80,250,494,111,81,283,55,97,69,62,235,48
44644,1996,1488,316,698,385,89,523,715,140,110,508,98,191,122,97,424,84
44645,873,695,129,382,148,36,337,284,44,30,178,36,61,63,18,132,46
44646,17846,12615,2629,5914,3148,924,4304,5540,1655,1116,5231,1087,1635,1487,1022,4440,791
44647,6915,4967,746,2468,1432,321,1606,2519,453,389,1948,345,523,633,447,1697,251
44651,325,236,68,82,79,7,105,118,5,8,89,0,34,35,20,89,0
44653,114,86,18,41,25,2,17,40,17,12,28,3,13,2,10,25,3
44654,5273,4255,1140,1901,960,254,2100,1652,264,239,1018,229,276,256,257,878,140
44656,1140,852,149,431,211,61,299,402,92,59,288,36,69,107,76,239,49
44657,4007,2926,470,1372,881,203,952,1486,299,189,1081,212,294,368,207,915,166
44659,33,21,9,7,5,0,6,11,1,3,12,5,1,0,6,12,0
44661,62,44,13,14,16,1,12,27,0,5,18,2,1,8,7,16,2
44662,3636,2635,406,1211,817,201,814,1404,199,218,1001,158,307,308,228,880,121
44663,10583,7143,1479,3181,1923,560,2381,3347,813,602,3440,632,1072,1087,649,2963,477
44666,1010,785,112,391,220,62,331,340,42,72,225,54,90,74,7,166,59
44667,5082,3793,844,1832,875,242,1490,1713,366,224,1289,218,468,365,238,1157,132
44669,537,428,99,218,85,26,228,187,9,4,109,31,29,29,20,96,13
44670,62,45,0,17,28,0,6,33,0,6,17,0,17,0,0,10,7
44671,151,109,14,56,39,0,41,45,17,6,42,0,18,11,13,37,5
44672,2288,1367,278,551,356,182,398,697,136,136,921,89,144,235,453,840,81
44675,732,523,92,218,158,55,156,307,36,24,209,48,67,56,38,190,19
44676,1770,1371,279,709,304,79,581,628,84,78,399,44,147,130,78,372,27
44677,964,756,159,378,176,43,301,318,100,37,208,47,54,62,45,189,19
44678,82,68,11,43,14,0,27,36,5,0,14,0,0,7,7,14,0
44680,1447,1043,248,486,248,61,372,515,104,52,404,53,125,117,109,346,58
44681,2294,1876,508,781,454,133,902,828,53,93,418,98,102,99,119,374,44
44682,262,187,38,107,31,11,67,85,26,9,75,10,10,19,36,67,8
44683,3464,2438,633,1083,560,162,871,1029,392,146,1026,148,300,322,256,936,90
44685,8651,6900,952,3765,1854,329,2779,3250,510,361,1751,225,584,624,318,1497,254
44688,1325,984,160,473,258,93,340,444,106,94,341,35,99,111,96,313,28
44689,248,210,62,105,37,6,118,80,12,0,38,6,10,12,10,22,16
44690,30,20,0,6,6,8,0,20,0,0,10,10,0,0,0,10,0
44691,16437,11103,2177,5284,2855,787,3848,5172,1277,806,5334,1318,1647,1229,1140,4466,868
44693,44,30,0,14,13,3,1,22,4,3,14,2,0,2,10,10,4
44695,651,484,87,223,141,33,164,262,22,36,167,28,39,43,57,143,24
44697,84,62,11,25,25,1,20,29,9,4,22,4,4,10,4,16,6
44699,362,257,54,107,82,14,86,144,16,11,105,0,49,38,18,83,22
44702,463,76,35,6,21,14,9,15,18,34,387,20,148,144,75,354,33
44703,4453,2530,830,1163,383,154,646,862,666,356,1923,528,810,305,280,1522,401
44704,1859,1205,272,490,334,109,269,378,336,222,654,48,287,231,88,579,75
44705,7946,5548,1375,2468,1263,442,1464,1816,1320,948,2398,367,710,816,505,1989,409
44706,7365,5237,1094,2360,1432,351,1712,2284,658,583,2128,334,777,592,425,1790,338
44707,4306,2825,716,1188,745,176,604,976,820,425,1481,213,500,511,257,1304,177
44708,11211,7124,1297,3039,1982,806,2193,3577,686,668,4087,659,1131,1028,1269,3645,442
44709,7988,4650,979,2109,1159,403,1434,2206,612,398,3338,888,968,811,671,2853,485
44710,4201,2603,658,1175,552,218,776,1118,392,317,1598,209,378,448,563,1406,192
44714,3924,2358,517,960,584,297,607,1126,343,282,1566,175,597,455,339,1360,206
44718,5177,3440,365,1734,1039,302,1280,1742,196,222,1737,480,448,411,398,1482,255
44720,15244,10625,1600,5243,2879,903,3963,5220,719,723,4619,1051,1447,1164,957,3957,662
44721,4303,3498,558,1862,903,175,1375,1675,287,161,805,120,313,226,146,688,117
44730,2424,1878,276,925,549,128,560,960,166,192,546,79,151,193,123,449,97
44802,332,271,30,147,74,20,114,133,16,8,61,24,16,10,11,55,6
44804,424,313,57,186,59,11,170,100,23,20,111,23,32,34,22,85,26
44805,12414,8681,1773,3907,2308,693,2973,4235,982,491,3733,884,925,1020,904,3241,492
44807,938,720,155,329,169,67,253,354,82,31,218,50,48,66,54,182,36
44809,115,83,11,54,10,8,26,20,18,19,32,12,0,12,8,27,5
44811,5101,3647,744,1679,944,280,1352,1716,339,240,1454,307,444,395,308,1240,214
44813,2702,2066,394,907,566,199,734,1051,196,85,636,104,254,195,83,555,81
44814,1004,786,98,445,192,51,329,367,52,38,218,62,80,45,31,176,42
44815,312,240,56,110,56,18,79,112,41,8,72,24,10,21,17,59,13
44816,41,33,24,9,0,0,17,0,16,0,8,0,8,0,0,8,0
44817,534,427,108,221,90,8,199,184,23,21,107,12,31,19,45,97,10
44818,987,777,165,341,207,64,293,372,77,35,210,51,59,59,41,188,22
44820,7741,5301,1064,2330,1495,412,1596,2552,681,472,2440,442,664,723,611,2066,374
44822,1034,854,219,399,212,24,337,387,91,39,180,36,58,55,31,162,18
44824,1523,1209,145,674,327,63,447,602,75,85,314,38,83,133,60,264,50
44825,80,58,13,28,16,1,29,23,4,2,22,7,4,2,9,20,2
44826,679,529,92,222,164,51,161,294,44,30,150,5,36,87,22,140,10
44827,2902,2041,529,825,528,159,662,921,302,156,861,136,277,281,167,769,92
44828,35,35,0,20,15,0,5,30,0,0,0,0,0,0,0,0,0
44830,7984,5484,1328,2432,1359,365,1692,2320,932,540,2500,472,749,710,569,2149,351
44833,7425,5209,1113,2273,1419,404,1605,2465,733,406,2216,430,602,690,494,1916,300
44836,975,729,191,361,142,35,348,283,48,50,246,33,71,68,74,231,15
44837,1582,1196,322,493,317,64,418,566,145,67,386,69,125,110,82,326,60
44838,65,41,10,22,7,2,19,19,1,2,24,3,14,3,4,24,0
44839,4910,3475,634,1624,955,262,1245,1737,333,160,1435,333,407,421,274,1249,186
44840,1000,770,141,360,209,60,332,352,45,41,230,47,70,54,59,197,33
44841,315,252,42,139,66,5,91,114,23,24,63,18,16,12,17,48,15
44842,2186,1541,310,737,416,78,607,722,136,76,645,95,215,145,190,581,64
44843,883,721,100,372,178,71,268,347,43,63,162,33,52,48,29,125,37
44844,268,235,43,146,46,0,114,90,22,9,33,4,4,7,18,26,7
44846,1229,999,105,544,289,61,387,471,79,62,230,31,58,73,68,193,37
44847,1265,1017,207,502,244,64,417,440,80,80,248,46,48,86,68,218,30
44849,897,669,130,296,213,30,224,361,40,44,228,41,75,36,76,196,32
44850,31,21,0,0,16,5,0,21,0,0,10,5,0,0,5,10,0
44851,1909,1443,297,726,337,83,516,662,140,125,466,70,164,145,87,412,54
44853,489,387,41,203,107,36,166,188,16,17,102,15,26,26,35,96,6
44854,732,560,114,237,177,32,212,263,33,52,172,32,55,36,49,152,20
44855,392,325,94,152,61,18,171,120,19,15,67,17,19,22,9,52,15
44856,60,52,14,17,17,4,25,22,3,2,8,0,2,4,2,8,0
44857,8793,6150,1515,2826,1421,388,2298,2531,871,450,2643,583,774,743,543,2250,393
44859,626,525,88,292,109,36,195,261,32,37,101,7,52,16,26,78,23
44860,22,22,0,17,5,0,18,4,0,0,0,0,0,0,0,0,0
44861,57,53,7,22,14,10,11,27,0,15,4,0,0,4,0,4,0
44864,1216,931,146,473,258,54,294,498,92,47,285,21,138,77,49,249,36
44865,1298,1038,271,467,259,41,403,447,126,62,260,41,70,113,36,232,28
44866,665,499,85,263,141,10,228,210,32,29,166,40,80,27,19,127,39
44867,787,629,128,340,130,31,273,271,52,33,158,6,54,64,34,126,32
44870,17865,11456,2385,5173,3031,867,3385,4974,1959,1138,6409,1155,2120,1733,1401,5616,793
44874,70,44,8,25,8,3,13,19,6,6,26,10,6,2,8,16,10
44875,5807,4054,784,1837,1100,333,1402,1903,491,258,1753,320,498,503,432,1566,187
44878,994,855,188,440,200,27,377,352,61,65,139,6,59,43,31,102,37
44880,728,585,132,276,166,11,217,288,58,22,143,14,59,56,14,119,24
44882,1144,823,161,399,214,49,333,371,81,38,321,35,111,84,91,290,31
44883,11522,7803,1453,3744,1995,611,2608,3695,950,550,3719,879,1045,965,830,3113,606
44887,426,326,87,163,54,22,152,141,20,13,100,16,35,33,16,91,9
44889,2289,1844,275,972,493,104,716,910,98,120,445,55,168,148,74,350,95
44890,4450,3299,751,1472,882,194,1136,1441,512,210,1151,195,369,376,211,1013,138
44902,2614,1545,502,608,365,70,338,432,547,228,1069,220,416,285,148,895,174
44903,10120,7345,1472,3501,1920,452,2359,3225,1090,671,2775,430,1079,727,539,2363,412
44904,5318,3999,598,2144,1100,157,1424,2017,324,234,1319,224,401,356,338,1154,165
44905,5204,3534,785,1467,999,283,1060,1841,379,254,1670,291,605,498,276,1432,238
44906,7540,5022,916,2149,1558,399,1475,2479,674,394,2518,431,787,695,605,2186,332
44907,7010,4156,993,1607,1101,455,1169,2080,564,343,2854,599,676,823,756,2509,345
45001,327,237,63,107,57,10,82,65,60,30,90,11,39,26,14,76,14
45002,4106,3233,683,1610,747,193,1309,1318,336,270,873,166,279,291,137,687,186
45003,272,178,39,86,39,14,70,86,15,7,94,21,33,32,8,80,14
45005,10932,8164,1848,3719,2239,358,2805,3838,860,661,2768,578,768,1001,421,2322,446
45011,19314,14580,3801,7546,2716,517,6377,5101,1825,1277,4734,1014,1606,1469,645,3882,852
45013,19204,14097,2849,6494,3824,930,4813,6675,1591,1018,5107,875,1609,1492,1131,4455,652
45014,17451,11800,2788,5801,2666,545,4413,5284,1420,683,5651,2121,1921,1080,529,4593,1058
45015,5187,3462,1071,1418,702,271,1147,1329,565,421,1725,361,512,483,369,1499,226
45030,5890,4387,898,2321,947,221,1797,1755,462,373,1503,240,460,532,271,1281,222
45032,96,70,20,34,14,2,35,18,6,11,26,0,19,2,5,18,8
45033,56,51,16,20,15,0,29,22,0,0,5,0,0,5,0,5,0
45034,284,221,41,115,65,0,93,84,29,15,63,16,40,7,0,58,5
45036,9563,7310,1857,3484,1565,404,2742,3205,898,465,2253,506,640,572,535,1970,283
45039,5772,4388,930,2430,914,114,1832,2044,316,196,1384,385,523,371,105,1114,270
45040,11806,9246,2056,5349,1548,293,5037,3343,565,301,2560,679,928,627,326,2192,368
45041,93,68,14,17,29,8,26,28,14,0,25,7,10,0,8,25,0
45042,10911,7850,1611,3583,2083,573,2705,3736,812,597,3061,456,1105,853,647,2625,436
45044,17290,12059,3348,5455,2569,687,4044,4479,2231,1305,5231,948,1753,1615,915,4480,751
45050,2112,1570,342,642,420,166,541,776,113,140,542,67,225,105,145,483,59
45052,1381,1109,160,625,278,46,476,487,82,64,272,27,90,115,40,227,45
45053,978,845,114,510,186,35,421,355,37,32,133,8,71,38,16,117,16
45054,620,455,107,222,107,19,213,177,40,25,165,58,54,38,15,138,27
45056,7966,3933,822,1983,907,221,1418,1824,420,271,4033,2817,549,387,280,2114,1919
45062,158,113,14,50,32,17,34,62,6,11,45,10,18,12,5,29,16
45064,928,790,138,408,189,55,277,436,52,25,138,13,40,64,21,122,16
45065,1114,825,248,353,188,36,317,367,105,36,289,26,76,109,78,254,35
45066,5710,4921,974,2835,988,124,2364,2102,324,131,789,97,322,251,119,700,89
45067,3815,3043,819,1484,633,107,1344,1155,300,244,772,197,282,160,133,625,147
45068,3277,2599,350,1436,661,152,1069,1210,167,153,678,102,274,187,115,576,102
45069,14959,12260,2119,7333,2544,264,5831,5027,960,442,2699,925,882,640,252,2218,481
45070,69,56,14,27,9,6,21,16,9,10,13,2,2,7,2,11,2
45101,1026,672,208,265,168,31,225,257,131,59,354,58,124,117,55,290,64
45102,7164,5453,1533,2784,944,192,2372,2017,587,477,1711,422,637,428,224,1395,316
45103,9509,7066,1900,3615,1362,189,2878,2815,1002,371,2443,966,705,535,237,1924,519
45106,4146,3298,735,1625,819,119,1366,1365,369,198,848,75,282,282,209,685,163
45107,3055,2279,441,1216,552,70,858,992,221,208,776,121,155,273,227,673,103
45111,183,106,0,54,36,16,33,33,0,40,77,5,19,48,5,53,24
45112,32,18,3,6,5,4,4,14,0,0,14,1,6,7,0,13,1
45113,968,786,169,424,153,40,319,335,100,32,182,26,71,58,27,152,30
45114,16,16,0,8,8,0,0,16,0,0,0,0,0,0,0,0,0
45115,14,0,0,0,0,0,0,0,0,0,14,0,0,7,7,14,0
45118,1397,1068,201,559,274,34,514,474,55,25,329,46,143,71,69,253,76
45120,1254,951,219,529,166,37,384,365,129,73,303,63,77,110,53,240,63
45121,3150,2254,533,1039,582,100,758,927,350,219,896,93,250,295,258,796,100
45122,3987,3216,695,1570,821,130,1263,1431,294,228,771,164,277,225,105,565,206
45123,2830,1975,498,845,512,120,643,869,264,199,855,136,252,249,218,783,72
45130,1347,1088,239,528,264,57,421,461,95,111,259,48,74,85,52,219,40
45131,118,83,23,27,24,9,29,37,9,8,35,4,7,16,8,35,0
45132,103,80,28,27,21,4,32,29,13,6,23,8,4,7,4,17,6
45133,9035,6623,1533,2883,1739,468,2296,3007,841,479,2412,384,677,812,539,2108,304
45135,1358,1036,268,480,244,44,424,456,114,42,322,95,106,58,63,275,47
45140,15416,12397,2306,7333,2371,387,6253,4630,1031,483,3019,766,1237,714,302,2548,471
45142,1501,1162,247,562,299,54,548,474,77,63,339,61,81,141,56,301,38
45144,1747,1216,270,533,303,110,397,548,139,132,531,78,114,184,155,474,57
45146,510,402,90,175,124,13,170,178,31,23,108,17,38,30,23,102,6
45148,490,412,97,208,90,17,157,182,49,24,78,21,16,36,5,54,24
45150,11103,7770,1586,3952,1880,352,3109,3506,706,449,3333,707,1023,900,703,2906,427
45152,2961,2305,402,1172,615,116,882,1098,189,136,656,120,174,206,156,548,108
45153,740,581,95,294,175,17,209,273,60,39,159,21,74,38,26,133,26
45154,2869,2207,543,1136,410,118,968,777,258,204,662,125,233,183,121,540,122
45155,81,68,9,32,25,2,22,33,3,10,13,1,3,9,0,11,2
45156,30,25,4,15,6,0,10,6,9,0,5,0,0,2,3,5,0
45157,3211,2548,491,1336,613,108,965,1076,321,186,663,119,300,164,80,532,131
45159,1046,762,199,328,198,37,310,336,91,25,284,59,114,74,37,229,55
45160,351,177,52,91,23,11,61,53,46,17,174,20,33,53,68,167,7
45162,876,747,148,397,158,44,325,298,74,50,129,43,47,20,19,81,48
45164,99,69,17,31,21,0,30,26,3,10,30,7,13,3,7,24,6
45167,1478,1058,169,458,342,89,348,487,118,105,420,77,123,130,90,359,61
45168,582,424,140,184,79,21,167,174,49,34,158,31,35,38,54,130,28
45169,1956,1444,299,697,363,85,471,672,228,73,512,145,157,136,74,416,96
45171,2083,1659,348,762,429,120,533,842,188,96,424,39,151,143,91,362,62
45172,62,52,10,16,23,3,20,21,2,9,10,2,0,2,6,10,0
45174,775,648,50,392,150,56,351,237,39,21,127,14,29,49,35,122,5
45176,2898,2263,442,1185,523,113,886,1016,205,156,635,145,204,173,113,525,110
45177,8203,5675,1297,2714,1280,384,2057,2557,665,396,2528,621,718,648,541,2145,383
45202,3258,638,218,233,153,34,55,403,124,56,2620,947,896,534,243,2368,252
45203,1236,550,242,232,76,0,29,63,374,84,686,218,238,154,76,558,128
45204,3032,1602,562,632,329,79,435,430,426,311,1430,468,498,325,139,1102,328
45205,8932,5368,1627,2608,906,227,1546,1575,1537,710,3564,939,1148,943,534,3079,485
45206,6398,2442,723,1005,517,197,374,704,810,554,3956,1152,1347,998,459,3450,506
45207,2872,1809,418,778,460,153,309,368,631,501,1063,131,432,313,187,929,134
45208,8760,3834,931,1681,802,420,1380,1848,227,379,4926,2393,1175,731,627,4101,825
45209,5967,2118,755,835,413,115,627,947,231,313,3849,1686,1126,624,413,3259,590
45210,4364,1610,820,629,134,27,93,250,1072,195,2754,974,1020,587,173,2382,372
45211,16775,9560,2760,4345,1880,575,3058,3418,1962,1122,7215,2072,2307,1396,1440,6211,1004
45212,10746,5796,1523,2787,1244,242,1776,2135,1111,774,4950,1564,1604,1109,673,4111,839
45213,6081,3583,690,1737,868,288,885,1363,800,535,2498,490,914,695,399,2228,270
45214,4921,2448,877,1134,365,72,406,504,1082,456,2473,586,898,779,210,2157,316
45215,13184,8206,1537,3870,2058,741,2660,3245,1326,975,4978,1106,1456,1308,1108,4358,620
45216,4198,2474,709,1026,577,162,664,1025,439,346,1724,370,653,432,269,1463,261
45217,2630,1545,282,741,394,128,438,518,279,310,1085,174,321,372,218,937,148
45218,1723,1186,290,546,259,91,411,466,206,103,537,107,164,133,133,457,80
45219,7236,2285,863,891,398,133,322,653,797,513,4951,3245,1069,447,190,3407,1544
45220,7283,2462,730,1044,505,183,646,1080,358,378,4821,2879,1041,608,293,3599,1222
45223,5564,3186,1180,1335,504,167,580,707,1291,608,2378,728,1097,424,129,1886,492
45224,9688,5885,996,2850,1479,560,1606,2376,1129,774,3803,625,1179,1020,979,3490,313
45225,5215,3121,1674,1009,330,108,368,350,1939,464,2094,839,706,395,154,1773,321
45226,3268,1777,380,797,493,107,463,824,263,227,1491,865,336,189,101,1172,319
45227,8159,4836,1094,2357,1098,287,1423,1610,1052,751,3323,837,988,802,696,2903,420
45229,7885,4026,1119,1828,823,256,682,905,1611,828,3859,897,1325,1135,502,3453,406
45230,11983,7648,1640,3713,1788,507,2977,3559,666,446,4335,1130,1363,1063,779,3749,586
45231,16201,11675,2425,5492,3006,752,3794,4951,1723,1207,4526,861,1426,1390,849,3972,554
45232,2897,1835,923,661,207,44,253,231,1145,206,1062,210,420,200,232,959,103
45233,5364,4187,517,2324,1129,217,1884,1742,281,280,1177,133,323,323,398,1058,119
45236,11487,6759,1299,2920,1747,793,2224,3045,721,769,4728,923,1391,1157,1257,4279,449
45237,10524,6000,1281,2708,1537,474,1221,1902,1642,1235,4524,730,1757,1379,658,4069,455
45238,19238,12388,2755,5594,3043,996,4584,5142,1414,1248,6850,1706,1890,1680,1574,5963,887
45239,11983,7742,2006,3206,1888,642,2573,3182,1206,781,4241,994,1313,963,971,3686,555
45240,10545,7875,1597,3992,1989,297,2828,2980,1134,933,2670,867,898,633,272,2237,433
45241,9898,6784,825,3582,1976,401,2572,3399,471,342,3114,733,994,818,569,2691,423
45242,8579,6363,565,3681,1672,445,2616,2788,620,339,2216,416,697,647,456,1960,256
45243,5930,4571,343,2313,1435,480,1933,2108,255,275,1359,147,357,466,389,1273,86
45244,9416,7543,1121,4284,1911,227,3466,3096,599,382,1873,566,608,453,246,1513,360
45245,6569,4508,1124,2205,1015,164,1539,2144,495,330,2061,599,697,438,327,1716,345
45246,6013,3704,855,1633,889,327,1036,1686,707,275,2309,510,649,605,545,1983,326
45247,7723,5897,898,2974,1615,410,2243,2788,461,405,1826,386,560,582,298,1539,287
45248,8659,6417,933,3052,1905,527,2372,3165,445,435,2242,233,510,867,632,2075,167
45249,5177,3772,607,2193,856,116,1685,1665,268,154,1405,480,476,241,208,1107,298
45251,8622,6549,1208,3456,1529,356,2512,2653,784,600,2073,438,672,615,348,1797,276
45252,1886,1383,212,724,402,45,522,724,77,60,503,57,234,142,70,449,54
45255,8981,6317,991,3385,1594,347,2549,2804,589,375,2664,458,796,727,683,2330,334
45301,52,46,4,25,17,0,15,17,14,0,6,0,6,0,0,6,0
45302,1286,1040,218,569,184,69,519,392,78,51,246,45,83,50,68,226,20
45303,810,639,139,306,163,31,204,305,84,46,171,26,37,49,59,149,22
45304,2840,2240,511,939,644,146,829,1127,163,121,600,112,206,114,168,513,87
45305,3508,2778,519,1627,560,72,1166,1208,311,93,730,148,260,204,118,592,138
45306,825,632,125,298,158,51,281,280,33,38,193,48,44,64,37,178,15
45307,117,90,20,42,17,11,29,35,17,9,27,5,4,9,9,26,1
45308,1762,1378,286,638,333,121,483,684,129,82,384,63,109,97,115,343,41
45309,4793,3497,439,1704,1078,276,1191,1865,285,156,1296,215,352,347,382,1164,132
45310,40,32,6,13,5,8,10,19,1,2,8,4,2,0,2,6,2
45311,2741,2115,453,1008,546,108,777,1035,164,139,626,81,189,201,155,525,101
45312,527,447,45,226,163,13,135,258,34,20,80,11,27,16,26,77,3
45314,1191,866,186,427,207,46,320,442,72,32,325,133,52,76,64,243,82
45315,1259,937,164,527,204,42,445,355,115,22,322,90,100,80,52,248,74
45316,73,53,8,23,10,12,16,21,7,9,20,3,11,0,6,20,0
45317,443,357,52,143,130,32,90,207,28,32,86,0,25,35,26,70,16
45318,2043,1604,330,737,428,109,557,784,176,87,439,65,119,138,117,398,41
45320,5769,4286,877,1974,1171,264,1548,1993,440,305,1483,267,447,384,385,1291,192
45321,373,289,65,152,62,10,127,116,25,21,84,7,22,32,23,71,13
45322,8029,5880,1137,2885,1521,337,2208,2785,529,358,2149,377,661,560,551,1851,298
45323,2199,1583,264,715,489,115,521,832,118,112,616,66,215,224,111,523,93
45324,15998,9391,2294,4344,2302,451,2821,4171,1459,940,6607,3274,1427,1285,621,4773,1834
45325,921,774,102,426,196,50,297,408,39,30,147,37,41,51,18,118,29
45326,407,343,113,161,61,8,170,137,29,7,64,16,9,26,13,56,8
45327,3136,2438,374,1241,637,186,779,1284,228,147,698,152,229,201,116,597,101
45328,144,117,33,54,25,5,36,43,34,4,27,8,4,8,7,24,3
45330,119,81,27,30,10,14,26,36,12,7,38,10,8,12,8,36,2
45331,9432,6517,1270,2996,1770,481,2099,3111,763,544,2915,499,811,878,727,2620,295
45332,239,185,53,72,54,6,57,100,17,11,54,3,14,29,8,44,10
45333,530,412,88,193,104,27,174,198,12,28,118,29,42,8,39,93,25
45334,800,608,147,294,124,43,231,266,72,39,192,39,33,39,81,169,23
45335,2428,1940,415,991,436,98,727,883,226,104,488,60,176,136,116,391,97
45336,34,26,2,12,10,2,10,11,2,3,8,2,2,2,2,8,0
45337,779,614,104,320,154,36,253,309,34,18,165,28,41,70,26,123,42
45338,2016,1550,255,783,441,71,571,703,180,96,466,60,151,144,111,412,54
45339,510,406,50,247,76,33,156,204,26,20,104,19,31,25,29,87,17
45340,265,237,31,136,66,4,88,131,0,18,28,11,4,13,0,28,0
45341,1730,1198,178,562,329,129,364,538,146,150,532,60,137,219,116,445,87
45342,12989,8803,2201,4178,1871,553,3178,4066,1003,556,4186,1528,1304,767,587,3508,678
45344,6714,5146,1040,2337,1506,263,1888,2418,457,383,1568,290,509,538,231,1364,204
45345,2492,1924,402,907,455,160,638,871,197,218,568,64,205,222,77,524,44
45346,936,714,138,362,159,55,300,314,74,26,222,42,66,36,78,198,24
45347,1683,1237,220,611,317,89,438,594,108,97,446,79,131,135,101,363,83
45348,371,314,52,149,96,17,123,144,20,27,57,13,18,13,13,51,6
45349,3,3,0,3,0,0,3,0,0,0,0,0,0,0,0,0,0
45351,32,19,5,7,4,3,7,12,0,0,13,2,0,3,8,13,0
45352,8,4,0,0,4,0,0,4,0,0,4,0,0,4,0,4,0
45353,26,26,8,3,7,8,0,19,4,3,0,0,0,0,0,0,0
45354,117,95,21,38,32,4,30,44,18,3,22,9,7,6,0,11,11
45356,10075,7116,1776,3086,1778,476,2194,3249,1077,596,2959,540,927,802,690,2533,426
45358,0,0,0,0,0,0,0,0,0,0,0,0,0,0,0,0,0
45359,706,585,98,263,169,55,208,316,38,23,121,12,34,41,34,110,11
45360,83,69,12,34,23,0,28,37,4,0,14,6,8,0,0,13,1
45362,446,329,53,173,74,29,131,164,21,13,117,21,33,33,30,104,13
45363,494,412,95,215,82,20,224,161,14,13,82,16,21,13,32,80,2
45365,11490,8252,2045,3825,1923,459,3035,3556,1065,596,3238,601,1001,839,797,2722,516
45368,1901,1461,298,707,392,64,509,694,162,96,440,65,108,138,129,383,57
45369,1160,913,176,472,232,33,358,455,61,39,247,50,88,67,42,190,57
45370,954,704,92,357,225,30,200,423,43,38,250,34,127,52,37,196,54
45371,6696,5065,800,2563,1491,211,1911,2452,447,255,1631,288,476,510,357,1358,273
45373,12575,8832,2030,4260,2034,508,3184,4036,1088,524,3743,721,1182,1059,781,3230,513
45377,6304,4147,725,1974,1231,217,1383,2029,443,292,2157,715,702,451,289,1863,294
45378,140,104,31,40,29,4,36,56,10,2,36,6,19,7,4,25,11
45380,1926,1402,289,640,353,120,596,632,90,84,524,100,121,152,151,481,43
45381,2211,1750,311,909,412,118,675,811,152,112,461,81,110,168,102,399,62
45382,424,352,63,165,88,36,142,160,31,19,72,14,27,13,18,70,2
45383,2878,2139,384,1050,628,77,718,1019,290,112,739,130,244,197,168,635,104
45384,51,51,0,25,26,0,11,28,0,12,0,0,0,0,0,0,0
45385,13307,9768,2125,4583,2448,612,3231,4390,1368,779,3539,622,1036,1170,711,3071,468
45387,2230,1467,160,799,392,116,471,695,217,84,763,157,282,235,89,633,130
45388,302,267,77,109,74,7,136,104,13,14,35,5,11,8,11,33,2
45389,196,141,37,63,27,14,39,67,22,13,55,13,6,21,15,41,14
45390,1380,997,252,411,268,66,371,471,117,38,383,62,114,123,84,308,75
45402,1413,225,100,75,41,9,39,122,26,38,1188,286,478,279,145,1061,127
45403,6873,4037,1318,1713,816,190,1168,1346,909,614,2836,673,1141,717,305,2212,624
45404,5165,3397,1042,1428,696,231,805,1048,978,566,1768,382,668,491,227,1436,332
45405,10380,5452,1801,2474,865,312,1470,1707,1428,847,4928,1123,2079,1131,595,4236,692
45406,11284,6822,1681,3319,1524,298,1518,2014,2009,1281,4462,818,1851,1330,463,3944,518
45407,4344,2575,658,1058,701,158,352,558,957,708,1769,213,634,584,338,1560,209
45408,4418,2827,905,1033,560,329,275,702,1146,704,1591,221,477,598,295,1432,159
45409,3475,1731,350,842,375,164,699,668,176,188,1744,707,540,209,288,1230,514
45410,7751,4099,1262,1832,733,272,1243,1578,731,547,3652,996,1183,948,525,2940,712
45414,8988,6282,1359,2735,1725,463,1656,2781,1237,608,2706,538,790,950,428,2280,426
45415,5306,3504,517,1677,978,332,1141,1887,294,182,1802,326,672,429,375,1584,218
45416,2339,1738,331,812,491,104,397,651,398,292,601,82,246,178,95,552,49
45417,4715,2833,689,1175,731,238,355,650,969,859,1882,250,474,733,425,1712,170
45418,2143,1552,279,581,577,115,341,695,264,252,591,54,192,249,96,531,60
45419,6680,3946,682,2020,946,298,1482,1703,442,319,2734,902,782,590,460,2424,310
45420,12421,6834,1760,2954,1519,601,2068,3105,905,756,5587,1508,1591,1364,1124,4697,890
45424,18265,13624,2928,6968,3346,382,5180,5868,1556,1020,4641,1159,1556,1392,534,3854,787
45426,7145,4533,978,2088,1107,360,1044,1882,1103,504,2612,408,1044,630,530,2292,320
45427,4266,2956,743,1151,874,188,609,969,844,534,1310,119,425,516,250,1181,129
45429,12204,7582,1168,3337,2077,1000,2468,4076,519,519,4622,898,1118,1209,1397,4173,449
45430,2558,2054,248,1094,598,114,824,1077,93,60,504,75,167,143,119,427,77
45431,8831,6191,1768,2638,1437,348,2398,2602,752,439,2640,850,727,704,359,2079,561
45432,6676,4552,706,2131,1408,307,1500,2285,374,393,2124,548,634,535,407,1768,356
45433,776,776,266,502,8,0,575,139,47,15,0,0,0,0,0,0,0
45434,3537,2961,253,1663,928,117,1129,1525,140,167,576,69,199,210,98,517,59
45439,4597,2915,854,1228,714,119,901,1073,552,389,1682,469,563,454,196,1404,278
45440,8223,5540,831,2723,1600,386,1887,2812,573,268,2683,1007,637,635,404,2199,484
45449,8231,5154,1486,2191,1235,242,1616,2351,790,397,3077,954,971,812,340,2549,528
45458,10363,7099,1208,3882,1637,372,2750,3157,766,426,3264,900,1133,745,486,2812,452
45459,11955,7994,1087,3452,2758,697,2576,4435,443,540,3961,1027,1097,1050,787,3433,528
45502,6347,4935,645,2595,1458,237,1758,2650,273,254,1412,179,348,559,326,1266,146
45503,13787,9045,2133,3773,2352,787,2811,4172,1253,809,4742,821,1293,1278,1350,4133,609
45504,7389,4967,1051,2253,1191,472,1631,2162,693,481,2422,571,712,622,517,1938,484
45505,9208,5919,1681,2521,1306,411,1609,2265,1335,710,3289,522,1005,1099,663,2825,464
45506,5975,4110,897,1963,965,285,1068,1535,962,545,1865,185,654,672,354,1564,301
45601,20354,14145,3397,6385,3504,859,4822,6205,1823,1295,6209,1116,1846,1907,1340,5268,941
45612,1828,1444,338,658,398,50,545,632,170,97,384,69,147,95,73,315,69
45613,1224,944,309,349,227,59,349,372,136,87,280,67,85,69,59,236,44
45614,1631,1145,235,585,297,28,412,526,112,95,486,72,135,197,82,441,45
45616,495,401,96,170,130,5,137,210,46,8,94,0,33,45,16,82,12
45619,3198,2325,434,1083,632,176,691,1122,301,211,873,202,192,340,139,775,98
45620,450,359,62,159,115,23,155,166,20,18,91,3,18,38,32,90,1
45621,71,54,23,21,8,2,26,18,8,2,17,2,5,4,6,14,3
45622,145,110,29,51,24,6,31,46,19,14,35,0,25,10,0,17,18
45623,1434,1134,276,496,326,36,459,506,116,53,300,35,92,137,36,265,35
45624,41,26,7,19,0,0,26,0,0,0,15,0,8,7,0,15,0
45628,1816,1329,314,617,328,70,542,569,111,107,487,52,141,179,115,442,45
45629,1228,963,199,473,221,70,335,437,107,84,265,8,72,113,72,240,25
45631,6500,4338,839,1989,1170,340,1400,1973,481,484,2162,305,744,680,433,1871,291
45634,741,573,130,243,161,39,187,290,52,44,168,18,60,40,50,149,19
45638,9040,6191,1342,2660,1651,538,1761,2908,943,579,2849,343,797,979,730,2548,301
45640,5909,4359,1040,1939,1053,327,1530,1882,556,391,1550,143,473,632,302,1424,126
45642,22,11,11,0,0,0,0,6,5,0,11,5,6,0,0,11,0
45644,1529,1144,240,597,259,48,481,498,98,67,385,35,137,111,102,321,64
45645,1018,815,209,406,178,22,354,364,71,26,203,48,43,88,24,174,29
45646,130,106,5,46,55,0,21,55,6,24,24,0,12,12,0,24,0
45647,712,554,101,238,167,48,136,305,66,47,158,25,36,46,51,130,28
45648,4440,3379,794,1480,949,156,1067,1579,421,312,1061,140,313,361,247,948,113
45650,242,135,17,55,57,6,27,78,13,17,107,6,42,20,39,92,15
45651,2324,1653,403,801,357,92,585,712,230,126,671,111,207,246,107,599,72
45652,1359,1067,254,490,242,81,363,425,173,106,292,51,62,149,30,278,14
45653,1554,1246,232,663,266,85,512,520,100,114,308,27,87,123,71,275,33
45654,393,297,54,135,108,0,101,131,36,29,96,6,38,36,16,88,8
45656,2604,1822,520,731,461,110,566,871,191,194,782,108,212,319,143,675,107
45657,938,711,173,317,175,46,273,331,84,23,227,44,70,80,33,205,22
45658,796,618,133,313,148,24,314,229,37,38,178,25,83,55,15,140,38
45659,1166,925,284,409,202,30,429,301,72,123,241,11,78,66,86,217,24
45660,2809,2125,520,992,504,109,767,854,300,204,684,72,253,206,153,593,91
45661,2530,1880,542,866,389,83,697,716,355,112,650,89,211,190,160,552,98
45662,13313,8141,2013,3443,2085,600,2420,3377,1254,1090,5172,799,1278,1761,1334,4577,595
45663,2758,2069,510,934,528,97,668,892,325,184,689,142,151,242,154,580,109
45669,4040,3044,600,1294,921,229,918,1562,288,276,996,145,325,308,218,870,126
45671,120,81,22,42,14,3,36,26,6,13,39,17,10,6,6,26,13
45672,603,444,109,192,113,30,193,201,30,20,159,34,47,63,15,139,20
45673,167,115,7,58,40,10,35,60,0,20,52,0,16,25,11,52,0
45674,187,123,58,37,20,8,32,38,50,3,64,34,17,13,0,47,17
45678,424,299,43,115,141,0,78,170,15,36,125,11,64,0,50,114,11
45679,1011,709,149,285,232,43,224,389,68,28,302,26,98,129,49,270,32
45680,5101,3725,824,1582,1077,242,1275,1678,399,373,1376,224,387,520,245,1245,131
45681,524,393,88,194,109,2,161,182,34,16,131,29,38,57,7,108,23
45682,929,700,199,274,210,17,259,307,74,60,229,28,68,97,36,209,20
45684,678,487,94,228,130,35,167,238,34,48,191,18,78,59,36,153,38
45685,313,266,57,137,54,18,98,112,23,33,47,9,8,16,14,47,0
45686,1332,1046,255,492,241,58,327,454,161,104,286,48,63,109,66,226,60
45688,189,138,47,62,17,12,40,41,46,11,51,0,20,22,9,37,14
45690,5574,3950,998,1675,929,348,1304,1822,537,287,1624,242,431,518,433,1389,235
45692,3638,2659,616,1274,647,122,893,988,419,359,979,126,271,347,235,876,103
45693,3233,2263,588,989,532,154,795,987,317,164,970,175,268,325,202,837,133
45694,4360,3240,744,1467,813,216,1101,1516,394,229,1120,182,347,343,248,987,133
45695,300,199,50,87,59,3,52,92,43,12,101,9,46,36,10,101,0
45696,514,416,87,201,128,0,153,153,77,33,98,0,20,53,25,93,5
45697,1697,1379,300,672,336,71,558,576,134,111,318,40,66,114,98,289,29
45698,112,77,19,33,17,8,15,41,16,5,35,2,6,15,12,28,7
45701,10283,4618,1084,2197,1103,234,1545,2289,497,287,5665,3784,838,647,396,3112,2553
45710,1983,1424,271,694,357,102,492,715,154,63,559,162,150,147,100,449,110
45711,498,299,50,149,77,23,61,137,63,38,199,40,69,56,34,183,16
45712,91,54,7,37,0,10,7,19,18,10,37,0,9,17,11,37,0
45713,47,38,10,18,10,0,20,10,8,0,9,0,9,0,0,9,0
45714,4418,3010,612,1320,831,247,820,1569,388,233,1408,250,519,370,269,1216,192
45715,982,683,150,256,202,75,219,385,60,19,299,51,77,95,76,265,34
45716,138,101,29,42,24,6,35,44,12,10,37,4,12,5,16,31,6
45719,442,285,87,117,71,10,79,104,67,35,157,30,55,48,24,126,31
45723,1365,1021,209,462,304,46,347,524,72,78,344,33,120,93,98,288,56
45724,544,422,87,232,74,29,147,204,48,23,122,7,16,51,48,97,25
45727,191,134,20,86,28,0,59,57,10,8,57,15,6,32,4,54,3
45729,538,415,70,198,122,25,144,234,25,12,123,17,32,74,0,108,15
45732,2016,1406,342,667,313,84,458,580,230,138,610,90,169,188,163,494,116
45734,279,219,36,93,66,24,79,106,23,11,60,19,9,22,10,31,29
45735,621,457,68,224,133,32,133,251,58,15,164,40,54,19,51,142,22
45740,185,116,28,52,27,9,48,41,12,15,69,7,14,28,20,66,3
45741,336,250,32,180,38,0,106,112,20,12,86,9,38,17,22,73,13
45742,1145,935,175,477,244,39,363,459,97,16,210,14,79,80,37,171,39
45743,645,484,101,260,105,18,159,246,45,34,161,31,25,49,56,145,16
45744,1202,868,142,409,266,51,333,360,60,115,334,14,109,133,78,303,31
45745,414,320,18,193,83,26,95,192,17,16,94,16,7,34,37,76,18
45746,181,131,40,39,50,2,40,62,17,12,50,8,10,28,4,38,12
45750,11309,7542,1395,3449,2150,548,2368,3642,883,649,3767,672,1189,1045,861,3275,492
45760,1620,1038,229,439,298,72,293,440,180,125,582,68,146,174,194,485,97
45761,674,466,80,258,106,22,154,172,94,46,208,71,51,48,38,140,68
45764,3532,2126,528,937,552,109,642,946,305,233,1406,642,295,296,173,1013,393
45766,559,414,102,214,78,20,144,192,48,30,145,41,34,51,19,101,44
45767,1176,838,149,391,239,59,287,424,69,58,338,39,101,117,81,311,27
45768,760,604,115,266,193,30,222,324,49,9,156,31,50,38,37,130,26
45769,2639,1879,424,873,450,132,625,845,234,175,760,92,235,216,217,694,66
45770,197,130,6,76,37,11,30,80,12,8,67,0,41,8,18,57,10
45771,1426,1057,194,418,384,61,346,523,106,82,369,53,136,101,79,323,46
45772,816,608,108,269,192,39,234,327,34,13,208,40,60,77,31,192,16
45773,69,69,10,28,23,8,20,49,0,0,0,0,0,0,0,0,0
45775,471,371,77,154,118,22,109,190,48,24,100,19,48,28,5,81,19
45776,332,201,46,111,34,10,59,98,30,14,131,13,41,56,21,131,0
45778,349,284,55,143,78,8,126,109,36,13,65,18,42,5,0,54,11
45779,304,231,39,105,71,16,55,136,23,17,73,7,14,28,24,67,6
45780,1369,834,242,349,211,32,271,383,117,63,535,201,98,177,59,457,78
45782,107,74,22,34,14,4,25,29,15,5,33,3,19,9,2,22,11
45784,1139,883,106,492,257,28,334,434,83,32,256,63,92,70,31,224,32
45786,1091,883,148,437,231,67,351,404,81,47,208,54,65,46,43,169,39
45788,386,304,22,197,79,6,115,171,5,13,82,8,14,42,18,74,8
45789,111,99,61,38,0,0,10,27,35,27,12,0,0,12,0,12,0
45801,9056,6221,1678,2817,1404,322,1947,2362,1301,611,2835,635,981,797,422,2405,430
45804,7103,4498,1252,1917,1062,267,975,1737,1193,593,2605,362,811,871,561,2292,313
45805,9452,6207,1182,2838,1655,532,1794,2967,908,538,3245,735,883,728,899,2891,354
45806,4144,3203,566,1550,917,170,1183,1598,312,110,941,155,303,275,208,790,151
45807,4166,3252,514,1652,927,159,1242,1662,211,137,914,155,240,308,211,837,77
45808,126,107,18,47,32,10,32,50,14,11,19,0,6,5,8,19,0
45809,90,71,18,32,16,5,13,39,19,0,19,12,0,7,0,13,6
45810,2734,1649,502,723,287,137,610,704,195,140,1085,569,139,221,156,844,241
45812,821,567,136,222,170,39,167,271,63,66,254,42,80,87,45,217,37
45813,1423,1019,187,498,278,56,351,487,117,64,404,98,112,107,87,358,46
45814,889,675,134,376,125,40,276,312,53,34,214,31,28,60,95,192,22
45816,110,76,16,33,27,0,34,31,3,8,34,11,3,16,4,34,0
45817,2188,1576,246,791,397,142,604,757,137,78,612,110,149,102,251,552,60
45819,110,90,36,26,23,5,29,40,16,5,20,5,4,9,2,17,3
45820,160,123,32,57,23,11,40,48,19,16,37,3,6,20,8,31,6
45821,552,454,145,200,92,17,177,183,76,18,98,26,20,40,12,71,27
45822,7613,5433,1032,2613,1402,386,2078,2504,521,330,2180,340,644,648,548,1956,224
45827,837,658,121,372,119,46,307,242,57,52,179,38,43,44,54,163,16
45828,2176,1697,385,776,414,122,851,679,69,98,479,59,156,144,120,458,21
45830,2162,1667,342,792,420,113,687,766,124,90,495,87,140,133,135,438,57
45831,1202,898,199,446,208,45,386,390,86,36,304,50,75,77,102,272,32
45832,1091,855,197,433,170,55,348,346,101,60,236,36,86,57,57,220,16
45833,4155,3058,686,1465,736,171,1279,1332,269,178,1097,155,266,325,351,1014,83
45835,189,143,28,43,66,6,49,77,17,0,46,0,34,6,6,33,13
45836,564,437,85,207,104,41,169,204,38,26,127,25,30,43,29,108,19
45837,35,31,7,15,9,0,13,7,5,6,4,4,0,0,0,4,0
45838,8,8,4,4,0,0,4,2,2,0,0,0,0,0,0,0,0
45840,20550,13694,3233,6298,3212,951,4979,6233,1595,887,6856,2046,2109,1497,1204,5700,1156
45841,373,291,42,180,43,26,126,130,13,22,82,4,49,4,25,74,8
45843,1400,1075,247,531,273,24,382,500,138,55,325,32,104,109,80,283,42
45844,1240,996,153,548,238,57,487,411,54,44,244,45,28,66,105,237,7
45845,990,779,166,378,181,54,405,303,30,41,211,57,60,42,52,191,20
45846,1397,1085,221,524,258,82,539,445,41,60,312,63,60,79,110,284,28
45849,462,351,65,152,98,36,119,171,31,30,111,18,23,20,50,101,10
45850,1390,1112,225,512,305,70,435,535,68,74,278,36,66,94,82,247,31
45851,220,189,31,92,56,10,87,71,9,22,31,7,12,6,6,25,6
45853,373,289,76,131,68,14,132,106,21,30,84,15,22,14,33,81,3
45855,77,60,10,25,19,6,18,36,6,0,17,0,9,4,4,11,6
45856,1915,1482,292,677,358,155,594,641,130,117,433,74,80,123,156,391,42
45858,1087,866,207,422,184,53,333,347,124,62,221,22,74,63,62,210,11
45859,170,117,30,53,21,13,26,45,29,17,53,11,13,16,13,43,10
45860,693,588,153,261,132,42,338,204,18,28,105,20,24,22,39,88,17
45861,87,59,20,28,11,0,25,19,10,5,28,7,4,7,10,19,9
45862,573,455,86,224,102,43,147,239,63,6,118,22,25,37,34,99,19
45863,451,334,57,185,76,16,142,147,11,34,117,21,30,40,26,111,6
45865,1737,1310,215,609,382,104,526,680,52,52,427,85,123,114,105,395,32
45866,39,24,4,13,7,0,11,9,1,3,15,4,7,4,0,9,6
45867,455,365,70,154,127,14,144,193,18,10,90,17,10,23,40,80,10
45868,273,210,35,107,54,14,86,88,9,27,63,4,12,21,26,61,2
45869,1632,1286,245,651,295,95,600,544,83,59,346,71,97,86,92,325,21
45870,39,26,5,12,9,0,10,8,0,8,13,8,0,0,5,5,8
45871,643,484,105,222,118,39,163,262,42,17,159,31,44,31,53,145,14
45872,1568,1138,323,481,265,69,403,487,161,87,430,57,130,145,98,369,61
45873,919,695,136,341,193,25,245,342,68,40,224,60,68,55,41,189,35
45874,911,696,134,314,196,52,249,343,64,40,215,33,47,77,58,196,19
45875,3941,2913,621,1413,686,193,1317,1175,260,161,1028,190,346,260,232,920,108
45876,177,112,21,48,30,13,48,39,14,11,65,16,20,13,16,61,4
45877,797,629,117,287,181,44,277,301,22,29,168,34,50,35,49,146,22
45879,2515,1809,310,901,457,141,670,800,157,182,706,119,183,204,200,623,83
45880,960,692,147,302,181,62,202,345,85,60,268,54,55,89,70,234,34
45881,444,386,59,211,91,25,140,185,31,30,58,13,15,18,12,52,6
45882,1100,801,140,377,235,49,273,439,50,39,299,65,74,106,54,265,34
45883,1111,937,175,450,239,73,488,385,35,29,174,46,38,33,57,161,13
45885,4992,3514,779,1630,827,278,1374,1523,380,237,1478,302,326,427,423,1329,149
45886,200,170,29,88,37,16,64,94,4,8,30,7,5,8,10,24,6
45887,1771,1363,309,617,345,92,490,641,144,88,408,87,120,100,101,344,64
45888,66,56,12,21,19,4,13,23,13,7,10,5,0,0,5,10,0
45889,409,355,40,220,88,7,157,168,13,17,54,5,18,19,12,51,3
45890,257,176,42,70,55,9,63,76,29,8,81,17,15,20,29,71,10
45891,6326,4460,965,1954,1170,371,1447,2194,466,353,1866,313,534,529,490,1667,199
45894,259,206,22,113,52,19,91,95,20,0,53,0,6,32,15,50,3
45895,6781,4994,1014,2473,1174,333,1961,2244,487,302,1787,322,555,457,453,1552,235
45896,738,582,134,255,154,39,235,250,55,42,156,19,50,54,33,141,15
45897,24,17,17,0,0,0,0,8,9,0,7,0,0,0,7,7,0
45898,485,367,82,187,65,33,172,135,46,14,118,29,34,34,21,100,18
45899,96,44,11,22,5,6,15,21,3,5,52,16,19,12,5,43,9
46001,4736,3489,776,1613,874,226,1317,1515,405,252,1247,199,316,477,255,1111,136
46011,6984,5148,947,2339,1448,414,1486,2655,587,420,1836,272,583,474,507,1662,174
46012,8505,5863,1115,2521,1706,521,1574,3227,635,427,2642,597,696,693,656,2309,333
46013,8220,5060,1213,1953,1423,471,1452,2571,650,387,3160,450,812,995,903,2793,367
46016,8853,5324,1789,2144,1085,306,1326,1762,1411,825,3529,624,1121,1087,697,3017,512
46017,2542,1804,421,781,509,93,598,913,211,82,738,163,241,212,122,633,105
46030,1216,984,235,472,221,56,314,516,89,65,232,55,57,63,57,188,44
46031,852,636,140,391,89,16,295,251,67,23,216,25,46,65,80,190,26
46032,12944,9776,1744,6081,1596,355,5116,3633,656,371,3168,873,865,776,654,2636,532
46033,9600,8498,1130,5257,1888,223,4613,3275,346,264,1102,141,454,405,102,961,141
46034,2128,1669,303,935,367,64,713,708,149,99,459,103,223,61,72,336,123
46035,403,263,77,116,66,4,116,128,19,0,140,37,22,57,24,118,22
46036,5141,3735,856,1567,1045,267,1112,1816,471,336,1406,201,467,425,313,1254,152
46038,15248,11327,3749,6094,1315,169,6104,4001,833,389,3921,1676,1526,460,259,3069,852
46039,318,235,83,81,48,23,50,144,24,17,83,0,29,22,32,75,8
46040,2146,1560,272,892,257,139,630,552,159,219,586,108,161,246,71,463,123
46041,9228,6562,1681,2988,1491,402,2322,2812,886,542,2666,421,719,900,626,2255,411
46044,1120,844,180,358,231,75,275,423,83,63,276,32,79,68,97,254,22
46045,23,23,0,23,0,0,23,0,0,0,0,0,0,0,0,0,0
46047,25,9,6,0,3,0,6,3,0,0,16,13,3,0,0,8,8
46048,452,359,86,160,97,16,140,166,31,22,93,23,28,21,21,73,20
46049,354,265,48,106,80,31,78,155,10,22,89,13,31,16,29,71,18
46050,684,537,108,194,166,69,167,261,68,41,147,24,38,58,27,121,26
46051,1013,750,169,337,190,54,242,348,122,38,263,37,76,74,76,221,42
46052,8284,5789,1360,2753,1396,280,2373,2447,534,435,2495,567,733,630,565,2067,428
46055,1045,892,185,418,248,41,319,476,40,57,153,12,41,83,17,131,22
46056,774,645,134,255,210,46,203,380,39,23,129,10,39,50,30,112,17
46057,450,377,104,177,70,26,199,149,19,10,73,17,13,9,34,59,14
46058,769,526,120,274,98,34,232,225,37,32,243,51,71,40,81,212,31
46060,15912,12314,3220,6413,2274,407,5757,4882,1131,544,3598,853,1223,858,664,3048,550
46063,51,40,6,17,17,0,6,20,7,7,11,4,1,2,4,9,2
46064,3762,2934,538,1466,813,117,1213,1245,302,174,828,130,322,151,225,760,68
46065,1031,811,188,396,178,49,359,345,55,52,220,43,66,80,31,176,44
46068,1094,913,189,461,231,32,397,427,44,45,181,38,46,52,45,150,31
46069,2448,1970,392,972,459,147,724,962,206,78,478,32,164,155,127,457,21
46070,891,688,187,253,190,58,225,328,77,58,203,37,44,81,41,174,29
46071,1288,1021,224,533,207,57,411,468,92,50,267,26,97,83,61,234,33
46072,3808,2687,560,1137,802,188,910,1347,260,170,1121,209,266,272,374,1012,109
46074,3288,2369,832,1159,318,60,1164,820,265,120,919,237,377,126,179,763,156
46075,648,470,65,237,158,10,173,250,29,18,178,32,65,46,35,125,53
46076,707,545,110,262,136,37,214,266,38,27,162,20,58,49,35,152,10
46077,5360,4298,568,2635,963,132,2180,1650,296,172,1062,229,320,278,235,846,216
46102,15,13,5,2,6,0,7,4,0,2,2,0,2,0,0,2,0
46103,61,45,12,31,2,0,24,10,11,0,16,5,9,0,2,9,7
46104,437,362,57,198,83,24,135,177,30,20,75,4,6,49,16,71,4
46105,735,589,122,236,177,54,190,276,51,72,146,13,44,61,28,129,17
46106,1595,1261,197,725,285,54,430,643,127,61,334,54,108,81,91,284,50
46107,4839,3070,720,1479,551,320,1002,1288,568,212,1769,389,643,310,427,1499,270
46110,178,158,24,96,25,13,68,77,5,8,20,20,0,0,0,12,8
46111,80,71,16,30,25,0,14,26,13,18,9,0,8,0,1,9,0
46112,8973,7241,1518,3854,1557,312,3271,3126,616,228,1732,497,528,404,303,1479,253
46113,2239,1878,532,940,327,79,716,834,150,178,361,46,102,106,107,315,46
46115,766,578,127,283,151,17,241,256,54,27,188,27,48,74,39,157,31
46117,221,185,16,98,53,18,89,82,4,10,36,9,0,20,7,30,6
46118,1752,1454,242,744,436,32,473,741,161,79,298,61,81,62,94,245,53
46120,2349,1755,347,863,479,66,659,844,173,79,594,93,199,176,126,504,90
46121,1573,1265,219,626,357,63,483,656,68,58,308,55,94,116,43,294,14
46122,4518,3543,572,2014,806,151,1503,1525,227,288,975,172,297,263,243,806,169
46123,7166,5828,1382,3135,1150,161,2772,2450,437,169,1338,405,542,261,130,988,350
46124,2763,1999,476,1030,415,78,777,898,196,128,764,106,272,223,163,628,136
46125,17,8,0,0,8,0,0,8,0,0,9,0,0,5,4,9,0
46126,1614,1332,166,760,352,54,539,592,113,88,282,62,81,83,56,218,64
46127,145,119,12,54,29,24,22,65,25,7,26,0,17,0,9,26,0
46128,776,670,128,350,174,18,244,353,58,15,106,2,44,46,14,69,37
46130,666,490,77,304,96,13,213,244,26,7,176,49,30,66,31,143,33
46131,9482,7081,2009,3183,1466,423,2697,3039,872,473,2401,546,849,554,452,1982,419
46133,318,251,46,127,59,19,114,109,20,8,67,5,8,39,15,67,0
46135,6307,4449,1011,2141,1043,254,1718,2063,460,208,1858,365,489,660,344,1624,234
46140,12813,9703,1767,4825,2634,477,3794,4727,775,407,3110,627,962,916,605,2694,416
46142,11637,8685,1736,4428,2182,339,3617,3875,723,470,2952,927,861,731,433,2438,514
46143,12518,9064,2197,4631,1869,367,3732,3858,980,494,3454,921,958,882,693,2980,474
46144,75,57,14,32,11,0,9,44,4,0,18,0,7,0,11,18,0
46147,1045,781,149,418,155,59,327,330,62,62,264,64,66,93,41,203,61
46148,1840,1347,234,671,360,82,477,641,106,123,493,101,111,166,115,417,76
46149,657,502,91,267,120,24,216,217,44,25,155,32,52,50,21,120,35
46150,339,235,60,109,56,10,85,118,32,0,104,13,18,8,65,99,5
46151,11772,8983,1963,4392,2250,378,3340,4185,916,542,2789,490,893,814,592,2336,453
46155,83,64,13,29,7,15,30,7,12,15,19,0,5,0,14,19,0
46156,547,412,122,190,87,13,186,136,51,39,135,37,22,42,34,111,24
46157,976,818,152,386,243,37,298,417,52,51,158,25,37,61,35,128,30
46158,8707,6862,1554,3372,1684,252,2656,2995,786,425,1845,388,680,556,221,1504,341
46160,2310,1747,248,879,492,128,580,948,98,121,563,77,180,160,146,469,94
46161,953,762,126,377,186,73,262,370,61,69,191,29,57,43,62,162,29
46162,118,88,9,62,17,0,41,40,0,7,30,5,7,7,11,18,12
46163,3284,2847,427,1746,617,57,1257,1215,216,159,437,48,172,132,85,379,58
46164,1527,1165,153,613,359,40,368,667,88,42,362,89,110,128,35,295,67
46165,567,421,85,225,88,23,159,207,41,14,146,17,41,38,50,122,24
46166,814,672,148,306,188,30,252,281,69,70,142,22,37,54,29,103,39
46167,1678,1401,257,757,307,80,584,643,86,88,277,53,57,111,56,257,20
46168,7971,5758,1266,2885,1294,313,2167,2673,662,256,2213,277,659,768,509,1971,242
46171,603,472,44,277,121,30,178,258,12,24,131,17,37,49,28,116,15
46172,915,720,158,320,201,41,276,325,62,57,195,36,46,58,55,171,24
46173,4401,3162,702,1477,772,211,1134,1394,387,247,1239,198,444,308,289,1078,161
46175,249,149,22,60,51,16,40,96,5,8,100,6,16,36,42,90,10
46176,10562,7284,1657,3494,1558,575,2465,3209,926,684,3278,788,1015,909,566,2768,510
46180,388,305,61,130,92,22,98,159,35,13,83,4,37,29,13,80,3
46181,1579,1289,277,592,377,43,546,613,80,50,290,33,123,80,54,229,61
46182,724,524,118,232,124,50,235,213,53,23,200,24,68,63,45,184,16
46184,3147,2611,609,1310,626,66,1217,1038,247,109,536,122,203,142,69,421,115
46186,639,529,119,262,139,9,206,258,35,30,110,4,33,45,28,96,14
46201,15167,8802,2804,4023,1588,387,2419,2518,2356,1509,6365,1558,2617,1541,649,4917,1448
46202,7924,2541,845,901,631,164,426,869,637,609,5383,2321,1708,1007,347,4466,917
46203,15612,10168,2933,4331,2243,661,2632,3439,2362,1735,5444,1170,1877,1598,799,4360,1084
46204,1676,202,72,73,49,8,14,131,25,32,1474,607,413,380,74,1308,166
46205,12045,6867,1850,3170,1488,359,1332,1989,2078,1468,5178,1453,2191,1029,505,4106,1072
46208,10497,5353,1298,2118,1289,648,972,1690,1390,1301,5144,1208,1655,1365,916,4324,820
46214,10420,5339,1645,2330,1060,304,1855,2315,642,527,5081,2175,1390,795,721,4173,908
46216,122,46,0,30,7,9,26,16,0,4,76,23,39,0,14,48,28
46217,7247,5495,1041,2782,1366,306,2201,2559,459,276,1752,497,602,432,221,1425,327
46218,13437,8877,2202,3593,2490,592,1350,2760,2734,2033,4560,569,1674,1583,734,3926,634
46219,15871,9364,2062,4290,2178,834,2691,3953,1617,1103,6507,1167,2274,1640,1426,5522,985
46220,16671,8721,1959,4171,1872,719,2876,4086,931,828,7950,2991,2652,1388,919,6183,1767
46221,8971,6376,1811,2910,1352,303,2257,2399,1049,671,2595,534,829,811,421,2121,474
46222,13858,8510,2674,3703,1682,451,2180,2439,2180,1711,5348,1320,2179,1209,640,4121,1227
46224,15269,8467,3010,3398,1469,590,2574,2890,2010,993,6802,2508,2312,1218,764,5556,1246
46225,3201,1836,567,802,319,148,576,621,412,227,1365,397,591,251,126,1006,359
46226,17908,11697,2734,5523,2799,641,2826,4243,2948,1680,6211,1589,2403,1615,604,5168,1043
46227,22612,13446,3790,5668,2970,1018,4197,5724,2284,1241,9166,2891,2612,1887,1776,7479,1687
46228,5829,3994,621,1974,1182,217,1359,1683,458,494,1835,348,646,518,323,1481,354
46229,9285,6598,1664,3293,1242,399,2323,2479,1184,612,2687,606,949,865,267,2217,470
46231,2175,1661,329,917,384,31,671,683,169,138,514,118,212,108,76,422,92
46234,7068,5042,1332,2548,1001,161,1923,2107,679,333,2026,484,878,448,216,1667,359
46235,9130,6289,2610,2856,710,113,1689,1390,2534,676,2841,925,1220,613,83,2327,514
46236,9274,7453,1780,4529,920,224,3829,2597,801,226,1821,405,761,464,191,1562,259
46237,11543,8247,2483,3986,1558,220,3461,3253,985,548,3296,1176,1286,533,301,2524,772
46239,5003,3959,640,2022,1049,248,1537,1945,298,179,1044,241,313,334,156,841,203
46240,9200,4258,660,1989,1114,495,1309,2194,448,307,4942,1893,1342,848,859,4132,810
46241,11748,8115,2242,3767,1769,337,2612,2857,1584,1062,3633,771,1351,1013,498,2911,722
46250,8329,3975,1073,1860,832,210,1369,1836,368,402,4354,2298,1169,510,377,3498,856
46254,15453,8627,3363,4139,948,177,3119,2646,1946,916,6826,3097,2592,890,247,5567,1259
46256,9355,6321,1219,3547,1308,247,2774,2695,549,303,3034,1168,984,551,331,2466,568
46259,2259,1967,347,1113,422,85,938,850,91,88,292,52,109,87,44,253,39
46260,13500,8030,1946,3721,1791,572,2512,3425,1349,744,5470,1928,1706,1153,683,4475,995
46268,10471,5549,1676,2859,638,376,1946,2020,960,623,4922,1711,1342,773,1096,4095,827
46278,2427,1851,273,1124,349,105,973,754,73,51,576,60,344,134,38,478,98
46280,2454,1729,406,819,422,82,741,776,154,58,725,228,235,186,76,606,119
46290,84,60,0,32,20,8,28,32,0,0,24,0,18,6,0,14,10
46301,330,195,2,74,90,29,34,131,2,28,135,22,51,39,23,110,25
46303,4209,3167,645,1706,700,116,1344,1346,246,231,1042,153,386,338,165,850,192
46304,8105,5924,958,3281,1404,281,2258,2487,732,447,2181,472,674,686,349,1830,351
46307,17445,13148,1919,7174,3262,793,5262,6087,855,944,4297,960,1255,1205,877,3685,612
46310,4243,3442,686,1689,904,163,1377,1629,233,203,801,165,235,208,193,705,96
46311,5902,4885,692,2664,1330,199,2059,2296,285,245,1017,152,349,367,149,894,123
46312,11680,7977,2039,3320,1917,701,2130,2171,2143,1533,3703,573,1233,1136,761,3351,352
46319,7423,5248,956,2737,1298,257,1838,2169,654,587,2175,551,735,486,403,1848,327
46320,6108,3758,1088,1793,734,143,1094,1051,1050,563,2350,427,757,769,397,2028,322
46321,8108,6170,517,3130,1930,593,2353,3051,354,412,1938,139,502,607,690,1751,187
46322,9633,6716,1087,3026,2055,548,2228,3352,513,623,2917,549,860,919,589,2555,362
46323,9273,6170,1435,2849,1480,406,2014,2451,933,772,3103,727,1138,733,505,2651,452
46324,8980,6107,1557,2688,1280,582,1846,2250,1141,870,2873,569,1030,673,601,2469,404
46327,4390,2939,724,1327,595,293,1020,966,487,466,1451,251,524,348,328,1254,197
46340,420,333,46,157,110,20,108,195,8,22,87,14,38,15,20,68,19
46341,3396,2655,452,1354,705,144,1074,1226,209,146,741,130,253,184,174,665,76
46342,11460,8098,1779,3689,1947,683,2796,3527,943,832,3362,740,945,1000,677,2770,592
46345,61,46,7,30,9,0,20,16,7,3,15,9,0,4,2,11,4
46346,493,391,116,182,66,27,119,135,88,49,102,20,15,44,23,94,8
46347,1439,1129,210,548,313,58,436,553,73,67,310,63,92,84,71,263,47
46348,412,298,37,153,79,29,105,166,16,11,114,23,41,24,26,95,19
46349,1172,881,193,418,232,38,371,377,71,62,291,10,136,97,48,233,58
46350,16266,11576,2325,5679,2764,808,4182,5333,1206,855,4690,692,1417,1405,1176,3964,726
46356,5227,4031,679,2221,913,218,1763,1711,292,265,1196,280,307,396,213,978,218
46360,17893,12010,2542,5397,3143,928,3464,5118,2107,1321,5883,995,2058,1631,1199,5004,879
46365,375,313,74,183,56,0,167,124,13,9,62,8,39,15,0,36,26
46366,2296,1727,382,757,462,126,640,810,185,92,569,57,143,230,139,500,69
46368,13672,9713,2047,4890,2249,527,3453,4034,1310,916,3959,751,1233,1113,862,3231,728
46371,1107,846,146,400,258,42,282,411,93,60,261,11,96,65,89,216,45
46373,2762,2345,234,1394,622,95,1160,1044,50,91,417,57,114,150,96,349,68
46374,400,315,40,181,94,0,99,140,45,31,85,0,8,53,24,75,10
46375,7220,5193,669,2854,1494,176,1947,2642,303,301,2027,391,843,463,330,1715,312
46376,118,90,27,35,22,6,44,31,4,11,28,3,12,4,9,22,6
46377,43,43,11,10,22,0,11,32,0,0,0,0,0,0,0,0,0
46379,86,59,22,18,12,7,31,19,9,0,27,0,14,7,6,17,10
46381,58,51,32,14,5,0,46,0,0,5,7,0,0,7,0,7,0
46382,729,586,110,273,156,47,258,275,29,24,143,0,45,63,35,130,13
46383,13751,8997,1688,4687,2154,468,3330,4149,927,591,4754,1518,1277,984,975,3852,902
46385,11749,9457,1468,5287,2324,378,3934,4280,788,455,2292,532,827,619,314,1867,425
46390,893,699,103,373,172,51,264,346,39,50,194,43,55,48,48,155,39
46391,1751,1239,233,671,296,39,474,580,135,50,512,68,249,126,69,396,116
46392,2177,1796,421,868,431,76,802,778,133,83,381,61,164,103,53,327,54
46393,68,57,10,25,22,0,23,16,10,8,11,0,0,0,11,0,11
46394,5324,3267,540,1561,769,397,1039,1348,388,492,2057,397,600,540,520,1812,245
46402,3361,1917,447,814,563,93,240,488,658,531,1444,125,504,583,232,1304,140
46403,5911,3902,883,2018,846,155,903,1375,1056,568,2009,408,841,631,129,1769,240
46404,7943,5606,1161,1999,1906,540,779,1728,1624,1475,2337,282,720,996,339,2128,209
46405,4626,3365,662,1651,822,230,1066,1262,497,540,1261,232,408,364,257,1040,221
46406,4340,3063,589,1299,998,177,605,993,815,650,1277,211,400,542,124,1055,222
46407,7167,4507,1184,1478,1164,681,511,968,1596,1432,2660,276,960,856,568,2421,239
46408,7324,5186,975,2625,1270,316,1415,1728,1012,1031,2138,359,774,730,275,1866,272
46409,4075,3057,725,1580,610,142,690,654,981,732,1018,93,479,351,95,870,148
46410,12707,8650,1627,4343,2069,611,3069,3625,963,993,4057,915,1179,829,1134,3453,604
46501,1406,1093,273,495,246,79,465,474,94,60,313,42,88,90,93,272,41
46502,30,15,0,7,8,0,0,8,0,7,15,0,0,15,0,0,15
46504,1165,866,182,437,208,39,358,372,89,47,299,50,100,63,86,263,36
46506,3518,2729,495,1351,714,169,1047,1324,194,164,789,91,234,241,223,703,86
46507,3301,2611,596,1289,622,104,994,1181,291,145,690,177,255,185,73,521,169
46508,57,37,12,16,8,1,11,11,10,5,20,8,1,5,6,13,7
46510,1299,1010,252,394,308,56,406,512,48,44,289,67,75,88,59,230,59
46511,1703,1205,251,527,347,80,418,540,132,115,498,90,168,155,85,441,57
46513,15,15,0,15,0,0,15,0,0,0,0,0,0,0,0,0,0
46514,15113,10468,2632,4729,2526,581,3430,4699,1478,861,4645,862,1464,1339,980,3837,808
46516,12787,8765,2767,3970,1641,387,3180,3007,1865,713,4022,985,1427,1048,562,3227,795
46517,7662,5272,1305,2513,1150,304,1901,2311,713,347,2390,513,774,602,501,1982,408
46524,687,546,119,280,103,44,276,165,61,44,141,45,39,40,17,111,30
46526,9917,6954,1862,3039,1433,620,2670,3199,699,386,2963,615,887,632,829,2555,408
46528,7141,5719,1568,2624,1272,255,2460,2356,480,423,1422,297,552,350,223,1103,319
46530,8449,7595,870,4811,1708,206,3826,3191,397,181,854,172,344,239,99,652,202
46531,458,348,46,196,85,21,139,171,10,28,110,32,36,20,22,71,39
46532,733,589,134,275,155,25,203,263,59,64,144,27,22,55,40,128,16
46534,4104,2985,685,1357,751,192,993,1432,336,224,1119,131,291,425,272,969,150
46536,1120,844,165,385,248,46,292,443,79,30,276,41,85,93,57,246,30
46537,199,131,59,45,5,22,15,68,32,16,68,14,25,15,14,58,10
46538,1647,1208,191,622,305,90,416,683,45,64,439,72,147,140,80,346,93
46539,787,603,131,310,121,41,241,267,72,23,184,22,41,61,60,173,11
46540,3148,2606,540,1372,571,123,1248,1047,229,82,542,69,241,138,94,470,72
46542,1441,1105,263,537,233,72,478,500,76,51,336,59,114,92,71,294,42
46543,872,790,251,392,108,39,420,288,64,18,82,27,22,22,11,70,12
46544,12034,7960,1858,3701,1878,523,2589,3357,1418,596,4074,891,1314,901,968,3413,661
46545,11525,6396,1743,2665,1425,563,2176,2644,901,675,5129,1841,1484,1038,766,4335,794
46550,3958,3093,889,1423,600,181,1469,1258,250,116,865,204,213,293,155,738,127
46552,2248,1584,180,905,372,127,548,798,155,83,664,106,246,150,162,599,65
46553,1011,855,177,415,178,85,376,399,70,10,156,32,18,43,63,156,0
46554,1508,1162,198,582,306,76,425,549,99,89,346,52,140,63,91,278,68
46555,1095,777,172,359,185,61,271,393,70,43,318,58,101,97,62,246,72
46556,3,3,0,3,0,0,0,0,3,0,0,0,0,0,0,0,0
46561,4138,3428,719,1758,792,159,1451,1488,311,178,710,130,268,230,82,575,135
46562,1549,1243,265,605,322,51,473,559,164,47,306,66,112,75,53,274,32
46563,8130,5910,1311,2822,1421,356,2194,2637,665,414,2220,398,724,555,543,1853,367
46565,2005,1700,548,720,358,74,922,573,109,96,305,72,65,106,62,251,54
46566,67,51,12,22,14,3,24,23,4,0,16,3,1,8,4,14,2
46567,3805,2684,528,1216,762,178,944,1306,287,147,1121,237,345,314,225,972,149
46570,430,308,43,166,83,16,149,114,29,16,122,11,38,43,30,113,9
46571,1440,1214,423,482,240,69,623,443,81,67,226,69,70,49,38,204,22
46573,1193,950,212,409,268,61,394,462,55,39,243,31,74,70,68,225,18
46574,3076,2319,426,958,730,205,823,1079,229,188,757,96,262,201,198,685,72
46580,7765,5448,1239,2533,1366,310,2093,2412,615,328,2317,447,700,629,541,1921,396
46582,4022,3023,786,1385,703,149,1206,1319,285,213,999,191,445,236,127,852,147
46590,1302,918,268,441,156,53,396,333,126,63,384,116,162,66,40,313,71
46595,39,28,9,12,0,7,9,13,6,0,11,0,0,6,5,11,0
46601,2614,988,428,358,174,28,213,278,374,123,1626,364,588,371,303,1430,196
46613,4443,2911,914,1300,512,185,967,839,668,437,1532,316,587,318,311,1253,279
46614,12072,7948,1516,3609,2113,710,2802,3889,690,567,4124,1000,1008,1003,1113,3608,516
46615,6757,3889,1268,1503,763,355,1301,1528,640,420,2868,757,887,601,623,2317,551
46616,2831,1711,515,806,274,116,509,597,383,222,1120,358,380,205,177,881,239
46617,4293,2577,522,1206,613,236,672,1041,507,357,1716,499,472,424,321,1348,368
46619,7549,5421,1225,2375,1216,605,1555,2109,1094,663,2128,245,512,926,445,1857,271
46628,10400,7103,1916,3104,1607,476,2271,2589,1349,894,3297,658,1216,799,624,2780,517
46629,0,0,0,0,0,0,0,0,0,0,0,0,0,0,0,0,0
46635,2650,1904,228,920,571,185,682,953,119,150,746,135,228,227,156,617,129
46637,6032,3666,682,1675,995,314,1177,1912,382,195,2366,813,646,466,441,1776,590
46701,2837,2112,443,994,520,155,782,1006,188,136,725,176,231,184,134,629,96
46702,961,769,183,359,182,45,284,361,73,51,192,22,66,59,45,158,34
46703,6711,4523,1073,2118,1063,269,1694,1967,575,287,2188,579,710,542,357,1738,450
46705,590,415,111,198,62,44,167,162,67,19,175,37,70,31,37,147,28
46706,6769,4723,1024,2331,1113,255,1775,2185,541,222,2046,507,608,482,449,1766,280
46710,1586,1175,287,590,229,69,482,507,109,77,411,108,106,105,92,349,62
46711,2580,1885,490,743,448,204,810,849,145,81,695,92,150,154,299,672,23
46714,5615,3895,861,1827,920,287,1417,1785,424,269,1720,266,522,477,455,1526,194
46721,1849,1372,368,671,295,38,594,557,169,52,477,99,184,106,88,385,92
46723,2586,1960,323,1092,437,108,775,838,207,140,626,145,171,175,135,554,72
46725,7960,5859,1143,2841,1455,420,2163,2749,603,344,2101,432,767,497,405,1832,269
46730,555,426,41,238,126,21,135,232,40,19,129,12,49,28,40,109,20
46731,214,199,43,100,30,26,95,96,0,8,15,0,8,7,0,15,0
46732,1221,970,323,447,156,44,392,405,133,40,251,68,60,83,40,192,59
46733,7197,5130,1068,2436,1268,358,1949,2257,602,322,2067,392,585,507,583,1842,225
46737,2576,1870,330,887,527,126,589,926,236,119,706,120,231,223,132,597,109
46738,2864,2062,570,977,398,117,816,871,232,143,802,156,269,196,181,676,126
46740,1145,865,254,384,194,33,417,330,69,49,280,37,86,80,77,233,47
46741,1439,1240,323,641,228,48,700,380,104,56,199,33,41,73,52,181,18
46742,1242,910,158,482,234,36,350,412,75,73,332,36,126,95,75,272,60
46743,419,310,65,131,95,19,120,153,16,21,109,21,42,14,32,83,26
46745,574,476,50,271,118,37,208,213,24,31,98,13,25,17,43,98,0
46746,1455,1076,203,554,281,38,469,446,97,64,379,69,148,105,57,324,55
46747,1044,779,163,307,255,54,266,385,67,61,265,72,81,71,41,210,55
46748,1226,957,199,543,185,30,434,419,74,30,269,55,119,38,57,225,44
46750,10559,7579,1626,3653,1786,514,2741,3495,919,424,2980,715,934,745,586,2559,421
46755,5893,4035,1140,1876,746,273,1713,1597,473,252,1858,388,566,537,367,1560,298
46759,308,250,31,119,85,15,96,120,10,24,58,8,9,16,25,58,0
46760,449,301,87,135,58,21,118,120,40,23,148,32,61,24,31,118,30
46761,3722,2860,735,1323,677,125,1175,1220,287,178,862,191,285,201,185,750,112
46763,588,471,53,252,147,19,152,279,24,16,117,9,46,31,31,99,18
46764,510,429,73,206,134,16,165,203,24,37,81,22,36,17,6,52,29
46765,1287,1115,146,655,258,56,525,516,43,31,172,8,36,65,63,155,17
46766,225,183,23,97,63,0,67,83,18,15,42,0,26,0,16,35,7
46767,2517,1959,605,910,394,50,876,706,250,127,558,114,172,144,128,459,99
46770,912,685,148,316,171,50,261,339,46,39,227,34,86,60,47,187,40
46772,791,690,162,339,143,46,396,234,40,20,101,22,10,26,43,88,13
46773,1314,1026,191,481,289,65,407,482,64,73,288,84,56,76,72,248,40
46774,5324,3947,633,1978,1057,279,1459,1844,419,225,1377,285,427,396,269,1174,203
46776,527,372,80,170,109,13,98,203,50,21,155,42,49,40,24,120,35
46777,2325,1784,385,903,395,101,708,767,185,124,541,81,197,161,102,482,59
46779,883,680,149,322,181,28,255,280,70,75,203,28,58,84,33,186,17
46781,330,260,55,120,75,10,115,108,24,13,70,7,25,6,32,69,1
46783,1864,1461,208,808,369,76,625,662,109,65,403,81,159,88,75,329,74
46784,964,788,169,368,214,37,328,336,65,59,176,47,46,53,30,154,22
46785,471,412,89,217,82,24,194,166,31,21,59,11,13,18,17,56,3
46787,1492,1081,233,522,234,92,401,505,114,61,411,78,116,81,136,371,40
46788,862,739,164,386,169,20,381,309,40,9,123,8,51,38,26,110,13
46791,335,261,43,148,54,16,108,110,39,4,74,13,36,5,20,59,15
46792,1428,1076,229,468,252,127,436,511,77,52,352,46,142,97,67,306,46
46793,1487,1132,269,573,245,45,478,448,140,66,355,70,134,76,75,303,52
46794,564,488,89,233,134,32,242,181,24,41,76,26,27,23,0,62,14
46795,2209,1701,348,736,522,95,602,864,144,91,508,67,166,168,107,423,85
46797,1340,1070,201,533,269,67,459,489,76,46,270,41,88,91,50,228,42
46798,712,528,79,326,116,7,199,250,64,15,184,19,56,66,43,167,17
46799,41,34,7,15,12,0,12,16,1,5,7,1,5,0,1,4,3
46802,4963,2097,758,834,362,143,505,628,580,384,2866,992,1041,573,260,2420,446
46803,3782,2327,761,984,430,152,475,612,781,459,1455,170,607,462,216,1225,230
46804,10213,7143,1113,4014,1643,373,2933,3285,579,346,3070,1070,893,652,455,2608,462
46805,9732,5189,1708,2214,934,333,1763,1861,981,584,4543,1414,1296,969,864,3788,755
46806,9640,6852,2285,3040,1266,261,1809,1583,2306,1154,2788,497,1184,704,403,2345,443
46807,6701,4121,1357,1855,658,251,1524,1227,829,541,2580,662,977,502,439,2052,528
46808,8216,4623,1416,1950,948,309,1569,1681,745,628,3593,1089,1383,651,470,2847,746
46809,3917,2479,539,1201,531,208,843,1119,327,190,1438,312,426,405,295,1308,130
46814,2512,2284,185,1565,464,70,1280,891,104,9,228,19,92,95,22,184,44
46815,10381,7334,1442,3404,1797,691,2804,3450,628,452,3047,821,738,745,743,2627,420
46816,7095,4359,1375,1873,868,243,1490,1563,933,373,2736,677,835,760,464,2353,383
46818,5448,3951,976,1827,931,217,1391,1873,431,256,1497,406,486,397,208,1159,338
46819,3731,2515,533,1150,645,187,819,1208,312,176,1216,301,356,255,304,977,239
46825,10055,6599,2013,3041,1274,271,2403,2778,1016,402,3456,1092,1032,827,505,2861,595
46835,12244,8358,1851,4149,1913,445,3457,3789,726,386,3886,1363,1102,864,557,3238,648
46845,5170,4485,622,2726,1003,134,2166,1987,223,109,685,114,267,230,74,581,104
46901,16281,10814,2598,4807,2749,660,3444,4850,1473,1047,5467,957,1774,1685,1051,4784,683
46902,15096,10105,2432,4253,2799,621,2958,4843,1501,803,4991,1238,1575,1252,926,4406,585
46910,1135,896,196,458,157,85,390,383,60,63,239,20,74,82,63,214,25
46911,596,486,55,250,158,23,167,266,34,19,110,33,27,21,29,98,12
46913,489,454,68,251,121,14,192,223,21,18,35,18,7,6,4,29,6
46914,815,617,120,337,130,30,230,277,77,33,198,56,53,44,45,162,36
46917,655,455,86,218,109,42,181,225,34,15,200,42,65,31,62,168,32
46919,906,689,112,323,211,43,217,369,70,33,217,22,65,54,76,196,21
46920,636,466,110,214,115,27,198,214,34,20,170,37,43,42,48,146,24
46921,29,23,5,6,12,0,11,12,0,0,6,0,0,0,6,6,0
46923,3124,2316,500,1104,599,113,944,1081,172,119,808,134,226,231,217,726,82
46926,678,526,118,222,147,39,171,257,64,34,152,16,31,36,69,135,17
46928,2196,1641,364,716,409,152,512,831,203,95,555,67,130,203,155,473,82
46929,1291,923,192,395,256,80,324,466,81,52,368,81,44,124,119,335,33
46930,89,69,9,38,19,3,32,33,2,2,20,2,6,7,5,14,6
46931,72,60,17,28,14,1,28,22,3,7,12,2,5,2,3,12,0
46932,1451,1147,215,620,251,61,453,559,89,46,304,86,81,66,71,269,35
46933,2479,1736,354,828,465,89,538,766,251,181,743,150,197,246,150,643,100
46936,2316,1836,288,982,447,119,788,820,113,115,480,43,139,148,150,438,42
46938,1355,1021,219,403,333,66,342,498,106,75,334,55,105,107,67,298,36
46939,894,648,121,272,203,52,195,338,74,41,246,18,45,73,110,218,28
46940,1126,890,192,407,241,50,292,483,82,33,236,38,89,53,56,212,24
46941,456,361,66,171,101,23,145,156,39,21,95,13,34,39,9,78,17
46943,107,72,28,21,23,0,28,34,0,10,35,0,0,12,23,35,0
46946,57,44,4,34,6,0,0,31,9,4,13,6,7,0,0,7,6
46947,11635,7891,1820,3450,1919,702,2666,3563,985,677,3744,652,988,1156,948,3251,493
46950,250,195,23,85,80,7,53,135,0,7,55,23,8,24,0,39,16
46951,828,642,70,370,171,31,278,320,28,16,186,24,72,55,35,168,18
46952,9117,6112,1174,2637,1842,459,1678,3229,673,532,3005,445,762,995,803,2670,335
46953,9771,6503,1589,2819,1691,404,1791,3060,1035,617,3268,522,996,1034,716,2818,450
46957,136,96,13,51,26,6,45,43,4,4,40,10,13,9,8,40,0
46958,298,183,19,122,37,5,75,71,28,9,115,21,25,55,14,84,31
46959,53,36,0,22,14,0,10,18,8,0,17,0,0,17,0,17,0
46960,555,414,110,165,95,44,138,191,58,27,141,19,57,18,47,131,10
46961,25,17,0,0,12,5,0,17,0,0,8,0,0,2,6,6,2
46962,3497,2481,469,1075,685,252,872,1242,184,183,1016,278,268,224,246,887,129
46968,37,28,6,9,7,6,9,13,0,6,9,5,4,0,0,0,9
46970,9737,6840,1501,3109,1775,455,2231,3313,854,442,2897,511,886,838,662,2567,330
46974,635,506,114,241,132,19,176,241,42,47,129,22,40,27,40,121,8
46975,5610,3913,796,1750,1158,209,1356,1817,429,311,1697,264,428,447,558,1423,274
46978,832,637,133,342,109,53,268,279,42,48,195,41,22,56,76,178,17
46979,1626,1306,272,651,336,47,602,583,94,27,320,34,105,81,100,296,24
46982,948,769,194,335,182,58,277,386,71,35,179,16,72,60,31,146,33
46985,602,492,77,222,140,53,161,244,35,52,110,19,23,48,20,102,8
46986,688,532,75,268,165,24,170,296,35,31,156,25,36,64,31,144,12
46987,246,180,34,75,50,21,55,91,17,17,66,5,8,24,29,66,0
46988,329,247,41,116,90,0,81,115,35,16,82,22,10,30,20,60,22
46989,1287,974,178,455,318,23,343,513,74,44,313,116,44,80,73,251,62
46990,297,260,53,116,60,31,125,112,15,8,37,0,6,18,13,37,0
46991,736,612,137,287,150,38,226,309,45,32,124,17,28,46,33,107,17
46992,7235,5019,1085,2243,1291,400,1684,2303,638,394,2216,412,532,724,548,1936,280
46994,1015,786,148,373,220,45,310,407,31,38,229,23,38,96,72,217,12
46996,2695,1911,378,890,480,163,701,843,249,118,784,100,252,235,197,706,78
46998,43,14,14,0,0,0,14,0,0,0,29,0,0,29,0,29,0
47001,4028,3004,624,1440,820,120,1077,1402,360,165,1024,179,394,251,200,856,168
47003,240,189,69,79,29,12,99,58,19,13,51,4,15,21,11,46,5
47006,3777,2859,553,1455,624,227,1302,1206,197,154,918,208,311,185,214,839,79
47010,149,104,6,55,31,12,41,58,0,5,45,15,20,4,6,41,4
47011,254,187,55,76,47,9,101,71,11,4,67,25,20,6,16,62,5
47012,3526,2641,503,1262,732,144,1023,1182,238,198,885,142,201,255,287,778,107
47016,242,180,33,83,52,12,64,95,9,12,62,13,19,7,23,51,11
47017,185,117,22,32,45,18,36,46,11,24,68,5,17,34,12,58,10
47018,1306,932,186,438,226,82,384,390,83,75,374,32,102,150,90,322,52
47019,19,19,4,10,5,0,0,19,0,0,0,0,0,0,0,0,0
47020,397,299,80,112,92,15,93,147,26,33,98,28,20,50,0,78,20
47021,29,15,0,15,0,0,10,0,5,0,14,0,0,9,5,14,0
47022,1062,908,137,528,185,58,351,451,89,17,154,13,65,48,28,134,20
47023,546,407,113,167,109,18,122,207,64,14,139,3,77,45,14,122,17
47024,1185,965,250,420,252,43,370,403,134,58,220,45,57,71,47,204,16
47025,7425,5574,1040,2987,1313,234,2213,2378,628,355,1851,285,504,656,406,1604,247
47030,515,425,101,196,85,43,169,174,45,37,90,19,13,52,6,67,23
47031,1879,1419,341,643,368,67,532,651,121,115,460,66,117,143,134,396,64
47032,1084,913,209,457,216,31,382,358,113,60,171,11,43,77,40,140,31
47034,45,39,8,12,13,6,9,21,4,5,6,0,2,2,2,4,2
47035,37,37,6,12,14,5,0,32,0,5,0,0,0,0,0,0,0
47036,222,173,26,103,22,22,74,86,1,12,49,4,13,12,20,46,3
47037,1663,1222,304,538,280,100,516,501,133,72,441,76,100,140,125,375,66
47038,547,423,64,236,100,23,151,175,62,35,124,14,53,37,20,86,38
47040,1910,1380,255,662,385,78,512,687,75,106,530,93,180,131,126,454,76
47041,1925,1519,224,777,406,112,608,613,137,161,406,77,111,92,126,365,41
47042,1678,1271,339,539,315,78,459,595,153,64,407,55,93,160,99,367,40
47043,2076,1492,296,670,411,115,491,718,160,123,584,85,169,195,135,494,90
47060,2132,1683,250,981,393,59,677,794,121,91,449,80,167,152,50,358,91
47102,2829,2161,526,982,559,94,797,855,281,228,668,119,209,193,147,583,85
47106,1621,1297,251,660,326,60,471,626,117,83,324,45,107,101,71,291,33
47108,902,660,166,311,146,37,256,302,64,38,242,32,60,94,56,205,37
47111,4466,3392,820,1643,750,179,1215,1403,466,308,1074,115,488,317,154,911,163
47112,5542,4035,886,2007,957,185,1535,1801,462,237,1507,212,503,429,363,1251,256
47114,53,39,3,21,11,4,15,15,4,5,14,0,5,5,4,14,0
47115,893,679,124,283,221,51,205,344,55,75,214,22,60,71,61,175,39
47116,300,234,43,105,64,22,59,139,7,29,66,14,32,20,0,42,24
47117,1487,1208,260,616,283,49,535,525,95,53,279,36,96,91,56,229,50
47118,1355,974,233,427,258,56,331,400,150,93,381,68,110,117,86,327,54
47119,3422,2826,344,1574,789,119,1145,1263,235,183,596,56,220,193,127,465,131
47120,344,246,34,128,57,27,65,117,49,15,98,57,25,4,12,74,24
47122,2978,2456,430,1453,494,79,1084,1100,188,84,522,59,245,152,66,448,74
47123,16,5,0,0,0,5,0,5,0,0,11,0,0,11,0,11,0
47124,1315,1144,212,647,255,30,532,456,98,58,171,47,43,38,43,149,22
47125,621,452,128,195,123,6,165,221,39,27,169,36,59,40,34,153,16
47126,1259,1022,201,547,266,8,403,460,73,86,237,27,79,106,25,185,52
47129,8722,5290,1355,2236,1388,311,1553,2222,912,603,3432,833,1015,827,757,2828,604
47130,16135,10628,2628,5051,2410,539,3368,4640,1644,976,5507,1268,1971,1515,753,4652,855
47135,484,396,88,145,149,14,107,222,41,26,88,0,25,35,28,88,0
47136,1335,1059,134,638,253,34,431,525,61,42,276,29,108,73,66,243,33
47137,556,405,85,192,96,32,108,221,47,29,151,15,43,56,37,136,15
47138,1650,1311,300,581,373,57,495,618,83,115,339,65,124,79,71,273,66
47139,15,11,7,2,2,0,7,4,0,0,4,0,3,1,0,4,0
47140,1102,804,184,371,231,18,312,356,77,59,298,69,71,82,76,249,49
47141,521,409,73,204,102,30,161,192,28,28,112,16,34,34,28,103,9
47142,384,288,80,118,90,0,121,98,22,47,96,20,13,45,18,84,12
47143,737,606,68,323,190,25,237,314,18,37,131,14,49,43,25,107,24
47145,757,576,119,286,145,26,194,278,73,31,181,24,67,52,38,142,39
47147,389,305,46,187,64,8,123,145,19,18,84,10,28,26,20,84,0
47150,19122,12700,2969,5995,2932,804,4094,5258,2038,1310,6422,1541,2056,1619,1206,5389,1033
47160,12,9,0,5,4,0,5,4,0,0,3,0,3,0,0,0,3
47161,1249,934,231,504,170,29,397,379,96,62,315,69,133,57,56,245,70
47162,284,210,61,98,40,11,63,92,38,17,74,26,18,22,8,41,33
47163,642,551,79,270,174,28,215,272,33,31,91,13,36,30,12,71,20
47164,1331,1084,250,557,236,41,365,492,153,74,247,32,99,79,37,209,38
47165,2105,1605,386,840,298,81,679,680,178,68,500,60,233,123,84,430,70
47166,481,380,59,239,75,7,144,170,16,50,101,8,47,28,18,93,8
47167,5638,4114,902,1906,1036,270,1524,1904,397,289,1524,302,390,436,396,1338,186
47170,5491,3970,965,1831,978,196,1368,1819,497,286,1521,293,498,410,320,1307,214
47172,4601,3436,710,1679,880,167,1161,1623,385,267,1165,230,481,296,158,989,176
47174,29,29,6,14,9,0,10,5,5,9,0,0,0,0,0,0,0
47175,343,250,45,131,68,6,109,120,14,7,93,14,27,30,22,77,16
47177,234,190,25,97,50,18,70,86,8,26,44,0,13,23,8,44,0
47201,15175,10725,2722,4855,2559,589,3874,4805,1281,765,4450,1130,1263,1273,784,3785,665
47203,9323,6797,1367,3395,1664,371,2601,3039,699,458,2526,463,699,852,512,2198,328
47220,1903,1447,357,629,351,110,489,708,157,93,456,106,87,118,145,403,53
47223,595,441,115,215,91,20,196,196,28,21,154,34,17,70,33,112,42
47224,227,190,25,113,52,0,49,111,11,19,37,23,14,0,0,37,0
47226,70,47,22,17,4,4,26,19,2,0,23,4,5,7,7,16,7
47227,522,442,118,172,112,40,197,200,24,21,80,16,16,28,20,71,9
47229,1290,979,203,485,236,55,339,451,83,106,311,37,80,119,75,278,33
47230,625,519,72,288,117,42,212,219,37,51,106,5,46,41,14,98,8
47231,402,340,75,195,48,22,117,166,37,20,62,17,12,31,2,55,7
47232,1001,732,184,315,197,36,290,332,44,66,269,53,79,86,51,233,36
47234,587,451,96,232,86,37,171,225,28,27,136,32,48,46,10,121,15
47235,776,619,134,303,164,18,243,310,10,56,157,20,48,71,18,146,11
47240,7615,5533,1357,2448,1408,320,1998,2549,579,407,2082,393,662,554,473,1789,293
47243,1907,1419,292,683,356,88,491,625,189,114,488,109,137,144,98,434,54
47244,297,238,45,108,69,16,97,130,5,6,59,16,15,20,8,39,20
47246,1580,1261,279,629,276,77,531,550,113,67,319,40,61,141,77,273,46
47247,57,35,4,19,8,4,10,18,4,3,22,3,15,2,2,20,2
47250,8543,5671,1208,2545,1554,364,1821,2611,774,465,2872,614,933,752,573,2458,414
47260,729,566,163,252,127,24,197,217,103,49,163,9,55,75,24,140,23
47263,89,77,19,30,23,5,27,33,8,9,12,0,5,1,6,8,4
47264,581,486,70,191,204,21,116,330,23,17,95,7,52,12,24,74,21
47265,7430,5531,1551,2460,1311,209,2257,2238,644,392,1899,302,588,608,401,1570,329
47270,296,232,65,98,60,9,81,133,11,7,64,8,36,6,14,56,8
47272,721,594,148,299,102,45,241,243,78,32,127,28,30,39,30,106,21
47273,696,558,76,312,133,37,213,285,41,19,138,18,56,42,22,104,34
47274,10967,7664,1881,3527,1830,426,2816,3450,866,532,3303,875,862,805,761,2737,566
47280,372,264,105,93,66,0,81,124,52,7,108,22,36,41,9,100,8
47281,551,393,97,166,100,30,160,194,9,30,158,18,70,28,42,144,14
47282,103,68,11,35,11,11,22,17,14,15,35,8,4,11,12,31,4
47283,1300,996,256,437,232,71,416,399,97,84,304,74,83,85,62,271,33
47302,12591,8295,2142,3392,2170,591,2224,3720,1529,822,4296,704,1316,1336,940,3698,598
47303,10862,5834,1513,2503,1469,349,1847,2587,881,519,5028,2701,895,856,576,3254,1774
47304,12194,7761,1686,3246,2176,653,2517,4104,670,470,4433,1595,1029,1009,800,3429,1004
47305,2246,951,256,498,154,43,237,305,294,115,1295,513,405,289,88,1005,290
47320,1716,1189,267,512,333,77,422,622,119,26,527,70,171,128,158,458,69
47325,272,243,54,129,60,0,92,121,30,0,29,10,14,5,0,23,6
47326,645,537,117,236,153,31,228,262,20,27,108,0,41,32,35,91,17
47327,2175,1635,288,741,489,117,522,807,163,143,540,89,114,149,188,471,69
47330,2038,1582,323,757,387,115,570,700,214,98,456,54,179,85,138,414,42
47331,9883,6930,1746,2796,1924,464,2288,3284,786,572,2953,393,860,862,838,2554,399
47334,1211,874,169,398,246,61,320,462,58,34,337,68,75,125,69,281,56
47336,1682,1245,270,543,347,85,384,615,163,83,437,75,117,143,102,380,57
47337,77,60,5,30,24,1,14,33,5,8,17,3,0,8,6,14,3
47338,1225,972,218,422,258,74,365,459,109,39,253,40,70,80,63,243,10
47339,232,166,46,65,49,6,68,77,19,2,66,7,34,2,23,57,9
47340,1235,922,212,377,254,79,322,466,79,55,313,35,84,104,90,269,44
47341,792,637,87,317,181,52,223,321,61,32,155,22,53,38,42,142,13
47342,1099,888,140,540,150,58,328,415,94,51,211,30,51,78,52,193,18
47344,45,29,7,11,7,4,7,18,0,4,16,8,3,5,0,16,0
47345,486,382,63,209,85,25,149,161,47,25,104,18,36,26,24,81,23
47346,1672,1154,199,517,370,68,439,601,56,58,518,95,132,132,159,448,70
47348,4368,3092,698,1306,852,236,1045,1493,361,193,1276,201,319,410,346,1143,133
47351,156,110,29,44,18,19,52,34,11,13,46,9,4,10,23,46,0
47352,402,287,39,123,98,27,91,170,14,12,115,45,19,31,20,87,28
47353,2296,1671,369,746,450,106,591,835,163,82,625,71,155,226,173,540,85
47354,524,413,105,112,170,26,128,241,21,23,111,21,45,23,22,106,5
47355,1169,857,165,405,222,65,298,412,97,50,312,55,74,98,85,272,40
47356,2535,1854,383,900,506,65,747,840,204,63,681,104,192,187,198,596,85
47357,442,317,64,165,69,19,123,141,34,19,125,5,55,42,23,109,16
47358,399,337,57,186,79,15,142,159,15,21,62,6,25,15,16,51,11
47359,1285,919,222,387,242,68,335,429,92,63,366,47,92,151,76,330,36
47360,541,461,51,239,123,48,182,239,21,19,80,20,15,23,22,51,29
47361,64,46,19,11,12,4,7,28,2,9,18,3,7,4,4,14,4
47362,12115,8427,1762,3690,2358,617,2713,4108,938,668,3688,577,957,1104,1050,3288,400
47368,1085,792,164,397,207,24,302,344,97,49,293,47,91,90,65,240,53
47369,530,353,63,175,84,31,140,152,34,27,177,38,34,66,39,130,47
47371,4896,3475,797,1534,925,219,1345,1558,298,274,1421,286,324,390,421,1243,178
47373,983,691,165,253,220,53,194,353,93,51,292,55,84,79,74,251,41
47374,20239,13079,3214,5304,3545,1016,3874,6315,1888,1002,7160,1173,2274,2063,1650,6086,1074
47380,856,661,162,263,187,49,256,322,49,34,195,19,76,59,41,166,29
47381,20,16,7,8,1,0,1,7,7,1,4,2,1,0,1,4,0
47382,74,46,15,18,6,7,27,13,0,6,28,9,10,9,0,23,5
47383,1120,941,154,476,266,45,352,465,84,40,179,11,40,72,56,169,10
47384,711,588,137,254,159,38,233,310,19,26,123,14,29,31,49,112,11
47385,656,492,101,220,135,36,197,235,22,38,164,18,36,72,38,155,9
47386,487,390,33,214,119,24,129,235,23,3,97,2,42,41,12,95,2
47387,268,218,42,113,41,22,89,110,6,13,50,2,13,17,18,50,0
47390,2241,1506,341,642,385,138,466,724,210,106,735,105,191,235,204,645,90
47392,18,18,0,6,12,0,6,12,0,0,0,0,0,0,0,0,0
47393,538,461,53,215,144,49,170,275,0,16,77,8,49,3,17,56,21
47394,3602,2434,470,1064,706,194,829,1177,244,184,1168,204,331,328,305,1031,137
47396,2474,1921,338,886,594,103,709,941,181,90,553,116,141,213,83,461,92
47401,14910,7557,1545,3508,2036,468,2530,3798,768,461,7353,4120,1517,1059,657,5026,2327
47403,10555,6571,1971,2959,1356,285,2143,2832,1091,505,3984,1319,1391,948,326,3090,894
47404,7734,4318,1169,1981,949,219,1340,1899,706,373,3416,1478,914,704,320,2381,1035
47406,0,0,0,0,0,0,0,0,0,0,0,0,0,0,0,0,0
47408,10197,3903,1124,1706,779,294,1259,1985,292,367,6294,4538,740,480,536,3882,2412
47420,41,27,0,27,0,0,19,8,0,0,14,0,0,7,7,14,0
47421,11378,7817,1469,3501,2268,579,2642,3726,760,689,3561,687,986,1107,781,3083,478
47424,3643,2629,591,1114,702,222,886,1302,278,163,1014,128,310,304,272,922,92
47427,390,307,92,112,78,25,112,171,12,12,83,0,26,57,0,73,10
47429,2591,1932,514,1092,269,57,815,673,329,115,659,121,232,168,138,571,88
47430,22,22,0,16,0,6,11,5,0,6,0,0,0,0,0,0,0
47431,471,344,42,171,116,15,108,182,27,27,127,13,48,50,16,108,19
47432,1812,1255,229,625,342,59,429,593,142,91,557,83,135,244,95,484,73
47433,1326,967,242,417,241,67,344,508,99,16,359,47,142,84,86,313,46
47436,553,407,106,164,109,28,122,180,50,55,146,20,84,22,20,125,21
47438,1939,1349,282,605,341,121,510,631,120,88,590,72,231,145,142,494,96
47441,3955,2654,520,1102,807,225,910,1387,214,143,1301,155,318,482,346,1203,98
47443,524,375,109,152,108,6,144,159,56,16,149,12,47,32,58,131,18
47445,18,11,0,11,0,0,11,0,0,0,7,0,0,0,7,7,0
47446,4162,2966,743,1454,612,157,1091,1334,364,177,1196,193,326,375,302,1031,165
47448,3032,2163,316,1076,668,103,715,1153,197,98,869,115,288,317,149,726,143
47449,196,141,28,42,69,2,37,78,12,14,55,9,29,4,13,50,5
47451,556,378,98,166,91,23,109,179,63,27,178,28,53,60,37,162,16
47452,1919,1404,314,599,354,137,572,627,110,95,515,68,204,120,123,441,74
47453,251,157,55,42,50,10,73,66,8,10,94,22,33,24,15,94,0
47454,2922,2085,492,915,540,138,794,965,233,93,837,137,187,301,212,785,52
47455,99,77,5,38,29,5,30,32,0,15,22,4,12,6,0,10,12
47456,268,234,42,122,62,8,123,83,11,17,34,9,7,11,7,34,0
47459,1342,1023,275,505,209,34,450,454,80,39,319,79,95,98,47,242,77
47460,4498,3305,670,1599,860,176,1169,1574,372,190,1193,227,411,385,170,998,195
47462,1784,1395,303,686,335,71,501,716,103,75,389,45,205,108,31,336,53
47464,32,27,0,21,6,0,14,9,2,2,5,0,1,2,2,5,0
47465,242,201,57,75,61,8,83,78,26,14,41,3,14,17,7,38,3
47467,27,21,8,6,7,0,8,7,0,6,6,0,0,0,6,6,0
47468,468,342,91,174,61,16,148,163,24,7,126,27,51,33,15,82,44
47469,737,529,82,245,165,37,160,271,43,55,208,25,39,93,51,186,22
47470,620,439,92,231,105,11,185,187,45,22,181,51,43,25,62,150,31
47471,1135,760,167,327,206,60,270,364,82,44,375,39,111,114,111,320,55
47501,6710,4584,960,2043,1213,368,1659,2026,570,329,2126,357,527,628,614,1879,247
47512,1939,1322,276,585,358,103,425,671,163,63,617,65,176,190,186,546,71
47513,693,503,111,273,88,31,251,173,30,49,190,13,59,60,58,175,15
47514,87,80,21,37,22,0,42,31,7,0,7,0,4,0,3,7,0
47515,401,317,43,188,69,17,146,133,30,8,84,17,27,25,15,66,18
47516,482,355,60,184,89,22,125,180,35,15,127,20,42,32,33,118,9
47519,189,142,21,70,42,9,70,62,8,2,47,0,34,13,0,40,7
47520,1154,790,147,414,179,50,253,399,98,40,364,58,108,122,76,307,57
47521,265,234,68,107,49,10,144,71,0,19,31,0,18,8,5,31,0
47522,99,58,6,20,28,4,23,26,7,2,41,2,27,6,6,36,5
47523,1392,1043,185,510,259,89,407,467,85,84,349,34,120,114,81,303,46
47524,254,173,17,100,40,16,46,86,24,17,81,6,7,21,47,80,1
47525,148,129,26,64,39,0,44,60,3,22,19,0,5,7,7,19,0
47527,676,479,111,224,117,27,190,188,30,71,197,0,81,64,52,185,12
47528,222,156,34,77,39,6,65,67,15,9,66,10,10,17,29,59,7
47529,496,366,72,162,99,33,115,196,31,24,130,17,23,43,47,124,6
47531,228,188,38,84,54,12,66,112,4,6,40,0,9,31,0,40,0
47532,1525,1198,252,591,276,79,598,472,65,63,327,96,59,89,83,301,26
47535,277,192,49,69,56,18,69,102,21,0,85,15,12,15,43,85,0
47536,28,19,0,0,19,0,0,11,0,8,9,0,0,9,0,9,0
47537,235,192,33,97,55,7,58,100,22,12,43,14,17,4,8,32,11
47541,464,336,74,152,87,23,133,161,28,14,128,14,31,52,31,111,17
47542,3252,2368,484,1190,553,141,932,968,272,196,884,157,282,266,179,772,112
47545,20,8,0,0,0,8,0,8,0,0,12,0,0,0,12,12,0
47546,7494,5322,915,2760,1311,336,2229,2335,438,320,2172,587,634,475,476,1856,316
47550,319,256,39,149,68,0,117,111,15,13,63,11,30,4,18,46,17
47551,216,186,16,97,58,15,57,93,13,23,30,5,10,12,3,25,5
47552,76,57,18,23,8,8,41,16,0,0,19,11,0,8,0,19,0
47553,3034,2161,455,1069,496,141,919,942,159,141,873,163,258,226,226,802,71
47557,547,399,58,212,90,39,161,197,35,6,148,20,33,45,50,130,18
47558,1079,875,269,415,169,22,530,269,33,43,204,20,69,43,72,196,8
47561,512,390,75,198,94,23,157,164,35,34,122,29,40,39,14,102,20
47562,1417,1122,216,518,314,74,464,530,88,40,295,25,80,102,88,275,20
47564,532,385,87,159,122,17,158,190,19,18,147,33,15,64,35,118,29
47567,2415,1684,315,703,525,141,547,871,121,145,731,93,205,216,217,669,62
47568,366,293,77,117,69,30,127,142,8,16,73,2,24,17,30,66,7
47574,51,37,3,17,17,0,6,26,5,0,14,0,5,5,4,14,0
47575,382,291,71,162,51,7,127,104,27,33,91,8,36,21,26,83,8
47576,163,120,16,42,50,12,40,72,4,4,43,5,4,26,8,43,0
47577,331,258,37,111,72,38,112,116,6,24,73,0,20,35,18,68,5
47578,365,282,40,142,90,10,131,134,9,8,83,5,22,23,33,77,6
47579,712,606,137,275,177,17,258,314,19,15,106,30,37,25,14,87,19
47580,73,42,0,30,7,5,25,12,5,0,31,0,17,8,6,23,8
47581,1566,1080,198,533,274,75,378,551,85,66,486,45,142,170,129,418,68
47584,47,34,8,10,16,0,11,21,2,0,13,0,6,6,1,13,0
47585,169,120,3,60,45,12,33,81,0,6,49,7,8,11,23,49,0
47586,4701,3199,654,1489,757,299,1068,1545,370,216,1502,286,387,415,414,1349,153
47588,212,125,35,46,41,3,42,52,21,10,87,18,43,15,11,71,16
47590,285,214,10,143,48,13,90,90,4,30,71,21,16,23,11,71,0
47591,10535,6645,1397,3084,1758,406,2122,3062,949,512,3890,1065,864,1032,929,3284,606
47596,93,57,7,38,12,0,28,23,0,6,36,9,10,5,12,30,6
47597,427,304,54,151,78,21,123,117,21,43,123,19,33,54,17,111,12
47598,1426,1080,204,501,313,62,330,579,118,53,346,80,95,100,71,308,38
47601,5372,3967,688,2146,931,202,1459,1831,337,340,1405,170,278,526,431,1259,146
47610,2069,1624,357,789,392,86,574,767,181,102,445,99,170,117,59,387,58
47611,490,363,66,193,91,13,138,175,41,9,127,5,24,72,26,116,11
47612,414,334,75,165,58,36,136,166,21,11,80,2,21,38,19,73,7
47613,875,681,141,311,188,41,256,328,51,46,194,33,78,61,22,172,22
47615,692,518,107,280,112,19,218,252,32,16,174,19,63,53,39,148,26
47616,165,124,7,64,46,7,37,79,4,4,41,0,7,12,22,38,3
47619,646,486,78,234,133,41,156,282,27,21,160,16,59,36,49,133,27
47620,5501,4059,789,2055,943,272,1503,1880,413,263,1442,175,415,445,407,1279,163
47630,9812,7937,1398,4362,1884,293,3500,3502,569,366,1875,438,666,509,262,1552,323
47631,838,571,126,306,122,17,270,231,46,24,267,16,96,78,77,254,13
47633,1090,797,119,370,260,48,315,391,55,36,293,36,74,87,96,262,31
47634,983,704,119,358,176,51,224,349,74,57,279,33,55,85,106,240,39
47635,2128,1657,299,831,445,82,602,787,169,99,471,76,86,165,144,455,16
47637,636,497,90,277,114,16,205,216,31,45,139,8,41,59,31,127,12
47638,1234,963,144,572,221,26,463,417,52,31,271,58,82,79,52,242,29
47639,1313,1007,168,539,254,46,450,466,50,41,306,42,72,129,63,293,13
47640,347,264,46,136,70,12,67,145,23,29,83,12,35,5,31,83,0
47647,44,22,0,0,6,16,0,0,0,22,22,5,7,0,10,22,0
47648,1650,1215,222,619,288,86,500,587,78,50,435,92,110,149,84,364,71
47649,615,453,88,243,112,10,173,222,35,23,162,23,27,50,62,126,36
47654,28,19,9,4,0,6,8,4,3,4,9,3,4,2,0,8,1
47660,2070,1461,313,628,399,121,459,717,195,90,609,98,173,175,163,553,56
47665,1272,943,214,468,200,61,402,419,90,32,329,47,84,111,87,280,49
47666,636,461,110,204,122,25,183,197,54,27,175,31,59,53,32,163,12
47670,4836,3243,744,1363,857,279,984,1582,420,257,1593,240,364,536,453,1401,192
47683,132,102,19,47,32,4,49,48,3,2,30,2,9,9,10,28,2
47708,168,76,11,35,30,0,11,35,9,21,92,10,44,25,13,92,0
47710,8993,5467,1369,2228,1464,406,1541,2362,912,652,3526,616,1044,1021,845,3168,358
47711,11836,7913,1651,3736,1813,713,2713,3479,1045,676,3923,705,1361,1064,793,3332,591
47712,9512,6109,1155,3027,1440,487,2154,2891,581,483,3403,1146,916,774,567,2638,765
47713,5330,2734,695,1212,554,273,530,1008,772,424,2596,621,908,691,376,2184,412
47714,14834,9009,2393,3851,2093,672,2639,3749,1637,984,5825,1478,1654,1486,1207,4830,995
47715,11174,6480,1534,2837,1613,496,2012,3134,991,343,4694,1531,1212,995,956,3998,696
47720,6319,4819,803,2369,1284,363,1825,2334,328,332,1500,272,463,434,331,1288,212
47725,3396,2914,376,1570,807,161,1208,1501,121,84,482,108,113,156,105,423,59
47802,12296,7906,1695,3721,1929,561,2619,3562,1174,551,4390,1303,1012,1058,1017,3736,654
47803,8386,5332,1036,2381,1344,571,1745,2514,655,418,3054,735,831,773,715,2594,460
47804,4624,2771,702,1182,631,256,796,1120,524,331,1853,317,452,578,506,1612,241
47805,4970,3691,790,1638,994,269,1280,1827,382,202,1279,305,411,348,215,1086,193
47807,5822,2850,1160,1114,430,146,875,662,817,496,2972,1450,709,465,348,2157,815
47832,447,332,73,177,51,31,122,126,45,39,115,9,45,42,19,100,15
47833,306,247,39,140,57,11,97,112,26,12,59,6,25,0,28,47,12
47834,7417,5351,1218,2477,1308,348,1983,2411,487,470,2066,265,480,649,672,1818,248
47836,40,30,8,16,6,0,18,12,0,0,10,0,5,5,0,5,5
47837,464,375,84,200,70,21,182,123,54,16,89,14,40,14,21,71,18
47838,783,596,78,297,172,49,221,287,39,49,187,36,43,76,32,154,33
47840,601,491,109,236,122,24,163,252,43,33,110,19,29,50,12,102,8
47841,947,696,151,245,243,57,202,383,58,53,251,18,70,64,99,238,13
47842,4197,2872,655,1339,703,175,980,1321,306,265,1325,131,317,453,424,1189,136
47846,310,191,34,99,46,12,87,92,12,0,119,11,49,26,33,108,11
47847,465,340,72,128,94,46,104,206,15,15,125,16,62,19,28,103,22
47848,683,483,97,196,160,30,153,265,41,24,200,37,48,72,43,173,27
47849,178,164,22,68,50,24,64,94,0,6,14,0,0,8,6,14,0
47850,1027,765,192,345,193,35,262,342,91,70,262,25,88,85,64,242,20
47853,73,47,7,28,5,7,21,9,4,13,26,4,9,8,5,25,1
47854,347,276,50,134,70,22,111,125,28,12,71,0,39,16,16,62,9
47855,271,191,51,83,36,21,54,92,16,29,80,10,13,26,31,67,13
47856,37,30,4,9,11,6,4,23,3,0,7,0,0,7,0,7,0
47858,265,204,31,92,70,11,84,106,6,8,61,10,12,32,7,44,17
47859,384,300,98,109,69,24,127,136,33,4,84,9,25,25,25,77,7
47860,121,90,19,53,14,4,27,38,16,9,31,4,9,14,4,27,4
47861,260,235,38,110,64,23,108,87,23,17,25,2,4,4,15,19,6
47862,679,499,127,178,151,43,138,255,71,35,180,37,64,39,40,146,34
47863,0,0,0,0,0,0,0,0,0,0,0,0,0,0,0,0,0
47865,35,21,0,0,21,0,0,21,0,0,14,9,0,5,0,5,9
47866,164,144,35,52,49,8,41,79,24,0,20,0,0,0,20,20,0
47868,1208,917,149,442,287,39,300,481,101,35,291,28,122,99,42,246,45
47872,3034,2103,369,916,692,126,639,1122,216,126,931,117,262,278,274,835,96
47874,1317,1003,136,495,289,83,325,523,61,94,314,55,62,139,58,293,21
47876,0,0,0,0,0,0,0,0,0,0,0,0,0,0,0,0,0
47879,1252,926,230,384,262,50,355,420,75,76,326,35,92,138,61,274,52
47881,109,88,21,37,27,3,32,40,6,10,21,6,7,3,5,15,6
47882,3363,2232,556,1017,487,172,830,965,224,213,1131,136,253,406,336,1004,127
47884,158,100,26,53,17,4,37,47,8,8,58,21,21,7,9,34,24
47885,3963,2902,654,1357,746,145,975,1380,325,222,1061,113,308,313,327,917,144
47901,1980,692,312,242,105,33,156,245,207,84,1288,741,357,113,77,1008,280
47904,6592,3575,1123,1499,666,287,1148,1494,598,335,3017,1239,747,595,436,2355,662
47905,14759,9629,2425,4572,2122,510,3487,4479,1090,573,5130,1739,1504,1066,821,4095,1035
47906,18121,8963,2578,4073,1897,415,3415,4057,797,694,9158,6598,1143,645,772,4977,4181
47909,11522,8065,2624,3554,1601,286,3153,3165,1281,466,3457,1433,997,677,350,2615,842
47916,30,25,7,9,6,3,4,14,7,0,5,0,0,3,2,5,0
47917,172,142,35,57,32,18,60,60,0,22,30,6,6,4,14,30,0
47918,2507,1794,438,791,488,77,659,844,196,95,713,99,161,220,233,637,76
47920,849,623,76,339,167,41,196,343,45,39,226,19,109,56,42,185,41
47921,456,320,104,110,73,33,99,161,36,24,136,27,27,27,55,114,22
47922,607,466,115,185,132,34,169,230,48,19,141,27,39,35,40,119,22
47923,1387,1091,252,557,229,53,434,474,114,69,296,54,118,62,62,244,52
47924,36,36,11,8,10,7,0,10,11,15,0,0,0,0,0,0,0
47925,61,37,6,18,13,0,15,13,3,6,24,4,3,17,0,17,7
47926,402,313,60,131,115,7,86,168,35,24,89,8,19,37,25,78,11
47928,798,564,82,256,198,28,203,297,33,31,234,45,48,68,73,207,27
47929,312,246,69,96,73,8,69,134,35,8,66,15,6,19,26,62,4
47930,377,306,62,169,61,14,115,131,50,10,71,14,16,24,17,60,11
47932,2163,1604,316,669,508,111,555,810,131,108,559,82,176,147,154,462,97
47933,10817,7476,1538,3561,1929,448,2755,3414,875,432,3341,605,938,1016,782,2843,498
47940,559,438,125,199,93,21,194,180,53,11,121,6,28,41,46,109,12
47941,215,159,69,62,17,11,84,48,22,5,56,10,26,12,8,44,12
47942,318,244,29,136,72,7,84,123,29,8,74,17,24,25,8,67,7
47943,294,230,59,95,76,0,95,114,6,15,64,0,46,5,13,57,7
47944,1444,1014,216,414,292,92,394,489,78,53,430,48,145,119,118,388,42
47946,819,592,116,237,169,70,211,311,57,13,227,50,66,65,46,199,28
47948,573,408,80,195,80,53,147,211,26,24,165,21,50,39,55,143,22
47949,441,331,102,113,74,42,141,139,30,21,110,7,53,17,33,97,13
47950,384,243,54,166,23,0,93,71,59,20,141,40,16,47,38,111,30
47951,956,655,97,313,187,58,220,315,77,43,301,45,95,85,76,259,42
47952,1254,899,156,359,317,67,306,460,87,46,355,51,114,142,48,302,53
47954,823,644,141,330,144,29,250,297,60,37,179,22,36,60,61,170,9
47955,427,317,61,138,101,17,99,171,33,14,110,15,40,20,35,97,13
47957,732,534,97,281,115,41,198,224,70,42,198,26,46,90,36,174,24
47958,113,78,28,19,28,3,17,38,13,10,35,3,10,14,8,35,0
47959,1135,838,188,325,279,46,232,449,67,90,297,48,76,81,92,253,44
47960,6104,4277,786,1874,1224,393,1441,2100,398,338,1827,311,465,605,446,1497,330
47963,823,573,122,219,196,36,212,273,43,45,250,42,48,64,96,212,38
47964,53,41,12,18,11,0,17,17,4,3,12,2,5,5,0,10,2
47965,111,84,21,41,20,2,36,40,7,1,27,6,2,3,16,24,3
47966,188,118,28,43,29,18,43,42,16,17,70,7,17,25,21,65,5
47967,320,243,42,140,52,9,90,127,21,5,77,14,21,27,15,67,10
47968,375,280,63,119,83,15,111,143,5,21,95,4,28,14,49,92,3
47969,52,34,14,11,4,5,13,14,6,1,18,8,2,4,4,14,4
47970,837,611,164,303,119,25,302,185,74,50,226,46,39,61,80,209,17
47971,681,498,112,224,120,42,187,224,52,35,183,17,39,78,49,155,28
47974,489,353,85,129,101,38,128,183,27,15,136,2,62,29,43,122,14
47975,291,207,33,104,50,20,59,120,19,9,84,16,41,14,13,65,19
47977,899,655,130,283,191,51,241,334,51,29,244,46,71,79,48,191,53
47978,4007,2968,571,1340,797,260,1104,1392,251,221,1039,231,247,271,290,920,119
47980,434,349,69,158,85,37,132,166,23,28,85,32,5,33,15,82,3
47981,271,183,48,79,56,0,96,63,19,5,88,17,22,21,28,66,22
47982,44,31,2,15,12,2,8,23,0,0,13,4,0,7,2,11,2
47983,83,51,23,15,13,0,25,20,6,0,32,0,0,23,9,32,0
47986,25,16,0,16,0,0,0,6,0,10,9,9,0,0,0,9,0
47987,1627,1232,256,544,364,68,431,615,124,62,395,50,87,136,122,337,58
47989,388,307,78,135,73,21,108,157,32,10,81,15,23,30,13,77,4
47990,626,468,127,178,127,36,163,236,46,23,158,31,27,49,51,143,15
47991,381,291,64,119,96,12,102,130,26,33,90,14,27,22,27,74,16
47992,428,356,69,201,48,38,154,156,18,28,72,6,33,20,13,57,15
47993,1541,1108,229,509,317,53,416,556,97,39,433,44,118,130,141,389,44
47994,207,144,20,77,27,20,56,65,17,6,63,5,5,34,19,61,2
47995,618,442,97,244,70,31,208,170,29,35,176,16,40,59,61,142,34
47997,24,14,3,8,3,0,2,12,0,0,10,2,7,1,0,10,0
48001,5229,3665,642,1745,1045,233,1289,1733,327,316,1564,291,478,420,375,1297,267
48002,1057,875,159,496,179,41,381,391,60,43,182,33,71,56,22,148,34
48003,1928,1571,269,871,370,61,666,708,94,103,357,71,121,105,60,317,40
48005,1695,1416,232,780,333,71,646,653,63,54,279,42,70,82,85,243,36
48006,1341,1114,217,571,284,42,443,513,86,72,227,33,59,85,50,187,40
48009,9185,5119,833,2582,1306,398,1978,2403,402,336,4066,1290,1387,694,695,3500,566
48014,1280,1010,221,503,220,66,422,409,113,66,270,69,66,80,55,237,33
48015,4010,2164,468,961,456,279,669,827,312,356,1846,235,432,569,610,1689,157
48017,5648,3279,620,1657,751,251,1173,1523,243,340,2369,598,733,611,427,2024,345
48021,13234,8898,1947,4202,1824,925,3290,3494,869,1245,4336,752,1170,1166,1248,3731,605
48022,814,686,137,370,143,36,336,281,35,34,128,6,44,51,27,111,17
48023,2654,1837,474,901,375,87,674,701,325,137,817,230,257,196,134,666,151
48025,5632,4187,357,2111,1253,466,1698,2056,158,275,1445,160,445,455,385,1262,183
48026,6078,4160,669,2221,998,272,1513,1731,406,510,1918,334,522,510,552,1715,203
48027,1030,855,153,456,193,53,336,397,57,65,175,33,72,42,28,150,25
48028,579,379,26,123,161,69,62,269,7,41,200,34,49,72,45,182,18
48030,7264,4701,1197,2210,966,328,1570,1457,870,804,2563,575,903,622,463,2075,488
48032,681,580,91,320,153,16,245,254,35,46,101,18,27,29,27,81,20
48034,15544,7915,1980,3374,1831,730,1829,3277,1449,1360,7629,2305,2395,1426,1503,6653,976
48035,13908,9174,2140,4286,2222,526,3223,3781,1220,950,4734,1129,1611,1188,806,3968,766
48036,9520,6103,1176,2563,1816,548,1573,2834,886,810,3417,685,1149,1048,535,2953,464
48038,17119,10547,2098,5226,2404,819,3774,5032,798,943,6572,1981,1741,1570,1280,5577,995
48039,3161,2246,359,1254,495,138,847,957,261,181,915,173,237,325,180,799,116
48040,4051,2802,472,1377,731,222,1020,1421,217,144,1249,189,241,383,436,1137,112
48041,1516,1163,199,659,236,69,496,502,90,75,353,67,115,97,74,281,72
48042,5336,4529,784,2531,1046,168,2197,1980,128,224,807,180,199,329,99,650,157
48043,7228,3982,982,1872,780,348,1126,1586,714,556,3246,838,1059,770,579,2812,434
48044,11558,9578,2321,5296,1655,306,4854,3677,612,435,1980,565,809,427,179,1604,376
48045,10518,6294,1141,3245,1594,314,2100,2909,724,561,4224,1237,1488,996,503,3463,761
48047,11568,8469,1923,4697,1540,309,3675,3489,770,535,3099,944,982,682,491,2512,587
48048,1928,1444,440,647,329,28,554,497,225,168,484,101,180,137,66,395,89
48049,2015,1702,254,919,492,37,725,811,83,83,313,31,170,81,31,245,68
48050,475,418,64,213,126,15,167,212,18,21,57,4,9,27,17,57,0
48051,4795,3764,1095,2048,518,103,1877,1196,473,218,1031,290,441,185,115,832,199
48054,2612,1999,261,1040,539,159,787,993,94,125,613,56,166,225,166,554,59
48059,5800,4204,692,2125,1117,270,1565,1981,385,273,1596,382,415,442,357,1338,258
48060,16139,10408,2719,4867,2161,661,3221,3943,2160,1084,5731,1285,1525,1616,1305,4793,938
48062,3029,2236,464,1128,535,109,932,921,207,176,793,147,215,282,149,659,134
48063,1525,1342,272,676,330,64,568,601,96,77,183,29,82,52,20,156,27
48064,1664,1293,292,709,277,15,546,509,93,145,371,74,138,124,35,326,45
48065,3631,2786,475,1558,602,151,1125,1184,291,186,845,188,279,237,141,749,96
48066,20443,13005,3010,5756,3151,1088,4259,5054,1676,2016,7438,1531,2436,1920,1551,6317,1121
48067,12195,5837,1410,2773,1150,504,1960,2643,485,749,6358,2509,2137,892,820,5051,1307
48069,1045,690,97,395,152,46,258,324,47,61,355,86,137,82,50,270,85
48070,2383,1816,239,1002,404,171,782,808,117,109,567,98,202,139,128,464,103
48071,13307,8010,1799,3728,1961,522,2746,3470,857,937,5297,1594,1569,1214,920,4484,813
48072,6665,4033,967,2024,738,304,1579,1703,328,423,2632,720,872,503,537,2159,473
48073,16588,8627,1713,3995,1918,1001,2799,4207,578,1043,7961,2649,2447,1552,1313,6718,1243
48074,3102,2321,489,1154,585,93,834,1019,276,192,781,175,317,162,127,551,230
48075,9418,5847,853,2865,1590,539,1600,2575,828,844,3571,673,1274,956,668,3150,421
48076,10608,7313,1107,3840,1798,568,2640,2805,893,975,3295,658,1400,744,493,2819,476
48079,4650,3491,620,1849,838,184,1536,1566,259,130,1159,225,360,261,313,1016,143
48080,10865,6259,972,2636,1756,895,1880,2950,536,893,4606,841,1220,1271,1274,4152,454
48081,9359,6297,895,2944,1800,658,2035,3233,405,624,3062,408,874,951,829,2724,338
48082,7024,4739,726,2050,1435,528,1501,2201,384,653,2285,332,661,728,564,2019,266
48083,8923,5703,1143,3149,1181,230,2588,2103,357,655,3220,884,910,704,722,2751,469
48084,6140,3526,505,1955,884,182,1564,1545,152,265,2614,938,782,508,386,2154,460
48089,12818,8572,2378,3868,1773,553,2899,2858,1507,1308,4246,1159,1422,994,671,3396,850
48091,12894,8229,1706,3625,2121,777,2533,3124,1177,1395,4665,1037,1409,1313,906,3889,776
48092,10045,7047,1220,2909,2208,710,2268,3349,452,978,2998,631,861,895,611,2542,456
48093,19768,12988,1776,4995,4551,1666,3801,6723,864,1600,6780,1175,1778,2135,1692,6051,729
48094,4870,3786,573,1949,1173,91,1485,1864,164,273,1084,346,393,164,181,887,197
48095,1292,1125,148,615,332,30,555,494,28,48,167,19,76,64,8,142,25
48096,1367,1137,132,644,321,40,521,511,28,77,230,39,78,71,42,204,26
48097,1874,1447,334,708,331,74,585,615,161,86,427,67,116,107,137,373,54
48098,14985,12760,1015,7762,3443,540,6074,5570,537,579,2225,368,784,735,338,1915,310
48101,12088,8239,1427,3569,2053,1190,2957,3735,556,991,3849,481,1123,1081,1164,3452,397
48103,20749,12433,2222,6876,2647,688,4931,5390,1288,824,8316,2934,2945,1548,889,6363,1953
48104,16173,5635,1334,2523,1379,399,2022,2721,384,508,10538,7327,1842,881,488,6115,4423
48105,13910,8167,2010,4058,1781,318,3367,3569,712,519,5743,3036,1505,835,367,4167,1576
48108,9520,5648,1639,2923,965,121,2132,2174,826,516,3872,1844,1330,523,175,2924,948
48109,30,0,0,0,0,0,0,0,0,0,30,30,0,0,0,30,0
48111,15705,10329,2822,4982,2138,387,3619,4225,1472,1013,5376,1873,1929,1137,437,4231,1145
48114,6653,5379,657,3365,1202,155,2398,2279,441,261,1274,190,476,464,144,1064,210
48116,9346,6901,1174,3868,1628,231,2950,3090,448,413,2445,490,857,628,470,2056,389
48117,3651,2848,519,1494,682,153,1071,1274,238,265,803,142,299,217,145,685,118
48118,4322,3170,319,1879,781,191,1338,1476,229,127,1152,145,403,254,350,1002,150
48120,2615,1447,370,539,396,142,555,521,181,190,1168,202,329,302,335,984,184
48122,4504,2728,649,1224,646,209,783,1102,481,362,1776,338,580,555,303,1551,225
48124,14123,9001,1457,4201,2231,1112,3245,4176,629,951,5122,982,1506,1244,1390,4485,637
48125,8880,6194,1302,2714,1694,484,2008,2663,671,852,2686,619,987,698,382,2281,405
48126,15566,10494,2694,4779,2015,1006,4715,3160,1056,1563,5072,952,1280,1301,1539,4598,474
48127,14407,9669,1549,4031,2841,1248,3294,4471,566,1338,4738,757,1102,1527,1352,4235,503
48128,4392,2973,449,1451,642,431,1085,1400,222,266,1419,226,361,299,533,1277,142
48130,3750,2996,438,1738,678,142,1384,1192,248,172,754,177,350,133,94,606,148
48131,2357,1739,424,872,366,77,657,694,193,195,618,124,180,156,158,523,95
48133,2024,1472,277,732,427,36,576,643,139,114,552,101,199,155,97,463,89
48134,5952,4342,1108,2341,792,101,1679,1572,720,371,1610,404,587,389,230,1258,352
48135,11139,8118,1612,3939,2076,491,2887,3426,935,870,3021,589,893,996,543,2597,424
48137,1599,1243,202,678,288,75,482,605,75,81,356,61,159,97,39,304,52
48138,4110,3292,215,1838,1104,135,1193,1858,137,104,818,100,275,265,178,727,91
48139,34,21,0,17,4,0,5,16,0,0,13,0,5,8,0,13,0
48140,1097,930,140,513,241,36,393,424,85,28,167,24,67,43,33,151,16
48141,11166,7550,2067,3253,1739,491,1708,2302,2094,1446,3616,744,1257,1040,575,3108,508
48143,23,17,5,12,0,0,5,12,0,0,6,0,6,0,0,6,0
48144,3160,2548,372,1434,622,120,1098,1091,182,177,612,113,149,216,134,514,98
48145,1203,974,117,602,222,33,431,458,45,40,229,34,77,82,36,168,61
48146,16083,10645,2663,4697,2257,1028,3468,4150,1518,1509,5438,1246,1857,1252,1083,4650,788
48150,11066,7925,1431,3951,1828,715,3015,3500,601,809,3141,527,868,953,793,2707,434
48152,12462,8818,1154,4706,2328,630,3470,4100,530,718,3644,601,1099,1147,797,3181,463
48154,14703,11523,1071,5710,3696,1046,4315,5680,599,929,3180,427,856,1041,856,2831,349
48157,571,396,92,242,46,16,134,156,84,22,175,17,48,58,52,159,16
48158,2657,1987,276,1067,494,150,718,977,166,126,670,120,248,167,135,573,97
48159,897,702,100,396,186,20,310,260,66,66,195,39,54,84,18,170,25
48160,4147,3087,585,1703,681,118,1162,1423,336,166,1060,194,296,347,223,875,185
48161,9822,6784,1629,3128,1604,423,2434,2639,999,712,3038,567,1042,759,670,2654,384
48162,11213,7801,1661,3844,1845,451,2960,3388,863,590,3412,758,885,942,827,2935,477
48164,2695,2177,327,1264,442,144,975,910,116,176,518,88,221,130,79,409,109
48165,1905,1486,308,897,213,68,761,588,111,26,419,115,165,117,22,325,94
48166,3651,2863,708,1535,538,82,1191,1128,338,206,788,236,312,165,75,611,177
48167,14320,10073,1148,5198,3051,676,3775,5140,511,647,4247,1105,1296,1170,676,3688,559
48169,6850,5507,971,3157,1171,208,2395,2404,439,269,1343,281,533,372,157,1036,307
48170,16081,10655,1705,5355,2857,738,4020,5322,596,717,5426,1375,1708,1244,1099,4760,666
48173,3991,2930,549,1565,706,110,1060,1327,254,289,1061,234,391,324,112,870,191
48174,11041,7752,1892,3953,1620,287,2537,2917,1451,847,3289,678,1233,940,438,2658,631
48176,6521,5046,770,3007,1054,215,2459,2002,376,209,1475,368,469,355,283,1213,262
48178,8934,6756,1024,3801,1522,409,2788,3177,392,399,2178,497,616,677,388,1840,338
48179,1006,829,109,434,258,28,307,408,64,50,177,17,71,60,29,137,40
48180,24766,17842,4659,8135,4256,792,5512,6857,3438,2035,6924,1499,2371,2133,921,5698,1226
48182,7549,5972,810,3214,1603,345,2410,2688,472,402,1577,238,567,458,314,1359,218
48183,16063,11505,2035,6013,2767,690,4219,5189,1336,761,4558,993,1480,1356,729,3964,594
48184,7379,4916,1233,2282,1143,258,1657,1798,833,628,2463,463,954,627,419,2067,396
48185,22624,12448,3202,5564,2779,903,3944,5399,1577,1528,10176,2783,2871,2580,1942,8645,1531
48186,14352,10045,2696,4612,2333,404,3751,3877,1338,1079,4307,1011,1536,1059,701,3483,824
48187,16368,12142,2286,7032,2444,380,5707,4783,914,738,4226,1476,1367,810,573,3505,721
48188,11186,8568,2281,4798,1303,186,4173,3145,785,465,2618,858,1173,468,119,2104,514
48189,5102,3588,781,2028,635,144,1501,1607,272,208,1514,403,639,293,179,1146,368
48190,35,31,6,17,8,0,19,12,0,0,4,4,0,0,0,0,4
48191,957,762,97,424,217,24,261,360,59,82,195,5,61,67,62,158,37
48192,18419,12051,2319,5803,2912,1017,3975,5053,1545,1478,6368,1405,1873,1475,1615,5550,818
48195,12822,8039,1631,3543,2197,668,2731,3640,743,925,4783,1055,1401,1252,1075,4146,637
48197,21950,11581,4097,5294,1774,416,4147,4419,1895,1120,10369,5830,2839,1186,514,7363,3006
48198,15756,9820,2961,4385,2032,442,2775,3462,2129,1454,5936,2048,2202,1288,398,4712,1224
48201,7504,2309,973,915,294,127,211,351,1094,653,5195,1502,1486,1486,721,4421,774
48202,9049,4041,1205,1689,707,440,664,839,1356,1182,5008,1329,1828,1213,638,4330,678
48203,16407,10124,3012,4045,2350,717,1653,2039,3666,2766,6283,1082,2180,2102,919,5573,710
48204,15340,10094,2471,3946,2735,942,1135,2308,3667,2984,5246,869,1680,1779,918,4631,615
48205,19968,15399,4965,7737,2056,641,3953,2346,6105,2995,4569,1065,2044,1017,443,3724,845
48206,11901,7629,1975,3033,1698,923,916,1438,2820,2455,4272,575,1457,1336,904,3696,576
48207,11866,5372,1391,2289,1197,495,563,1180,2049,1580,6494,1175,2256,1979,1084,5907,587
48208,5304,2727,729,1194,519,285,344,486,1087,810,2577,504,869,834,370,2138,439
48209,11819,8287,3020,3512,1365,390,2816,1865,2079,1527,3532,758,1254,1009,511,2862,670
48210,12705,8738,2941,3470,1654,673,2414,1748,2490,2086,3967,788,1541,977,661,3232,735
48211,3291,2097,613,805,542,137,404,352,700,641,1194,185,466,329,214,951,243
48212,15269,9764,2724,4467,1773,800,2994,2157,2383,2230,5505,1120,1629,1484,1272,4526,979
48213,13764,9860,2898,3999,2319,644,1252,1929,3955,2724,3904,679,1373,1216,636,3292,612
48214,13033,6692,1709,2571,1554,858,790,1502,2172,2228,6341,978,2026,1953,1384,5633,708
48215,6796,4284,1182,1905,1021,176,600,969,1660,1055,2512,342,1039,796,335,2156,356
48216,2464,1340,498,568,217,57,326,284,412,318,1124,217,436,370,101,866,258
48217,3915,2655,471,970,764,450,461,764,573,857,1260,144,430,391,295,1140,120
48218,3662,2511,625,1087,614,185,540,660,785,526,1151,260,419,294,178,980,171
48219,21611,14758,3329,7783,3055,591,3513,3819,4277,3149,6853,1437,2894,1787,735,5990,863
48220,11023,5854,1406,2963,1120,365,1612,2183,1044,1015,5169,1925,1701,931,612,3884,1285
48221,16590,11689,1678,4684,4068,1259,2183,3849,2353,3304,4901,714,1528,1720,939,4400,501
48223,12413,8650,2654,4255,1510,231,2075,1885,3173,1517,3763,978,1724,781,280,3071,692
48224,18675,13231,3611,7009,2043,568,3948,2744,4109,2430,5444,1320,2450,1135,539,4537,907
48225,6384,3769,890,1741,638,500,1330,1531,464,444,2615,553,740,581,741,2317,298
48226,2598,611,173,263,140,35,47,223,164,177,1987,445,855,476,211,1788,199
48227,20756,14945,3904,6756,3673,612,2471,3253,5134,4087,5811,1119,2482,1737,473,5018,793
48228,23301,15915,4961,7297,2728,929,3723,3372,5464,3356,7386,1602,2869,1781,1134,6142,1244
48229,4304,2748,763,1054,700,231,571,878,706,593,1556,342,541,457,216,1323,233
48230,7249,4903,592,2709,1234,368,2131,2040,367,365,2346,618,685,596,447,1996,350
48234,15449,11089,2862,5170,2262,795,2171,2382,3822,2714,4360,704,1613,1388,655,3822,538
48235,19738,13654,2780,6099,4041,734,2653,4132,3393,3476,6084,836,2081,2272,895,5411,673
48236,12131,9154,862,4654,2597,1041,3686,4256,501,711,2977,352,782,960,883,2692,285
48237,12576,8277,1732,4013,1767,765,2637,2705,1500,1435,4299,866,1583,995,855,3700,599
48238,16329,11012,3103,3936,2789,1184,1362,2372,4027,3251,5317,983,1808,1715,811,4663,654
48239,14908,10184,2161,4881,1983,1159,3776,3918,1122,1368,4724,870,1590,1124,1140,4026,698
48240,7316,4900,1178,2277,1033,412,1772,1859,602,667,2416,505,881,500,530,1985,431
48242,0,0,0,0,0,0,0,0,0,0,0,0,0,0,0,0,0
48301,5628,4460,217,2290,1580,373,1842,2343,116,159,1168,114,275,468,311,1099,69
48302,6420,4926,224,2312,1951,439,1770,2721,122,313,1494,267,463,421,343,1350,144
48304,6695,4994,222,2380,2000,392,1771,2698,210,315,1701,110,571,626,394,1537,164
48306,7712,6649,620,4147,1706,176,3384,2795,242,228,1063,148,362,327,226,977,86
48307,15713,9931,2200,5552,1760,419,4178,4158,866,729,5782,2031,1896,1078,777,4874,908
48309,10422,7730,783,4201,2329,417,3106,3885,306,433,2692,487,729,797,679,2417,275
48310,14654,11135,1663,5858,3043,571,4513,4865,649,1108,3519,986,1116,822,595,2950,569
48312,12945,8684,1320,3697,2846,821,2864,4463,516,841,4261,1072,1174,1042,973,3763,498
48313,12381,9208,1766,5164,1989,289,3904,3720,805,779,3173,790,969,742,672,2755,418
48314,6253,4398,816,2347,1028,207,1930,1944,232,292,1855,550,539,350,416,1642,213
48315,8049,6308,549,3502,1830,427,2641,3057,296,314,1741,216,448,637,440,1547,194
48316,7760,6071,827,3132,1898,214,2315,3040,333,383,1689,531,523,470,165,1400,289
48317,10644,6860,1815,3331,1428,286,2564,2797,799,700,3784,1578,1237,570,399,3010,774
48320,2022,1142,267,588,236,51,387,513,169,73,880,265,398,137,80,721,159
48322,11219,8347,847,4255,2456,789,3496,4070,302,479,2872,305,907,919,741,2608,264
48323,6304,5236,418,2835,1652,331,2214,2534,277,211,1068,105,408,419,136,927,141
48324,6315,5010,618,3067,1172,153,2338,2171,254,247,1305,246,541,386,132,1043,262
48326,7828,4474,1486,2028,768,192,1569,1848,565,492,3354,1367,1109,586,292,2614,740
48327,8864,5444,1422,2787,997,238,2083,2243,619,499,3420,1048,1215,714,443,2708,712
48328,10726,6482,1706,3033,1337,406,2270,2600,889,723,4244,1164,1475,841,764,3399,845
48329,10007,7369,1428,3756,1769,416,2821,3506,510,532,2638,591,1005,679,363,2097,541
48331,8364,6426,562,3777,1805,282,2892,3008,318,208,1938,627,667,404,240,1625,313
48334,7559,4929,599,2471,1220,639,1824,2428,346,331,2630,491,592,783,764,2361,269
48335,10536,5780,1423,2624,1326,407,2167,2893,348,372,4756,1950,1116,778,912,3990,766
48336,11186,6854,1285,3593,1459,517,2494,2971,645,744,4332,982,1339,1124,887,3761,571
48340,9708,5924,2320,2519,812,273,1717,1577,1730,900,3784,1154,1345,778,507,3021,763
48341,7273,4365,1155,1949,960,301,1030,1203,1140,992,2908,624,1174,730,380,2399,509
48342,7154,4972,1551,2091,1150,180,1083,1175,1716,998,2182,491,955,571,165,1705,477
48346,8944,6561,1306,3449,1612,194,2462,2982,631,486,2383,805,799,480,299,1955,428
48348,6597,5571,777,3489,1196,109,2631,2274,392,274,1026,226,438,290,72,779,247
48350,2468,1945,351,1069,446,79,873,799,189,84,523,110,219,139,55,397,126
48353,2158,1810,278,988,489,55,721,913,89,87,348,42,143,122,41,283,65
48356,3139,2456,397,1471,493,95,1047,1062,200,147,683,169,232,201,81,566,117
48357,3290,2557,545,1390,576,46,1057,1029,329,142,733,192,185,253,103,556,177
48359,2823,1902,517,1041,255,89,883,620,216,183,921,386,322,170,43,668,253
48360,4040,3110,628,1777,635,70,1525,1243,182,160,930,304,344,178,104,767,163
48362,5134,3698,755,2174,704,65,1610,1536,292,260,1436,402,595,285,154,1091,345
48363,1572,1272,103,742,375,52,510,598,86,78,300,35,126,107,32,272,28
48367,1698,1308,185,764,327,32,547,542,124,95,390,96,133,129,32,285,105
48370,618,482,72,276,124,10,201,253,16,12,136,28,50,46,12,91,45
48371,6701,5149,1033,2898,1034,184,2250,2120,428,351,1552,372,578,319,283,1286,266
48374,3576,3225,454,2336,419,16,2104,860,187,74,351,56,159,115,21,275,76
48375,8159,5456,920,3276,1041,219,2621,2300,213,322,2703,827,1077,542,257,2243,460
48377,5243,2577,851,1134,437,155,794,1194,313,276,2666,1321,896,283,166,2107,559
48380,1925,1717,125,1119,368,105,826,754,57,80,208,17,100,65,26,162,46
48381,4505,3404,561,1905,843,95,1398,1362,398,246,1101,220,512,237,132,912,189
48382,6550,5385,780,3392,1069,144,2689,2141,317,238,1165,214,533,307,111,891,274
48383,4224,3383,659,2077,588,59,1532,1364,290,197,841,187,375,222,57,647,194
48386,5921,4470,619,2548,1118,185,1817,2038,360,255,1451,274,628,355,194,1158,293
48390,7890,5372,1004,2992,1162,214,2237,2163,526,446,2518,545,1036,614,323,2149,369
48393,7014,3932,1207,2067,560,98,1737,1344,558,293,3082,1655,1009,311,107,2489,593
48401,574,429,60,201,141,27,159,215,28,27,145,24,35,50,36,123,22
48412,2020,1622,277,885,384,76,715,695,118,94,398,67,136,127,68,311,87
48413,3041,2145,377,1051,541,176,837,935,239,134,896,200,257,227,212,787,109
48414,900,746,123,399,193,31,265,356,75,50,154,8,75,43,28,126,28
48415,3509,2732,531,1362,716,123,967,1268,303,194,777,158,253,209,157,632,145
48416,1849,1460,306,707,382,65,588,652,114,106,389,91,105,113,80,325,64
48417,1049,859,179,493,162,25,376,345,103,35,190,31,68,52,39,140,50
48418,1437,1189,241,561,348,39,461,585,73,70,248,33,117,54,44,188,60
48419,1056,812,130,377,260,45,276,412,74,50,244,25,67,95,57,214,30
48420,8348,6330,1194,3249,1567,320,2198,2991,689,452,2018,427,637,602,352,1637,381
48421,2448,1976,349,1014,546,67,837,895,129,115,472,101,152,167,52,397,75
48422,2353,1749,385,834,443,87,645,764,214,126,604,103,189,155,157,520,84
48423,12815,8533,1765,4311,1966,491,3041,3781,1113,598,4282,1354,1283,1079,566,3541,741
48426,426,325,50,149,107,19,118,150,31,26,101,21,42,25,13,83,18
48427,1181,823,120,376,246,81,293,405,69,56,358,52,102,104,100,309,49
48428,1684,1467,230,849,342,46,652,640,92,83,217,28,132,38,19,206,11
48429,3750,2806,556,1388,673,189,998,1179,422,207,944,168,330,241,205,776,168
48430,12195,9091,1386,5072,2316,317,3412,4225,870,584,3104,742,963,856,543,2544,560
48432,303,233,32,117,61,23,84,106,21,22,70,10,17,14,29,60,10
48433,9777,7370,905,3895,2037,533,2725,3410,612,623,2407,323,696,811,577,2198,209
48434,47,22,7,8,5,2,8,12,2,0,25,0,4,3,18,25,0
48435,764,610,95,308,154,53,257,282,29,42,154,11,59,39,45,131,23
48436,1246,1013,146,622,221,24,411,509,57,36,233,12,126,69,26,178,55
48437,125,87,31,32,18,6,36,33,18,0,38,4,5,19,10,34,4
48438,2057,1750,244,1087,394,25,830,751,106,63,307,66,161,60,20,258,49
48439,15794,10939,2120,5620,2679,520,4339,5052,904,644,4855,1527,1601,1060,667,4048,807
48440,25,25,5,10,10,0,15,10,0,0,0,0,0,0,0,0,0
48441,1808,1300,229,581,374,116,487,600,106,107,508,42,113,160,193,484,24
48442,6846,5171,991,2884,1124,172,2146,2244,448,333,1675,407,594,411,263,1322,353
48444,3210,2375,456,1235,559,125,1021,962,190,202,835,147,242,208,238,742,93
48445,705,519,83,186,182,68,153,284,41,41,186,19,50,71,46,168,18
48446,11065,8195,1485,4411,1884,415,3150,3469,1015,561,2870,632,974,826,438,2453,417
48449,1365,1093,238,512,264,79,431,475,104,83,272,45,77,114,36,235,37
48450,2233,1455,235,582,488,150,449,796,111,99,778,80,211,253,234,702,76
48451,4429,3456,740,1764,792,160,1450,1532,336,138,973,206,398,235,134,795,178
48453,1932,1426,280,715,335,96,553,625,151,97,506,90,161,115,140,438,68
48454,399,298,54,144,81,19,121,130,18,29,101,14,38,31,18,88,13
48455,2904,2339,322,1333,618,66,967,1151,100,121,565,92,209,177,87,449,116
48456,398,301,53,140,78,30,115,137,29,20,97,25,23,15,34,90,7
48457,2930,2304,422,1147,649,86,822,997,254,231,626,75,232,197,122,527,99
48458,9412,6444,1448,2993,1608,395,1766,2284,1552,842,2968,648,1017,920,383,2516,452
48460,898,696,115,326,215,40,276,324,65,31,202,52,46,55,49,178,24
48461,2571,2167,405,1220,462,80,999,846,192,130,404,66,129,130,79,344,60
48462,4505,3702,580,2381,681,60,1728,1542,273,159,803,156,332,229,86,631,172
48463,1750,1364,239,734,354,37,473,659,134,98,386,45,142,147,52,319,67
48464,717,563,140,241,156,26,232,247,47,37,154,27,75,51,1,118,36
48465,237,168,19,74,54,21,52,96,9,11,69,14,14,17,24,68,1
48466,581,446,96,220,105,25,153,199,58,36,135,22,27,50,36,120,15
48467,1234,767,74,288,313,92,203,483,33,48,467,49,123,162,133,429,38
48468,583,431,42,160,167,62,105,282,17,27,152,8,36,59,49,148,4
48469,659,398,64,132,150,52,92,234,37,35,261,19,44,102,96,236,25
48470,321,238,55,88,62,33,112,104,6,16,83,14,21,18,30,76,7
48471,2246,1540,279,787,371,103,603,635,198,104,706,124,211,177,194,625,81
48472,712,570,126,262,144,38,227,248,47,48,142,12,38,46,46,117,25
48473,7514,5660,812,2988,1588,272,1974,2836,550,300,1854,250,592,653,359,1609,245
48475,1061,766,126,343,222,75,307,352,55,52,295,70,59,87,79,267,28
48476,147,125,20,66,32,7,33,53,15,24,22,4,13,3,2,17,5
48502,272,48,39,9,0,0,0,29,11,8,224,104,76,34,10,212,12
48503,12477,7140,2196,2920,1456,568,1673,2224,2109,1134,5337,1102,1937,1474,824,4663,674
48504,14338,9889,2741,4794,1921,433,2232,2420,3473,1764,4449,977,1586,1211,675,3790,659
48505,12290,8669,2619,3369,2274,407,1253,1831,3407,2178,3621,508,1414,1329,370,3139,482
48506,12988,8588,2566,3754,1842,426,2566,3016,2009,997,4400,857,1688,1194,661,3584,816
48507,14235,8818,2454,3723,2100,541,2390,3553,1818,1057,5417,1216,1835,1305,1061,4597,820
48509,3889,2918,544,1423,737,214,882,1372,372,292,971,93,289,357,232,844,127
48519,2706,1845,387,933,455,70,770,811,131,133,861,141,264,257,199,768,93
48529,4438,2919,988,1340,499,92,890,942,784,303,1519,353,513,458,195,1274,245
48532,8273,5279,1080,2362,1479,358,1573,2150,941,615,2994,637,1001,750,606,2580,414
48601,17147,12476,3376,5564,2844,692,2545,3577,4159,2195,4671,669,1595,1731,676,4105,566
48602,13047,8147,2511,3656,1349,631,2592,2801,1853,901,4900,1167,1689,1139,905,4174,726
48603,16771,10506,1538,4988,3013,967,3285,5368,1026,827,6265,1598,1394,1538,1735,5361,904
48604,4329,3013,649,1312,818,234,978,1407,420,208,1316,389,366,301,260,1067,249
48607,1079,450,120,180,101,49,63,73,172,142,629,115,238,191,85,545,84
48609,4796,3645,511,1713,1165,256,1159,1922,288,276,1151,130,414,374,233,1031,120
48610,1433,1021,106,419,421,75,254,588,110,69,412,31,123,165,93,364,48
48611,2287,1714,242,877,485,110,625,760,186,143,573,117,191,136,129,488,85
48612,3752,2700,489,1166,860,185,804,1406,308,182,1052,122,279,410,241,912,140
48613,385,300,52,133,104,11,108,145,23,24,85,7,38,19,21,75,10
48614,476,361,85,176,98,2,149,157,39,16,115,14,32,37,32,89,26
48615,1164,873,203,411,220,39,318,395,112,48,291,59,88,84,60,257,34
48616,2903,2162,359,1102,541,160,805,1019,165,173,741,163,211,203,164,649,92
48617,3328,2293,518,1009,621,145,837,951,328,177,1035,227,274,299,235,883,152
48618,2020,1525,303,737,387,98,540,750,153,82,495,89,137,151,118,424,71
48619,197,143,10,61,47,25,29,93,12,9,54,5,9,25,15,47,7
48620,17,17,0,0,14,3,0,17,0,0,0,0,0,0,0,0,0
48621,620,439,38,209,149,43,133,245,41,20,181,9,38,58,76,173,8
48622,2443,1798,297,789,542,170,508,952,216,122,645,94,201,218,132,535,110
48623,4038,3189,514,1787,754,134,1343,1540,210,96,849,182,245,260,162,709,140
48624,6535,4772,710,1857,1831,374,1359,2724,437,252,1763,197,432,725,409,1532,231
48625,5646,3876,694,1462,1456,264,986,2142,486,262,1770,207,464,714,385,1500,270
48626,2134,1719,282,834,520,83,629,809,177,104,415,91,165,70,89,355,60
48627,124,82,7,33,29,13,13,59,7,3,42,4,13,18,7,35,7
48628,839,615,56,286,246,27,156,390,33,36,224,46,53,94,31,184,40
48629,3387,2232,304,793,852,283,498,1428,208,98,1155,139,365,369,282,973,182
48630,102,70,11,15,33,11,6,39,20,5,32,0,6,13,13,32,0
48631,1711,1301,196,685,349,71,431,695,107,68,410,100,100,108,102,323,87
48632,2170,1535,232,573,610,120,362,933,149,91,635,60,191,252,132,536,99
48633,32,17,0,4,13,0,0,13,2,2,15,0,3,10,2,10,5
48634,1676,1287,210,671,345,61,499,632,87,69,389,66,107,114,102,324,65
48635,811,580,78,199,244,59,143,373,38,26,231,19,65,100,47,194,37
48636,500,378,66,127,146,39,88,234,44,12,122,11,26,65,20,92,30
48637,1268,989,140,484,307,58,374,490,68,57,279,43,71,84,81,243,36
48640,12601,8826,1686,4429,2158,553,3559,3914,933,420,3775,1223,1132,815,605,3095,680
48642,12166,8602,1663,4577,1851,511,3564,3700,860,478,3564,893,892,1050,729,2993,571
48647,1899,1316,216,543,449,108,410,695,159,52,583,76,150,249,108,506,77
48649,619,507,71,259,142,35,176,231,54,46,112,19,26,38,29,95,17
48650,2951,2217,386,1091,596,144,691,1122,243,161,734,97,230,234,173,616,118
48651,2271,1594,150,546,705,193,307,1025,184,78,677,91,186,248,152,588,89
48652,574,428,72,217,116,23,167,193,36,32,146,24,50,50,22,118,28
48653,4325,3046,304,1209,1230,303,751,1915,226,154,1279,123,398,434,324,1137,142
48654,1061,764,91,356,264,53,229,405,73,57,297,21,103,109,64,254,43
48655,2481,1947,352,978,510,107,718,892,201,136,534,66,175,134,159,471,63
48656,2044,1364,173,430,616,145,292,782,135,155,680,86,190,263,141,603,77
48657,3156,2368,447,1174,632,115,859,1252,164,93,788,170,288,240,90,622,166
48658,2103,1438,295,658,385,100,445,658,214,121,665,81,195,202,187,586,79
48659,1038,799,135,384,236,44,259,380,118,42,239,38,78,69,54,213,26
48661,4038,2799,477,1197,920,205,895,1422,283,199,1239,194,391,388,266,1070,169
48662,625,477,101,221,119,36,200,226,28,23,148,23,55,29,41,132,16
48701,578,425,85,189,121,30,140,200,57,28,153,25,46,44,38,128,25
48703,1514,1025,99,431,407,88,249,652,80,44,489,45,165,160,119,432,57
48705,257,173,17,66,73,17,32,112,24,5,84,2,34,29,19,80,4
48706,16614,11432,2002,5314,3271,845,3577,5488,1338,1029,5182,1026,1503,1416,1237,4523,659
48708,11782,7527,1633,3539,1776,579,2408,3177,1262,680,4255,884,1276,1044,1051,3682,573
48720,481,328,47,174,75,32,148,128,18,34,153,23,62,37,31,131,22
48721,206,147,12,58,73,4,39,93,9,6,59,0,31,16,12,57,2
48722,1325,989,146,446,322,75,263,596,71,59,336,49,129,99,59,292,44
48723,4752,3315,673,1551,800,291,1198,1384,466,267,1437,188,502,462,285,1228,209
48724,127,99,2,55,42,0,34,47,18,0,28,0,6,22,0,28,0
48725,1178,725,85,258,270,112,143,458,68,56,453,64,98,149,142,398,55
48726,2490,1785,306,880,456,143,607,856,227,95,705,117,187,196,205,621,84
48727,462,340,56,175,91,18,136,150,31,23,122,8,36,41,37,101,21
48728,145,95,2,26,47,20,7,76,2,10,50,2,11,25,12,41,9
48729,579,456,75,243,106,32,157,193,62,44,123,17,45,44,17,95,28
48730,2246,1407,200,508,523,176,350,789,169,99,839,92,222,253,272,737,102
48731,735,542,105,257,134,46,157,257,81,47,193,49,38,51,55,173,20
48732,4951,3182,520,1658,778,226,1048,1482,437,215,1769,349,510,442,468,1562,207
48733,807,612,96,274,173,69,177,343,50,42,195,27,51,46,71,175,20
48734,3020,2059,235,1004,647,173,773,1079,111,96,961,134,165,237,425,894,67
48735,372,261,41,118,85,17,74,145,27,15,111,12,35,40,24,92,19
48737,619,412,60,97,208,47,71,282,37,22,207,6,43,118,40,183,24
48738,681,471,39,133,243,56,74,349,29,19,210,19,33,90,68,189,21
48739,2035,1417,143,533,593,148,303,900,156,58,618,56,146,278,138,529,89
48740,1063,735,73,280,299,83,166,464,58,47,328,22,90,103,113,285,43
48741,784,613,96,300,165,52,217,285,73,38,171,31,54,55,31,136,35
48742,805,537,63,188,213,73,125,336,49,27,268,16,49,110,93,244,24
48743,15,10,0,0,10,0,0,5,0,5,5,0,0,5,0,5,0
48744,1767,1349,212,730,343,64,560,594,105,90,418,78,137,115,88,358,60
48745,554,402,49,170,140,43,118,243,24,17,152,11,55,69,17,129,23
48746,3185,2560,466,1306,693,95,943,1213,256,148,625,102,201,173,149,525,100
48747,562,433,48,221,130,34,149,236,13,35,129,13,37,41,38,103,26
48748,780,547,52,196,249,50,116,369,45,17,233,25,67,92,49,207,26
48749,494,361,55,154,121,31,122,171,34,34,133,16,35,51,31,110,23
48750,3950,2619,423,1037,991,168,712,1408,370,129,1331,243,353,486,249,1169,162
48754,348,234,43,107,52,32,86,118,21,9,114,21,23,46,24,99,15
48755,1311,987,110,398,349,130,295,599,54,39,324,39,70,114,101,303,21
48756,1755,1230,197,477,445,111,290,683,151,106,525,41,137,208,139,457,68
48757,1540,1164,202,588,289,85,437,578,107,42,376,73,83,103,117,341,35
48759,1556,1053,180,499,285,89,331,477,105,140,503,78,109,119,197,473,30
48760,426,319,47,152,88,32,112,140,33,34,107,13,41,33,20,78,29
48761,520,347,19,116,162,50,68,249,11,19,173,11,35,95,32,153,20
48762,598,440,49,168,183,40,113,264,24,39,158,11,39,56,52,147,11
48763,2034,1446,169,622,509,146,427,792,137,90,588,74,179,175,160,498,90
48765,355,270,45,120,93,12,87,146,33,4,85,18,28,16,23,68,17
48766,528,382,61,200,96,25,111,186,54,31,146,17,51,46,32,122,24
48767,890,663,122,295,190,56,237,349,41,36,227,38,59,53,77,207,20
48768,3614,2813,567,1382,694,170,1051,1301,272,189,801,122,243,260,176,718,83
48770,816,569,88,239,185,57,164,298,54,53,247,26,77,87,57,200,47
48801,4584,3032,628,1491,727,186,1041,1293,469,229,1552,343,419,394,396,1259,293
48806,673,532,117,245,142,28,194,263,42,33,141,19,39,21,62,126,15
48807,356,259,55,118,66,20,82,130,27,20,97,17,29,21,30,89,8
48808,1572,1215,196,674,291,54,460,597,107,51,357,69,213,65,10,284,73
48809,4037,2924,791,1489,467,177,1049,1105,612,158,1113,157,402,337,217,929,184
48811,1241,932,240,414,235,43,365,389,127,51,309,37,85,95,92,275,34
48813,7567,5660,1118,2932,1337,273,2133,2553,630,344,1907,394,644,501,368,1582,325
48815,740,548,105,278,151,14,221,261,41,25,192,44,55,53,40,176,16
48817,2536,1743,378,879,406,80,653,755,235,100,793,140,284,202,167,684,109
48818,1048,710,156,277,227,50,219,356,88,47,338,42,116,92,88,273,65
48819,808,668,119,360,166,23,255,300,60,53,140,27,64,37,12,111,29
48820,5093,4068,596,2382,960,130,1784,1765,364,155,1025,253,327,275,170,858,167
48821,2245,1626,163,838,499,126,533,912,72,109,619,55,213,207,144,534,85
48822,878,690,57,390,211,32,257,367,31,35,188,50,87,35,16,147,41
48823,19469,8160,1969,3758,1868,565,2864,3568,908,820,11309,7521,1763,1090,935,6591,4718
48824,0,0,0,0,0,0,0,0,0,0,0,0,0,0,0,0,0
48827,5411,4145,841,2118,1026,160,1725,1731,429,260,1266,212,513,289,252,1057,209
48829,1259,925,215,416,220,74,349,420,108,48,334,45,84,104,101,297,37
48830,21,13,5,4,4,0,5,6,2,0,8,2,0,3,3,4,4
48831,1351,1012,195,466,283,68,385,477,103,47,339,43,101,95,100,280,59
48832,517,415,110,163,121,21,167,187,46,15,102,18,43,24,17,83,19
48834,839,665,121,342,188,14,238,293,79,55,174,41,59,43,31,145,29
48835,1099,882,160,432,236,54,417,385,30,50,217,60,51,42,64,187,30
48836,4090,3156,611,1773,632,140,1411,1171,318,256,934,250,293,228,163,755,179
48837,6772,5012,835,2749,1189,239,1992,2215,490,315,1760,356,555,522,327,1461,299
48838,6317,4446,1098,2058,981,309,1576,1931,682,257,1871,389,622,498,362,1546,325
48840,5299,3126,580,1833,576,137,1255,1228,474,169,2173,740,626,429,378,1794,379
48841,276,241,43,110,68,20,89,105,16,31,35,4,11,12,8,29,6
48842,7116,5168,1014,2952,983,219,2079,2004,788,297,1948,465,654,415,414,1641,307
48843,15494,12054,2620,6533,2445,456,5310,5086,1006,652,3440,949,1294,774,423,2746,694
48845,333,254,55,119,74,6,101,102,31,20,79,8,28,33,10,59,20
48846,5608,3907,975,1884,814,234,1387,1654,630,236,1701,305,626,444,326,1383,318
48847,2406,1769,342,866,435,126,644,854,176,95,637,85,154,199,199,573,64
48848,2766,2230,386,1315,465,64,909,1000,218,103,536,97,169,176,94,438,98
48849,2257,1706,365,807,429,105,684,739,175,108,551,119,159,151,122,456,95
48850,1726,1279,244,603,340,92,488,588,122,81,447,76,123,144,104,350,97
48851,831,623,117,335,145,26,231,288,66,38,208,37,81,56,34,179,29
48852,38,28,9,11,6,2,9,13,5,1,10,0,2,6,2,10,0
48853,168,122,40,50,26,6,47,46,20,9,46,5,7,16,18,44,2
48854,6296,4662,688,2599,1188,187,1755,2118,504,285,1634,337,519,431,347,1377,257
48856,337,255,48,112,66,29,102,112,27,14,82,25,34,12,11,72,10
48857,825,654,161,312,152,29,243,299,63,49,171,41,63,51,16,115,56
48858,15249,7619,2062,3610,1529,418,2678,3074,1215,652,7630,4745,1329,897,659,3910,3720
48860,504,372,99,153,92,28,119,151,77,25,132,30,48,24,30,99,33
48861,582,452,80,244,90,38,174,205,45,28,130,16,52,49,13,101,29
48864,7802,5135,740,3000,1160,235,2256,2231,511,137,2667,1262,865,380,160,1908,759
48865,685,500,110,238,127,25,163,238,62,37,185,37,77,46,25,131,54
48866,1645,1277,245,616,322,94,483,553,137,104,368,93,139,86,50,319,49
48867,11044,7785,1552,3700,1947,586,2605,3527,1031,622,3259,575,976,947,761,2804,455
48871,699,549,90,224,200,35,187,290,31,41,150,30,58,33,29,120,30
48872,2668,2101,416,1190,405,90,813,910,271,107,567,142,150,158,117,465,102
48873,602,477,107,222,120,28,236,186,29,26,125,11,44,21,49,104,21
48874,61,46,13,31,0,2,15,22,9,0,15,6,0,9,0,15,0
48875,3274,2553,535,1374,550,94,1157,1058,206,132,721,142,200,199,180,619,102
48876,1264,950,274,446,205,25,392,368,132,58,314,57,139,78,40,253,61
48877,932,724,150,357,183,34,281,280,115,48,208,55,58,74,21,149,59
48878,618,473,94,235,114,30,191,201,56,25,145,35,46,31,33,123,22
48879,6309,4804,967,2473,1098,266,2000,2079,458,267,1505,367,458,348,332,1287,218
48880,2546,1779,391,827,412,149,562,857,234,126,767,154,191,262,160,639,128
48881,1983,1508,356,769,317,66,648,608,157,95,475,61,132,161,121,413,62
48883,2669,2034,425,996,496,117,757,857,247,173,635,146,235,158,96,512,123
48884,1531,1154,236,536,303,79,436,561,103,54,377,59,137,116,65,296,81
48885,313,248,44,142,52,10,94,97,38,19,65,21,12,21,11,43,22
48886,848,600,128,233,194,45,213,275,63,49,248,43,52,104,49,208,40
48888,2572,1953,385,897,524,147,626,923,279,125,619,98,184,174,163,515,104
48889,496,379,73,183,101,22,142,189,34,14,117,20,38,33,26,96,21
48890,771,598,129,303,123,43,204,286,57,51,173,25,77,49,22,152,21
48891,1080,821,183,379,201,58,265,394,104,58,259,38,63,91,67,217,42
48892,1569,1237,261,660,255,61,498,514,124,101,332,76,101,88,67,283,49
48893,1833,1342,274,570,425,73,412,719,143,68,491,115,166,143,67,386,105
48894,245,185,41,69,64,11,82,87,11,5,60,13,6,11,30,56,4
48895,4156,3158,487,1697,791,183,1320,1416,242,180,998,210,347,281,160,812,186
48896,45,35,5,28,2,0,12,13,6,4,10,8,0,2,0,10,0
48897,571,454,80,196,136,42,140,253,44,17,117,13,32,29,43,104,13
48906,10378,6668,1758,2983,1539,388,2078,2565,1375,650,3710,970,1356,842,542,2853,857
48910,15795,8609,2840,3772,1421,576,2634,3250,1670,1055,7186,2478,2411,1387,910,5631,1555
48911,15685,10306,3052,4967,1892,395,3306,3238,2543,1219,5379,1681,1949,1345,404,4359,1020
48912,8084,4034,1175,1815,784,260,1152,1543,808,531,4050,1476,1387,766,421,3073,977
48915,4144,2492,861,1047,437,147,607,771,774,340,1652,579,604,325,144,1236,416
48917,13687,8354,1722,4032,1984,616,2837,3721,1052,744,5333,1608,1698,1194,833,4392,941
48933,1491,296,144,101,39,12,57,109,50,80,1195,465,344,258,128,1065,130
49001,16760,9862,3115,4472,1728,547,3002,3346,2370,1144,6898,2185,2336,1392,985,5424,1474
49002,8162,4994,987,2432,1233,342,1714,2278,639,363,3168,1147,876,704,441,2586,582
49004,8266,6219,1312,2904,1526,477,2356,2821,623,419,2047,327,619,674,427,1790,257
49006,10206,4247,1440,1537,856,414,1104,1787,804,552,5959,3577,1079,610,693,3426,2533
49007,4578,2146,763,870,447,66,390,494,775,487,2432,1307,570,417,138,1581,851
49008,7337,3470,822,1517,878,253,1012,1712,469,277,3867,1633,947,759,528,2819,1048
49009,12140,7706,1562,3848,1869,427,2921,3511,824,450,4434,2038,1098,704,594,3313,1121
49010,6225,4577,962,2210,1093,312,1552,2102,644,279,1648,312,612,447,277,1378,270
49011,811,617,137,309,126,45,277,252,54,34,194,29,49,67,49,153,41
49012,1429,1042,142,557,300,43,342,560,95,45,387,75,127,118,67,316,71
49013,1957,1434,306,649,376,103,537,545,210,142,523,61,159,198,105,457,66
49014,8607,5863,1247,2831,1428,357,1832,2471,969,591,2744,614,1030,716,384,2288,456
49015,13928,9037,2124,4214,2026,673,3038,3741,1478,780,4891,1295,1528,1157,911,4070,821
49016,0,0,0,0,0,0,0,0,0,0,0,0,0,0,0,0,0
49017,14915,9570,2337,4346,2209,678,2886,3919,1746,1019,5345,842,1717,1601,1185,4660,685
49021,2241,1742,281,906,461,94,594,876,175,97,499,89,166,138,106,428,71
49022,13384,8839,2569,3674,2050,546,1897,2994,2583,1365,4545,696,1589,1501,759,3812,733
49024,10855,7879,1539,4086,1865,389,3295,3234,867,483,2976,941,804,740,491,2481,495
49026,1003,738,128,380,179,51,264,298,101,75,265,58,94,75,38,176,89
49027,45,39,3,22,14,0,9,21,7,2,6,0,4,0,2,6,0
49028,2426,1790,429,812,419,130,672,737,204,177,636,91,170,214,161,532,104
49029,650,525,83,263,162,17,149,291,59,26,125,37,23,41,24,100,25
49030,927,701,138,319,187,57,254,329,75,43,226,50,57,57,62,182,44
49031,3131,2200,425,1025,600,150,679,1098,261,162,931,118,363,298,152,768,163
49032,1014,777,161,390,182,44,330,348,61,38,237,50,53,90,44,214,23
49033,602,503,69,258,149,27,187,256,26,34,99,21,22,49,7,68,31
49034,811,646,101,363,147,35,260,305,48,33,165,46,31,40,48,135,30
49036,8842,6028,1188,2798,1643,399,2025,2843,756,404,2814,480,812,862,660,2365,449
49038,4088,2861,503,1409,723,226,1006,1340,338,177,1227,210,391,451,175,1068,159
49040,1404,992,209,433,276,74,318,471,119,84,412,50,121,126,115,349,63
49042,1825,1350,262,688,336,64,480,583,213,74,475,81,157,150,87,387,88
49043,918,621,107,331,160,23,205,215,115,86,297,38,83,101,75,267,30
49045,2070,1469,286,697,394,92,506,646,211,106,601,101,183,178,139,491,110
49046,2726,2057,337,953,682,85,702,1088,163,104,669,116,233,181,139,564,105
49047,5878,4134,833,1874,1130,297,1188,1936,635,375,1744,321,452,558,413,1494,250
49050,605,424,85,206,122,11,182,227,7,8,181,49,64,45,23,119,62
49051,865,662,141,256,227,38,197,369,49,47,203,21,73,69,40,179,24
49052,294,256,35,129,70,22,89,127,23,17,38,5,8,18,7,32,6
49053,2381,1714,380,839,416,79,584,813,239,78,667,128,278,175,86,507,160
49055,2223,1633,330,813,412,78,632,723,157,121,590,69,267,181,73,481,109
49056,1466,1105,248,490,312,55,344,490,148,123,361,32,164,85,80,290,71
49057,2338,1740,428,795,429,88,623,701,266,150,598,73,197,206,122,501,97
49058,6790,5050,992,2480,1212,366,1935,2374,474,267,1740,253,525,535,427,1465,275
49060,797,636,58,364,174,40,231,367,29,9,161,34,51,26,50,130,31
49061,581,449,73,233,136,7,148,222,38,41,132,16,40,61,15,104,28
49064,1344,1014,195,499,244,76,370,455,124,65,330,46,110,96,78,261,69
49065,2283,1742,298,967,402,75,705,734,208,95,541,89,190,168,94,429,112
49066,251,211,28,97,64,22,62,125,16,8,40,2,17,15,6,34,6
49067,1646,1209,260,524,358,67,403,585,134,87,437,89,121,132,95,365,72
49068,6001,4260,780,2059,1067,354,1637,2036,345,242,1741,338,486,462,455,1552,189
49070,777,605,146,279,147,33,221,279,81,24,172,31,68,29,44,145,27
49071,2925,2352,409,1508,379,56,1109,873,262,108,573,102,232,176,63,480,93
49072,1214,941,186,460,233,62,347,456,107,31,273,51,93,70,59,243,30
49073,1902,1431,295,723,341,72,469,692,194,76,471,82,132,138,119,387,84
49075,58,39,17,20,2,0,6,3,30,0,19,4,8,4,3,19,0
49076,1440,1044,270,521,216,37,435,395,150,64,396,116,117,102,61,290,106
49078,3418,2507,467,1287,573,180,939,1089,313,166,911,155,281,266,209,747,164
49079,4814,3480,604,1711,904,261,1287,1575,317,301,1334,254,441,389,250,1111,223
49080,5352,4130,804,2260,947,119,1694,1743,438,255,1222,201,406,342,273,978,244
49082,2388,1783,386,921,391,85,673,756,263,91,605,110,185,171,139,500,105
49083,2405,1879,201,1109,485,84,791,921,117,50,526,59,208,180,79,437,89
49085,9935,6493,869,3268,1735,621,2463,3149,530,351,3442,762,959,883,838,3075,367
49087,1897,1509,245,898,311,55,672,635,131,71,388,69,128,136,55,334,54
49088,1076,867,92,481,261,33,378,435,34,20,209,46,85,54,24,151,58
49089,764,613,146,261,171,35,186,296,92,39,151,43,54,44,10,114,37
49090,5933,3993,847,1849,953,344,1312,1767,613,301,1940,289,577,662,412,1632,308
49091,7603,5248,1243,2450,1211,344,1871,2197,761,419,2355,544,634,655,522,1930,425
49092,853,609,121,318,152,18,196,284,75,54,244,31,67,102,44,204,40
49093,7117,4957,1200,2164,1244,349,1544,2283,774,356,2160,486,660,584,430,1774,386
49094,1616,1169,225,528,321,95,362,565,130,112,447,67,130,163,87,359,88
49095,761,512,75,248,135,54,104,303,64,41,249,26,72,72,79,190,59
49096,1161,919,152,496,229,42,359,427,80,53,242,41,75,78,48,195,47
49097,3731,2914,427,1485,816,186,1063,1381,279,191,817,117,361,181,158,675,142
49098,2383,1705,352,880,360,113,645,704,207,149,678,99,139,247,193,602,76
49099,2162,1580,281,754,464,81,456,800,248,76,582,99,206,186,91,452,130
49101,1249,899,192,432,220,55,368,403,80,48,350,57,134,99,60,292,58
49102,405,310,38,162,98,12,140,136,16,18,95,29,25,23,18,82,13
49103,4342,3197,599,1547,826,225,1117,1515,285,280,1145,432,233,310,170,912,233
49106,1951,1377,198,704,406,69,500,669,124,84,574,107,180,182,105,512,62
49107,4155,2952,613,1328,785,226,962,1312,391,287,1203,227,417,287,272,1025,178
49111,1288,988,176,452,287,73,326,476,100,86,300,56,112,59,73,258,42
49112,3892,2837,496,1400,776,165,919,1359,357,202,1055,186,394,307,168,841,214
49113,757,560,81,288,173,18,172,271,60,57,197,39,70,59,29,157,40
49115,11,5,0,0,0,5,0,5,0,0,6,0,0,0,6,6,0
49116,128,107,6,22,51,28,28,79,0,0,21,0,8,6,7,21,0
49117,1863,1186,171,478,419,118,328,678,93,87,677,78,241,217,141,573,104
49119,37,21,8,3,5,5,4,13,4,0,16,0,6,0,10,13,3
49120,14114,9782,1935,4397,2709,741,2957,4537,1405,883,4332,737,1347,1157,1091,3694,638
49125,1087,703,99,324,215,65,253,324,71,55,384,59,172,91,62,345,39
49126,615,399,75,158,125,41,124,193,40,42,216,27,51,86,52,195,21
49127,3615,2707,493,1367,685,162,1078,1344,171,114,908,171,304,233,200,814,94
49128,1912,1355,222,633,388,112,412,705,131,107,557,73,153,184,147,461,96
49129,339,228,17,96,102,13,59,126,16,27,111,0,35,48,28,101,10
49130,542,436,60,199,165,12,146,265,13,12,106,13,24,10,59,106,0
49201,14657,10724,2129,5363,2729,503,3811,4960,1338,615,3933,622,1438,1230,643,3275,658
49202,9119,5333,1705,2150,1042,436,1454,2056,1197,626,3786,827,1086,856,1017,3206,580
49203,15135,10218,2553,4523,2200,942,3220,4058,1912,1028,4917,915,1536,1387,1079,4130,787
49220,858,631,146,297,168,20,214,256,111,50,227,62,60,55,50,184,43
49221,14164,9966,2259,4703,2362,642,3423,4345,1378,820,4198,1032,1261,1025,880,3589,609
49224,5415,3705,849,1554,1048,254,1050,1610,681,364,1710,309,467,495,439,1468,242
49227,415,310,59,155,77,19,129,145,18,18,105,13,43,32,17,86,19
49228,2195,1606,306,764,416,120,622,742,144,98,589,90,144,167,188,508,81
49229,1033,839,155,426,209,49,355,386,31,67,194,29,66,41,58,166,28
49230,3815,2767,399,1299,875,194,860,1536,241,130,1048,114,348,365,221,902,146
49232,970,741,119,370,213,39,285,359,63,34,229,32,72,83,42,192,37
49233,607,490,80,254,125,31,133,290,47,20,117,7,34,42,34,101,16
49234,1004,749,125,363,231,30,250,388,62,49,255,13,90,82,70,207,48
49235,773,585,112,276,165,32,222,278,45,40,188,40,57,62,29,151,37
49236,1845,1377,248,735,299,95,535,558,163,121,468,110,133,142,83,382,86
49237,1104,873,146,473,204,50,326,409,93,45,231,49,75,53,54,183,48
49238,615,472,101,205,146,20,201,207,35,29,143,42,37,29,35,109,34
49240,2719,2169,341,1170,549,109,769,1100,164,136,550,105,176,137,132,416,134
49241,865,674,112,332,176,54,248,299,71,56,191,30,52,71,38,169,22
49242,5737,3853,880,1705,1033,235,1363,1739,442,309,1884,449,540,509,386,1565,319
49245,1731,1304,280,645,309,70,459,561,183,101,427,74,130,124,99,358,69
49246,1249,1011,153,491,328,39,372,522,82,35,238,44,84,68,42,193,45
49247,2252,1653,326,763,438,126,626,740,161,126,599,125,174,160,140,507,92
49248,351,270,37,154,61,18,120,125,13,12,81,11,19,32,19,74,7
49249,1361,1076,150,501,354,71,332,637,43,64,285,55,100,98,32,225,60
49250,2182,1643,306,826,405,106,572,757,202,112,539,108,153,155,123,468,71
49251,2242,1719,330,880,426,83,674,758,171,116,523,105,191,131,96,411,112
49252,983,702,143,311,206,42,213,352,99,38,281,62,81,84,54,245,36
49253,1240,888,146,444,264,34,353,422,55,58,352,30,128,94,100,302,50
49254,1297,964,125,532,208,99,300,459,91,114,333,99,111,79,44,273,60
49255,615,477,152,192,100,33,204,179,69,25,138,29,34,44,31,110,28
49256,1548,1166,245,566,288,67,414,526,162,64,382,49,106,100,127,329,53
49259,924,744,157,392,171,24,308,294,117,25,180,30,83,21,46,163,17
49262,558,437,85,186,123,43,153,231,22,31,121,28,30,35,28,105,16
49263,11,11,0,6,5,0,0,6,0,5,0,0,0,0,0,0,0
49264,638,490,112,255,90,33,204,210,61,15,148,24,83,26,15,128,20
49265,1756,1399,189,751,406,53,588,679,83,49,357,32,164,99,62,291,66
49266,1081,830,179,391,217,43,336,379,83,32,251,55,80,63,53,182,69
49267,1465,1142,145,629,316,52,455,500,79,108,323,44,117,105,57,284,39
49268,396,298,39,148,77,34,99,143,37,19,98,13,17,36,32,86,12
49269,2192,1726,338,923,376,89,755,613,246,112,466,106,150,107,103,389,77
49270,2019,1656,292,853,442,69,649,840,96,71,363,42,100,128,93,328,35
49271,852,658,97,350,163,48,230,328,60,40,194,44,66,55,29,167,27
49272,912,636,94,377,111,54,281,295,45,15,276,48,72,90,66,205,71
49274,1361,991,208,440,278,65,397,468,86,40,370,73,96,120,81,319,51
49276,343,276,35,154,65,22,125,116,9,26,67,0,20,31,16,59,8
49277,1295,1089,131,603,298,57,420,544,66,59,206,29,84,81,12,167,39
49279,316,269,46,125,68,30,109,123,10,27,47,5,14,5,23,45,2
49281,210,170,40,75,49,6,73,97,0,0,40,0,21,19,0,27,13
49282,316,220,16,89,89,26,61,130,17,12,96,0,26,37,33,92,4
49283,941,681,82,332,173,94,244,357,36,44,260,40,66,76,78,233,27
49284,1131,821,120,395,270,36,274,404,96,47,310,89,106,86,29,231,79
49285,1800,1418,265,734,342,77,565,618,115,120,382,61,138,111,72,328,54
49286,5461,3986,743,1961,998,284,1534,1777,391,284,1475,390,337,409,339,1295,180
49287,750,604,99,329,160,16,220,311,32,41,146,39,50,36,21,126,20
49288,520,368,83,172,95,18,145,154,41,28,152,19,48,45,40,134,18
49289,34,23,0,15,8,0,10,11,0,2,11,5,0,0,6,6,5
49301,3467,2949,317,1809,751,72,1354,1357,162,76,518,62,198,151,107,420,98
49302,2105,1804,265,1079,401,59,834,761,112,97,301,70,123,57,51,229,72
49303,334,280,56,152,59,13,113,113,28,26,54,9,30,15,0,47,7
49304,1844,1095,167,423,422,83,208,634,152,101,749,66,254,285,144,642,107
49305,1089,778,116,325,284,53,206,417,105,50,311,34,94,104,79,247,64
49306,2816,2230,400,1270,488,72,935,959,231,105,586,60,171,187,168,467,119
49307,6515,3711,919,1687,861,244,1226,1640,586,259,2804,1446,582,452,324,1858,946
49309,737,504,94,172,205,33,144,261,62,37,233,32,81,86,34,211,22
49310,1004,770,145,385,195,45,267,364,96,43,234,41,78,72,43,205,29
49312,46,23,3,6,14,0,5,11,5,2,23,5,6,7,5,17,6
49315,4837,3729,626,1965,972,166,1788,1633,128,180,1108,390,308,228,182,899,209
49316,4848,3893,725,2070,923,175,1818,1698,233,144,955,157,355,295,148,781,174
49318,531,427,63,235,111,18,167,221,28,11,104,21,38,27,18,81,23
49319,4831,3817,970,1913,786,148,1565,1553,494,205,1014,210,457,194,153,879,135
49321,6095,3879,1170,1808,715,186,1353,1560,624,342,2216,1080,631,384,121,1498,718
49322,457,348,57,161,108,22,135,177,19,17,109,26,27,24,32,92,17
49323,2543,2155,567,1177,323,88,1105,790,160,100,388,119,118,77,74,316,72
49325,554,447,96,238,95,18,201,184,39,23,107,23,31,30,23,93,14
49326,1328,1010,199,475,282,54,346,513,95,56,318,58,113,116,31,254,64
49327,2632,2014,436,1043,433,102,874,785,237,118,618,111,218,160,129,506,112
49328,1272,1013,186,551,226,50,425,415,115,58,259,53,95,49,62,203,56
49329,2427,1917,458,965,388,106,749,833,213,122,510,81,164,171,94,447,63
49330,1585,1311,365,607,266,73,577,490,170,74,274,44,115,61,54,213,61
49331,4954,3872,720,2274,773,105,1754,1534,381,203,1082,226,366,322,168,899,183
49332,1241,865,111,321,355,78,174,536,100,55,376,38,98,168,72,339,37
49333,3224,2620,520,1429,533,138,1098,1129,277,116,604,112,224,180,88,492,112
49335,39,29,0,21,0,8,21,0,0,8,10,0,0,4,6,10,0
49336,1369,1053,292,467,240,54,420,447,128,58,316,37,117,114,48,256,60
49337,4682,3450,690,1555,974,231,1158,1665,412,215,1232,149,429,458,196,1049,183
49338,769,532,140,260,105,27,281,155,66,30,237,97,55,76,9,178,59
49339,764,623,105,336,148,34,260,289,45,29,141,39,40,40,22,113,28
49340,1106,830,185,359,234,52,312,371,90,57,276,50,76,84,66,230,46
49341,9911,8142,1470,4837,1556,279,4054,3134,676,278,1769,288,596,596,289,1414,355
49342,716,533,98,204,192,39,134,284,93,22,183,26,62,73,22,144,39
49343,1748,1307,250,691,311,55,534,587,132,54,441,60,184,118,79,363,78
49344,1360,1001,194,458,269,80,338,527,108,28,359,65,140,105,49,279,80
49345,4531,3437,632,1790,804,211,1450,1378,381,228,1094,276,317,264,237,908,186
49346,1806,1429,198,465,635,131,361,934,87,47,377,53,94,127,103,311,66
49347,486,362,76,177,77,32,129,162,41,30,124,22,36,43,23,103,21
49348,4025,3096,896,1514,576,110,1332,1289,389,86,929,206,281,243,199,752,177
49349,3106,2231,436,1058,618,119,721,989,372,149,875,107,300,300,168,711,164
49401,3435,2155,706,955,370,124,944,916,196,99,1280,987,96,143,54,542,738
49402,603,395,51,144,168,32,87,269,15,24,208,33,74,75,26,174,34
49403,805,655,128,343,159,25,278,290,51,36,150,19,61,40,30,124,26
49404,2743,2153,464,1100,456,133,955,875,206,117,590,122,147,159,162,498,92
49405,593,461,67,232,123,39,164,219,37,41,132,24,56,29,23,108,24
49406,334,186,26,76,65,19,52,92,21,21,148,18,58,39,33,113,35
49408,3415,2396,512,1234,531,119,890,1065,293,148,1019,127,352,352,188,822,197
49410,682,470,76,206,161,27,139,263,52,16,212,29,81,60,42,172,40
49411,615,466,54,248,130,34,163,251,24,28,149,14,33,57,45,141,8
49412,4171,3043,557,1456,797,233,1125,1472,306,140,1128,193,310,290,335,1013,115
49415,2064,1635,277,894,362,102,609,776,151,99,429,102,125,142,60,334,95
49417,10809,7833,1535,4097,1778,423,3156,3532,705,440,2976,771,890,716,599,2484,492
49418,9012,6741,1458,3433,1480,370,3015,2805,597,324,2271,825,496,548,402,1876,395
49419,2098,1761,432,945,355,29,851,758,109,43,337,60,151,60,66,295,42
49420,2279,1645,355,740,433,117,606,697,212,130,634,96,174,194,170,524,110
49421,2285,1679,313,837,425,104,591,731,236,121,606,72,193,215,126,507,99
49423,16252,11237,2930,5224,2210,873,4548,4593,1302,794,5015,1529,1384,938,1164,4004,1011
49424,14521,11193,3112,5603,2132,346,5093,4402,1142,556,3328,1123,1133,686,386,2664,664
49425,1299,1003,214,468,280,41,356,481,89,77,296,48,103,87,58,246,50
49426,8741,7468,1507,4097,1461,403,3823,3054,293,298,1273,366,389,189,329,1141,132
49428,8443,6822,968,3779,1700,375,2986,3171,447,218,1621,394,324,406,497,1370,251
49431,6874,4636,850,2136,1267,383,1399,2281,703,253,2238,313,678,570,677,1979,259
49434,38,7,0,0,0,7,0,7,0,0,31,0,0,22,9,31,0
49435,1097,846,135,512,158,41,397,344,64,41,251,45,83,52,71,200,51
49436,663,501,80,190,201,30,149,297,31,24,162,21,64,58,19,132,30
49437,2624,1941,296,932,578,135,610,994,211,126,683,113,236,181,153,578,105
49440,444,141,53,38,12,38,25,60,32,24,303,51,71,70,111,277,26
49441,16897,11130,2302,4763,3002,1063,3563,5097,1511,959,5767,1080,1788,1404,1495,4915,852
49442,15755,10556,2970,4881,1989,716,3426,3502,2387,1241,5199,1196,1581,1435,987,4379,820
49444,7967,5662,1412,2595,1245,410,1406,1806,1599,851,2305,405,782,686,432,2016,289
49445,7345,5649,992,2916,1388,353,2165,2579,564,341,1696,310,462,502,422,1412,284
49446,843,673,121,347,155,50,273,299,74,27,170,33,58,42,37,158,12
49448,1210,934,162,503,237,32,372,414,85,63,276,54,126,54,42,224,52
49449,1189,859,100,329,322,108,237,506,56,60,330,26,87,123,94,294,36
49450,988,740,289,281,151,19,306,210,129,95,248,43,86,79,40,176,72
49451,2038,1629,327,812,394,96,672,708,149,100,409,83,124,97,105,337,72
49452,691,530,132,265,118,15,172,216,101,41,161,47,36,46,32,127,34
49453,1169,702,93,375,187,47,172,366,131,33,467,68,193,127,79,382,85
49454,1731,1277,231,597,343,106,437,592,175,73,454,84,144,127,99,382,72
49455,1839,1376,228,683,358,107,451,628,194,103,463,39,152,156,116,405,58
49456,6886,4762,769,2354,1300,339,1862,2361,375,164,2124,529,664,468,463,1836,288
49457,3517,2727,656,1413,600,58,993,1082,481,171,790,196,338,175,81,613,177
49458,57,40,14,11,14,1,8,26,6,0,17,7,7,1,2,10,7
49459,495,382,76,181,107,18,127,172,59,24,113,23,27,36,27,97,16
49460,2451,1974,457,1017,469,31,805,843,172,154,477,113,163,116,85,354,123
49461,3338,2440,414,1310,616,100,996,1106,232,106,898,123,238,262,275,791,107
49464,7031,5714,1438,2880,1052,344,2866,2238,392,218,1317,279,330,276,432,1196,121
49503,13923,6541,2525,2638,901,477,1806,2148,1673,914,7382,3255,2495,1097,535,5683,1699
49504,15576,9814,2681,4443,1832,858,3279,3527,1710,1298,5762,1331,1787,1343,1301,4670,1092
49505,12755,7961,2487,3384,1505,585,2790,3270,1322,579,4794,1294,1594,975,931,3853,941
49506,12262,8121,1731,4083,1673,634,3181,3125,1154,661,4141,1165,1272,790,914,3353,788
49507,12747,9251,3177,4303,1399,372,3291,2145,2401,1414,3496,984,1244,796,472,2824,672
49508,15278,10413,2529,5238,2138,508,4197,3989,1388,839,4865,1667,1295,1065,838,4057,808
49509,22559,14780,4361,6890,2771,758,5424,5420,2512,1424,7779,2855,2473,1496,955,6050,1729
49512,5371,2645,1017,1131,381,116,964,1111,326,244,2726,1389,901,357,79,2155,571
49525,9761,7039,1162,3839,1626,412,2982,2859,748,450,2722,629,962,778,353,2286,436
49544,11087,7366,1765,3617,1676,308,2943,3185,780,458,3721,1602,964,657,498,2867,854
49546,11841,8468,1210,4480,2072,706,3697,3703,668,400,3373,811,840,695,1027,2951,422
49548,12279,8097,2499,3765,1358,475,2927,2738,1567,865,4182,1174,1274,1013,721,3375,807
49601,7945,5536,994,2634,1547,361,1863,2596,745,332,2409,570,687,636,516,2039,370
49611,110,88,21,33,31,3,32,39,11,6,22,5,3,8,6,18,4
49612,442,310,38,141,103,28,88,181,22,19,132,32,32,48,20,118,14
49613,309,212,20,70,109,13,45,136,21,10,97,17,16,44,20,80,17
49614,1049,756,117,323,249,67,215,408,91,42,293,52,75,87,79,247,46
49615,1665,1169,188,439,429,113,352,666,110,41,496,58,141,192,105,443,53
49616,857,565,91,244,174,56,193,292,37,43,292,16,71,117,88,256,36
49617,1255,900,139,376,288,97,267,501,78,54,355,59,119,114,63,279,76
49618,305,237,45,117,58,17,80,112,27,18,68,16,22,24,6,55,13
49619,402,297,42,122,115,18,77,170,31,19,105,7,47,33,18,84,21
49620,751,573,102,293,142,36,228,252,60,33,178,56,64,31,27,129,49
49621,1084,810,124,415,208,63,331,384,70,25,274,32,97,84,61,228,46
49622,1071,794,102,347,273,72,240,452,67,35,277,52,78,82,65,218,59
49623,474,334,69,160,89,16,122,157,38,17,140,26,54,42,18,123,17
49625,486,356,55,173,103,25,108,179,36,33,130,17,43,41,29,95,35
49626,124,78,22,28,26,2,27,36,11,4,46,5,8,21,12,43,3
49627,109,71,7,18,36,10,15,50,2,4,38,3,13,11,11,31,7
49628,120,77,20,36,14,7,29,26,14,8,43,4,7,22,10,37,6
49629,1041,693,86,282,267,58,171,392,98,32,348,34,89,129,96,319,29
49630,564,382,29,146,154,53,84,239,29,30,182,23,87,43,29,160,22
49631,2422,1746,321,770,545,110,514,883,242,107,676,99,206,237,134,554,122
49632,439,331,52,168,84,27,136,153,27,15,108,13,34,36,25,92,16
49633,1345,998,186,445,308,59,320,511,111,56,347,61,101,134,51,282,65
49634,39,20,2,14,4,0,10,0,0,10,19,4,10,0,5,14,5
49635,1544,1039,137,395,395,112,298,599,93,49,505,71,138,135,161,436,69
49636,265,165,7,65,64,29,56,102,1,6,100,2,26,37,35,97,3
49637,1002,767,150,398,161,58,271,347,107,42,235,62,84,74,15,193,42
49638,341,245,31,97,95,22,58,143,24,20,96,3,48,31,14,76,20
49639,914,692,175,256,225,36,228,355,82,27,222,28,90,52,52,195,27
49640,638,439,66,165,177,31,105,257,41,36,199,13,60,66,60,168,31
49642,291,187,27,68,84,8,43,80,43,21,104,0,21,54,29,83,21
49643,1928,1367,331,650,302,84,478,620,168,101,561,111,291,94,65,433,128
49644,831,542,60,182,252,48,86,383,40,33,289,18,72,152,47,242,47
49645,647,454,72,232,119,31,157,227,44,26,193,41,46,57,49,162,31
49646,3246,2268,492,1037,572,167,750,1061,333,124,978,199,294,297,188,799,179
49648,814,644,65,245,272,62,183,395,46,20,170,6,49,79,36,152,18
49649,1910,1524,491,752,217,64,691,525,205,103,386,87,121,108,70,281,105
49650,965,747,183,379,168,17,324,340,68,15,218,49,90,38,41,169,49
49651,2979,2136,412,904,637,183,652,1104,247,133,843,131,240,276,196,715,128
49653,814,607,71,280,212,44,200,338,39,30,207,32,72,68,35,174,33
49654,276,193,5,62,94,32,35,134,8,16,83,2,22,31,28,80,3
49655,1133,865,173,391,252,49,336,396,85,48,268,59,71,83,55,220,48
49656,624,442,75,201,129,37,140,217,53,32,182,11,39,78,54,168,14
49657,1157,908,176,429,224,79,416,403,54,35,249,41,66,61,81,219,30
49659,2423,1800,398,762,557,83,590,831,236,143,623,90,220,210,103,515,108
49660,5625,3790,539,1792,1104,355,1210,1862,388,330,1835,288,419,640,488,1601,234
49663,2004,1505,286,719,405,95,536,674,180,115,499,99,160,159,81,375,124
49664,775,593,62,318,161,52,218,297,49,29,182,32,73,39,38,149,33
49665,1629,1195,238,548,331,78,411,549,166,69,434,70,123,155,86,378,56
49666,9,5,0,5,0,0,0,5,0,0,4,0,4,0,0,4,0
49667,211,151,32,67,46,6,50,69,15,17,60,7,25,22,6,51,9
49668,1244,878,196,393,224,65,290,394,134,60,366,34,132,135,65,320,46
49670,887,631,58,251,253,69,157,409,41,24,256,20,76,89,71,232,24
49675,466,299,37,99,119,44,64,194,31,10,167,20,38,72,37,150,17
49676,1244,904,134,416,280,74,277,505,84,38,340,45,109,123,63,282,58
49677,2641,1883,331,923,497,132,617,878,261,127,758,165,208,237,148,603,155
49679,435,310,43,133,107,27,80,185,27,18,125,16,33,46,30,106,19
49680,623,485,87,270,104,24,187,203,59,36,138,36,38,37,27,103,35
49682,1510,1162,173,550,359,80,393,567,135,67,348,47,116,102,83,308,40
49683,726,495,96,199,174,26,145,261,57,32,231,39,81,80,31,184,47
49684,13520,9313,1698,4858,2153,604,3476,4104,1083,650,4207,1049,1557,1000,601,3283,924
49686,11972,7833,1300,3868,2025,640,2655,3873,868,437,4139,765,1446,1081,847,3376,763
49688,950,720,130,328,220,42,253,340,77,50,230,49,86,61,34,170,60
49689,672,460,61,202,170,27,108,256,69,27,212,25,70,82,35,178,34
49690,2582,1949,259,1009,556,125,712,1049,127,61,633,123,191,148,171,505,128
49701,366,224,36,97,66,25,65,117,28,14,142,25,46,41,30,120,22
49705,311,261,45,135,69,12,81,122,42,16,50,10,10,25,5,44,6
49706,1816,1323,256,612,394,61,439,635,148,101,493,91,200,114,88,402,91
49707,10072,6687,1064,3086,1996,541,2072,3328,773,514,3385,558,917,1014,896,2919,466
49709,1745,1212,128,440,512,132,251,761,127,73,533,42,136,232,123,459,74
49710,200,139,13,44,64,18,26,94,12,7,61,5,29,21,6,53,8
49712,3223,2220,380,1042,636,162,800,994,288,138,1003,175,325,299,204,869,134
49713,776,579,119,288,145,27,239,263,41,36,197,61,34,71,31,165,32
49715,1092,813,178,348,253,34,251,381,137,44,279,68,103,74,34,223,56
49716,346,253,46,125,60,22,95,126,19,13,93,19,22,21,31,72,21
49718,403,257,31,114,91,21,71,147,23,16,146,16,44,55,31,119,27
49719,728,499,62,195,198,44,113,309,51,26,229,29,52,95,53,206,23
49720,3880,2681,427,1275,744,235,819,1388,350,124,1199,197,341,392,269,1010,189
49721,6129,4279,779,1799,1343,358,1318,2160,557,244,1850,340,507,578,425,1592,258
49722,26,19,0,19,0,0,0,10,4,5,7,3,4,0,0,7,0
49724,425,332,46,176,90,20,112,170,26,24,93,9,30,32,22,87,6
49725,400,244,16,90,117,21,58,151,16,19,156,15,34,75,32,140,16
49726,475,327,24,113,152,38,63,221,24,19,148,19,45,55,29,132,16
49727,2628,1963,380,884,560,139,703,920,209,131,665,115,214,175,161,545,120
49728,120,92,9,52,25,6,31,46,15,0,28,0,12,14,2,24,4
49729,609,459,85,233,116,25,162,235,42,20,150,17,50,46,37,139,11
49730,684,523,98,228,147,50,190,256,42,35,161,24,54,55,28,134,27
49733,784,559,97,234,191,37,153,308,60,38,225,28,61,101,35,194,31
49735,7216,5261,993,2573,1386,309,2031,2379,505,346,1955,347,627,525,456,1633,322
49736,277,175,12,75,55,33,27,126,11,11,102,11,27,39,25,95,7
49738,4079,2918,528,1250,933,207,857,1468,433,160,1161,117,334,443,267,1005,156
49740,2997,2048,263,968,678,139,673,1124,171,80,949,159,324,295,171,809,140
49743,357,251,24,110,79,38,78,146,15,12,106,11,21,38,36,92,14
49744,302,244,47,122,50,25,103,117,16,8,58,7,12,20,19,53,5
49745,107,81,5,45,23,8,19,47,9,6,26,4,7,9,6,26,0
49746,1544,1095,151,455,369,120,319,604,78,94,449,52,106,168,123,377,72
49747,775,562,45,222,240,55,143,347,39,33,213,33,43,93,44,180,33
49748,111,75,12,32,23,8,16,49,7,3,36,2,5,16,13,36,0
49749,1887,1320,208,487,490,135,374,783,109,54,567,47,142,249,129,504,63
49751,768,561,85,220,229,27,166,331,30,34,207,34,66,79,28,167,40
49752,161,98,10,63,16,9,38,42,18,0,63,4,35,17,7,53,10
49753,891,685,98,294,225,68,216,376,38,55,206,26,47,83,50,178,28
49755,814,572,119,241,172,40,195,274,58,45,242,37,88,71,46,204,38
49756,1849,1218,143,399,552,124,274,811,82,51,631,68,151,238,174,577,54
49757,247,139,23,70,36,10,38,73,18,10,108,32,49,14,13,87,21
49759,725,523,77,185,201,60,125,309,58,31,202,11,49,85,57,176,26
49760,295,202,41,75,68,18,54,100,27,21,93,12,40,21,20,70,23
49761,23,7,0,1,6,0,1,6,0,0,16,0,5,5,6,16,0
49762,338,239,26,79,110,24,71,153,10,5,99,8,40,39,12,93,6
49764,48,18,7,4,3,4,0,11,7,0,30,13,12,5,0,30,0
49765,1818,1225,192,540,389,104,338,658,152,77,593,61,126,228,178,519,74
49766,1061,748,109,339,254,46,255,359,60,74,313,43,83,101,86,266,47
49768,232,157,11,55,71,20,20,121,9,7,75,7,29,24,15,68,7
49769,526,396,88,186,92,30,136,167,53,40,130,19,62,24,25,103,27
49770,6182,4073,677,2103,1076,217,1586,1770,461,256,2109,529,674,372,534,1777,332
49774,724,563,88,261,168,46,190,321,26,26,161,13,58,54,36,132,29
49775,38,20,1,9,10,0,9,10,0,1,18,0,10,5,3,13,5
49776,815,564,72,258,178,56,218,284,30,32,251,33,72,63,83,219,32
49777,702,517,40,184,224,69,115,361,25,16,185,24,55,66,40,173,12
49779,2263,1513,175,655,552,131,435,879,117,82,750,91,164,244,251,699,51
49780,845,630,99,321,172,38,253,260,65,52,215,26,71,68,50,195,20
49781,2114,1410,268,665,401,76,448,664,208,90,704,118,252,162,172,600,104
49782,268,155,12,56,68,19,41,97,2,15,113,4,49,48,12,102,11
49783,7715,4824,1073,2286,1181,284,1512,2111,821,380,2891,909,739,678,565,2346,545
49788,826,657,227,370,45,15,289,144,194,30,169,39,71,51,8,124,45
49791,36,15,4,0,7,4,0,7,6,2,21,7,0,4,10,14,7
49792,25,18,5,11,0,2,7,2,3,6,7,0,0,4,3,7,0
49793,74,49,8,19,17,5,10,35,2,2,25,0,11,10,4,21,4
49795,739,526,91,218,173,44,159,284,34,49,213,27,71,71,44,174,39
49796,59,41,8,13,20,0,18,18,3,2,18,11,5,2,0,14,4
49799,832,605,131,268,172,34,198,275,82,50,227,41,78,70,38,194,33
49801,5205,3430,545,1678,847,360,1291,1605,364,170,1775,234,516,538,487,1574,201
49802,2942,1942,392,946,473,131,676,943,272,51,1000,138,240,320,302,887,113
49805,100,59,7,30,22,0,21,35,1,2,41,2,15,12,12,39,2
49806,257,183,21,71,77,14,47,124,8,4,74,9,15,34,16,61,13
49807,1413,1059,150,518,291,100,369,559,74,57,354,50,126,88,90,310,44
49808,80,55,4,30,18,3,16,32,2,5,25,0,11,8,6,21,4
49812,358,239,43,106,65,25,78,131,23,7,119,21,37,48,13,109,10
49813,120,80,0,41,34,5,10,64,2,4,40,2,11,16,11,40,0
49814,603,451,62,220,135,34,137,244,38,32,152,29,53,41,29,114,38
49815,226,143,23,65,46,9,52,70,7,14,83,9,9,39,26,74,9
49816,318,238,39,111,75,13,68,142,15,13,80,7,18,23,32,66,14
49817,226,186,31,77,66,12,64,99,10,13,40,1,18,11,10,37,3
49818,411,311,38,154,94,25,118,165,12,16,100,12,33,29,26,84,16
49820,366,252,30,91,114,17,62,163,13,14,114,15,24,46,29,98,16
49821,600,424,56,188,147,33,149,219,26,30,176,27,56,47,46,156,20
49822,85,55,4,28,21,2,16,32,4,3,30,0,22,2,6,22,8
49825,87,61,9,32,14,6,24,32,5,0,26,11,5,7,3,23,3
49826,13,9,0,6,0,3,4,5,0,0,4,0,4,0,0,2,2
49827,409,272,35,109,101,27,75,161,18,18,137,10,33,56,38,114,23
49829,7691,4855,938,2213,1267,437,1766,2234,547,308,2836,541,790,795,710,2449,387
49831,23,7,0,4,3,0,2,5,0,0,16,4,7,3,2,10,6
49833,85,62,0,26,36,0,9,53,0,0,23,0,23,0,0,23,0
49834,102,72,6,40,20,6,26,34,4,8,30,5,3,13,9,30,0
49835,385,265,16,136,87,26,74,167,20,4,120,13,22,51,34,107,13
49836,279,205,38,65,76,26,64,120,7,14,74,8,16,30,20,63,11
49837,3868,2726,354,1405,765,202,1018,1306,248,154,1142,170,285,392,295,1009,133
49838,162,94,9,24,45,16,16,67,5,6,68,7,25,15,21,60,8
49839,201,133,4,47,58,24,24,91,6,12,68,6,15,23,24,62,6
49840,347,274,36,125,92,21,89,172,7,6,73,4,21,33,15,59,14
49841,2279,1635,370,722,465,78,524,734,268,109,644,141,244,167,92,529,115
49847,460,298,39,134,104,21,95,159,32,12,162,23,50,44,45,141,21
49848,76,53,12,26,13,2,26,17,8,2,23,3,8,4,8,21,2
49849,5133,3502,678,1684,902,238,1181,1607,432,282,1631,333,540,382,376,1383,248
49852,59,45,2,19,21,3,6,32,4,3,14,0,4,4,6,14,0
49853,529,419,28,178,193,20,109,283,13,14,110,17,39,43,11,101,9
49854,2781,1855,310,817,564,164,540,944,242,129,926,143,222,274,287,835,91
49855,12610,7382,1316,3856,1729,481,2499,3441,952,490,5228,2095,1370,903,860,4020,1208
49858,5766,3723,723,1723,949,328,1116,1829,515,263,2043,305,652,632,454,1781,262
49861,244,161,8,68,73,12,40,104,11,6,83,7,26,30,20,74,9
49862,1901,1240,166,583,372,119,387,662,116,75,661,100,207,185,169,579,82
49863,52,35,9,15,9,2,14,12,5,4,17,1,6,3,7,14,3
49864,18,7,0,0,4,3,0,7,0,0,11,0,3,8,0,11,0
49866,3177,2146,344,1090,518,194,755,1046,195,150,1031,216,265,264,286,899,132
49868,1970,1359,285,587,353,134,440,669,187,63,611,116,175,172,148,548,63
49870,1448,954,195,413,258,88,345,425,125,59,494,71,136,128,159,444,50
49871,180,103,16,52,19,16,34,45,14,10,77,7,28,18,24,73,4
49872,32,15,0,9,6,0,2,13,0,0,17,2,7,6,2,17,0
49873,41,27,2,14,9,2,7,20,0,0,14,2,5,3,4,13,1
49874,361,239,43,125,59,12,72,124,32,11,122,19,42,26,35,102,20
49876,453,374,38,220,89,27,128,188,42,16,79,16,8,29,26,65,14
49877,22,14,0,4,8,2,2,10,0,2,8,0,0,6,2,4,4
49878,1657,1192,134,549,422,87,354,701,76,61,465,58,140,163,104,403,62
49879,456,319,21,128,130,40,76,186,28,29,137,11,43,48,35,124,13
49880,489,349,42,168,110,29,115,177,29,28,140,19,42,46,33,124,16
49881,145,108,14,62,30,2,45,47,4,12,37,0,11,15,11,31,6
49883,58,39,7,14,13,5,9,23,2,5,19,0,4,9,6,15,4
49884,226,197,37,74,80,6,76,101,11,9,29,5,17,5,2,15,14
49885,826,607,83,337,153,34,226,322,28,31,219,39,79,73,28,176,43
49886,211,151,28,49,63,11,47,85,9,10,60,17,7,15,21,47,13
49887,951,602,93,256,199,54,174,353,51,24,349,35,80,109,125,305,44
49891,419,274,36,127,77,34,83,142,29,20,145,11,46,57,31,130,15
49892,797,555,73,314,124,44,225,260,46,24,242,42,63,66,71,209,33
49893,696,488,101,242,118,27,192,237,42,17,208,28,89,57,34,181,27
49894,303,225,27,82,76,40,52,119,23,31,78,9,39,17,13,71,7
49895,259,204,21,98,69,16,65,111,16,12,55,7,19,15,14,35,20
49896,555,443,107,198,105,33,156,177,61,49,112,32,32,20,28,93,19
49901,204,117,8,62,40,7,31,61,16,9,87,9,21,30,27,80,7
49902,92,45,14,13,14,4,20,14,3,8,47,0,5,22,20,45,2
49903,70,33,3,16,9,5,11,20,0,2,37,14,4,10,9,30,7
49905,527,375,80,219,61,15,181,114,44,36,152,24,46,36,46,123,29
49908,1015,670,145,318,157,50,225,255,123,67,345,72,75,111,87,304,41
49910,215,143,6,69,51,17,39,83,5,16,72,5,25,31,11,58,14
49911,1351,808,120,356,247,85,253,403,92,60,543,65,131,166,181,505,38
49912,474,309,37,125,105,42,76,184,36,13,165,18,42,61,44,140,25
49913,3345,2010,316,895,579,220,621,954,252,183,1335,202,326,398,409,1184,151
49915,420,258,43,103,62,50,65,122,43,28,162,15,38,47,62,148,14
49916,1039,754,94,344,248,68,257,393,54,50,285,60,115,58,52,232,53
49917,85,56,10,16,24,6,17,33,6,0,29,5,6,10,8,28,1
49918,33,27,2,10,10,5,2,21,2,2,6,3,0,3,0,3,3
49919,89,61,1,32,20,8,18,37,3,3,28,7,4,15,2,26,2
49920,1968,1260,135,542,431,152,319,712,125,104,708,45,207,214,242,641,67
49921,167,111,32,49,30,0,37,37,18,19,56,13,16,15,12,48,8
49922,490,353,68,139,118,28,105,199,35,14,137,20,56,30,31,117,20
49925,299,183,22,84,67,10,60,92,17,14,116,19,34,41,22,103,13
49927,200,134,22,40,49,23,41,71,7,15,66,2,14,24,26,63,3
49929,62,45,8,16,17,4,9,31,0,5,17,0,7,8,2,11,6
49930,2482,1404,313,597,335,159,494,645,147,118,1078,339,318,165,256,889,189
49931,2911,1436,351,676,302,107,563,582,204,87,1475,824,177,203,271,938,537
49934,360,243,36,125,66,16,81,97,33,32,117,14,37,30,36,94,23
49935,2483,1603,203,674,509,217,431,886,181,105,880,95,181,310,294,812,68
49938,3981,2423,385,1065,659,314,717,1196,309,201,1558,290,328,423,517,1390,168
49942,136,102,17,34,39,12,27,63,12,0,34,12,0,8,14,29,5
49945,1122,731,125,327,221,58,225,371,92,43,391,49,91,123,128,363,28
49946,1718,1172,211,538,321,102,338,581,156,97,546,81,142,167,156,475,71
49947,302,223,22,76,98,27,71,127,7,18,79,4,34,26,15,71,8
49948,324,200,17,111,58,14,72,108,13,7,124,11,41,24,48,105,19
49950,570,362,34,148,141,39,90,217,34,21,208,18,51,84,55,190,18
49952,27,25,1,11,10,3,6,13,1,5,2,2,0,0,0,2,0
49953,1428,915,106,396,335,78,257,511,98,49,513,58,159,155,141,468,45
49955,143,109,19,43,39,8,40,42,7,20,34,6,7,10,11,32,2
49958,573,319,49,152,83,35,137,147,13,22,254,18,87,64,85,230,24
49959,180,108,26,40,32,10,22,50,18,18,72,0,18,25,29,72,0
49960,106,67,16,20,27,4,22,30,4,11,39,5,11,7,16,34,5
49961,65,42,7,13,11,11,9,23,3,7,23,1,4,13,5,23,0
49962,131,58,2,15,35,6,11,35,3,9,73,4,31,19,19,64,9
49963,343,170,40,59,47,24,39,91,29,11,173,33,56,39,45,153,20
49964,478,279,55,112,77,35,64,131,60,24,199,13,49,47,90,183,16
49965,187,124,7,46,67,4,24,75,11,14,63,10,21,21,11,56,7
49967,221,134,13,55,49,17,28,76,10,20,87,5,18,28,36,78,9
49968,1076,671,87,303,193,88,181,396,56,38,405,48,57,143,157,363,42
49969,558,385,36,139,164,46,78,224,52,31,173,22,48,75,28,152,21
49970,143,108,10,36,43,19,25,79,2,2,35,0,5,12,18,33,2
49971,287,191,18,70,86,17,39,123,20,9,96,7,24,38,27,87,9
50001,258,198,34,115,49,0,91,89,16,2,60,25,11,17,7,43,17
50002,552,338,56,147,91,44,115,191,20,12,214,38,45,46,85,187,27
50003,2226,1620,242,898,403,77,701,680,126,113,606,89,204,152,161,525,81
50005,322,263,71,99,81,12,94,134,21,14,59,10,20,14,15,47,12
50006,765,533,95,260,141,37,221,251,43,18,232,34,49,75,74,215,17
50007,141,137,18,72,42,5,66,56,12,3,4,0,2,0,2,4,0
50008,366,268,62,127,60,19,109,108,36,15,98,10,15,28,45,95,3
50009,4461,3322,907,1649,638,128,1467,1255,427,173,1139,304,427,328,80,888,251
50010,10734,6144,1841,2592,1294,417,2282,2911,523,428,4590,2270,1085,776,459,3101,1489
50014,8845,4020,1017,1942,855,206,1517,1909,280,314,4825,3732,588,295,210,2322,2503
50020,626,420,72,187,124,37,134,223,46,17,206,20,58,58,70,186,20
50021,11713,8522,2171,4312,1753,286,3770,3568,829,355,3191,1469,869,426,427,2405,786
50022,3676,2461,394,1159,651,257,814,1207,276,164,1215,206,266,328,415,1109,106
50025,1534,1057,170,411,343,133,373,550,93,41,477,62,87,159,169,448,29
50026,265,182,33,93,46,10,61,97,11,13,83,4,20,30,29,79,4
50027,149,109,24,42,35,8,32,57,13,7,40,7,6,16,11,33,7
50028,625,440,103,192,109,36,164,202,47,27,185,27,58,42,58,155,30
50029,295,193,27,95,58,13,76,82,19,16,102,8,16,33,45,91,11
50032,188,126,14,65,28,19,33,58,17,18,62,0,33,22,7,62,0
50033,21,10,4,2,4,0,3,5,0,2,11,0,11,0,0,6,5
50034,181,157,22,71,45,19,64,77,3,13,24,2,9,8,5,24,0
50035,1075,867,179,473,184,31,401,369,62,35,208,45,75,43,45,177,31
50036,6672,4478,836,2122,1185,335,1568,2135,516,259,2194,515,598,584,497,1893,301
50038,151,99,30,40,14,15,13,53,27,6,52,26,15,7,4,38,14
50039,157,98,5,59,29,5,40,41,7,10,59,6,24,14,15,49,10
50040,98,66,6,25,28,7,17,41,6,2,32,1,12,10,9,29,3
50041,50,42,12,18,12,0,19,17,6,0,8,0,4,4,0,4,4
50042,148,114,16,42,39,17,37,66,7,4,34,7,12,8,7,28,6
50044,447,312,72,147,75,18,118,132,29,33,135,36,20,50,29,114,21
50046,508,366,85,171,80,30,148,159,37,22,142,44,44,46,8,103,39
50047,1905,1429,322,642,386,79,539,662,127,101,476,80,194,80,122,417,59
50048,403,299,41,142,95,21,110,147,26,16,104,23,21,22,38,87,17
50049,2781,1849,309,792,572,176,602,956,193,98,932,177,212,249,294,836,96
50050,349,252,37,89,104,22,73,143,22,14,97,6,16,34,41,95,2
50051,132,84,6,35,29,14,19,45,10,10,48,21,24,0,3,32,16
50052,76,48,10,16,17,5,15,29,4,0,28,0,5,4,19,28,0
50054,1379,1002,226,466,254,56,394,453,123,32,377,71,92,136,78,328,49
50055,373,267,40,110,94,23,72,166,20,9,106,13,41,18,34,93,13
50056,575,413,78,225,80,30,182,180,33,18,162,43,46,26,47,132,30
50057,80,64,13,22,15,14,26,27,5,6,16,0,0,16,0,14,2
50058,824,563,94,230,171,68,200,281,50,32,261,39,68,66,88,241,20
50059,8,8,0,8,0,0,0,0,8,0,0,0,0,0,0,0,0
50060,1130,761,112,312,243,94,192,450,83,36,369,25,87,97,160,349,20
50061,427,358,37,205,102,14,139,177,20,22,69,24,17,19,9,50,19
50062,655,465,92,211,131,31,156,229,57,23,190,21,45,59,65,175,15
50063,900,714,76,415,163,60,285,346,50,33,186,36,71,39,40,156,30
50064,49,36,8,17,10,1,12,10,4,10,13,4,5,0,4,12,1
50065,233,169,32,69,58,10,54,80,32,3,64,7,15,28,14,60,4
50066,130,76,18,26,24,8,30,40,1,5,54,28,10,8,8,54,0
50067,131,81,21,44,14,2,32,31,18,0,50,11,10,24,5,44,6
50068,132,94,8,39,43,4,31,51,5,7,38,12,11,4,11,31,7
50069,339,272,89,126,54,3,130,111,19,12,67,15,20,27,5,48,19
50070,619,440,76,193,137,34,162,227,22,29,179,16,63,49,51,156,23
50071,528,335,45,145,115,30,96,207,22,10,193,39,36,43,75,183,10
50072,934,665,158,321,130,56,294,301,43,27,269,57,80,56,76,226,43
50073,315,215,45,86,59,25,52,125,14,24,100,27,39,14,20,87,13
50074,210,156,15,57,72,12,18,132,6,0,54,1,12,39,2,54,0
50075,331,227,54,101,44,28,86,100,30,11,104,25,28,20,31,90,14
50076,630,404,37,192,120,55,148,201,37,18,226,31,36,68,91,209,17
50078,52,32,4,12,14,2,4,19,4,5,20,2,14,2,2,20,0
50101,24,18,0,12,6,0,7,11,0,0,6,0,0,6,0,6,0
50102,47,37,10,11,8,8,8,25,0,4,10,0,5,5,0,10,0
50103,202,136,10,82,36,8,52,66,13,5,66,5,23,23,15,63,3
50104,88,59,21,27,10,1,28,25,2,4,29,2,7,12,8,27,2
50105,368,299,82,154,50,13,139,142,15,3,69,30,13,15,11,47,22
50106,458,315,59,133,88,35,135,159,19,2,143,16,56,31,40,130,13
50107,485,342,68,142,87,45,116,153,39,34,143,18,35,52,38,130,13
50108,228,150,29,50,52,19,51,83,14,2,78,4,14,32,28,73,5
50109,677,518,58,314,105,41,206,262,29,21,159,31,52,24,52,150,9
50110,34,26,1,12,9,4,5,17,0,4,8,0,1,3,4,8,0
50111,2105,1625,533,817,217,58,867,494,173,91,480,101,175,115,89,401,79
50112,4363,2754,506,1313,650,285,976,1274,330,174,1609,366,407,425,411,1361,248
50115,1137,808,142,365,209,92,237,435,85,51,329,50,55,68,156,304,25
50116,80,59,20,16,17,6,24,23,0,12,21,11,5,5,0,18,3
50117,110,94,4,58,29,3,35,50,0,9,16,0,9,0,7,16,0
50118,341,273,71,114,86,2,105,122,23,23,68,11,19,28,10,59,9
50119,169,135,21,72,31,11,58,60,14,3,34,2,9,20,3,27,7
50120,119,96,32,40,21,3,52,28,9,7,23,7,10,1,5,23,0
50122,594,433,82,192,114,45,165,224,39,5,161,31,37,37,56,144,17
50123,402,261,47,103,80,31,98,142,13,8,141,21,30,42,48,121,20
50124,1077,764,167,438,122,37,321,330,66,47,313,122,80,54,57,234,79
50125,6282,4601,932,2317,1018,334,1762,2084,514,241,1681,361,470,443,407,1407,274
50126,2871,1821,336,806,511,168,609,935,180,97,1050,262,187,297,304,910,140
50128,159,99,22,32,38,7,32,56,7,4,60,22,10,12,16,38,22
50129,2332,1575,209,727,445,194,467,820,209,79,757,99,153,186,319,706,51
50130,663,493,79,221,147,46,177,257,41,18,170,28,46,48,48,152,18
50131,3365,2455,452,1451,464,88,1135,1040,191,89,910,268,287,169,186,760,150
50132,176,136,24,68,36,8,52,63,10,11,40,13,6,17,4,40,0
50133,300,186,19,100,51,16,61,87,33,5,114,14,4,50,46,98,16
50134,243,200,60,92,38,10,89,75,15,21,43,18,13,12,0,36,7
50135,682,512,90,265,118,39,194,227,59,32,170,10,51,53,56,150,20
50136,235,160,29,76,34,21,59,77,17,7,75,15,11,20,29,60,15
50137,24,21,9,0,12,0,9,12,0,0,3,0,0,3,0,0,3
50138,4692,3201,790,1414,760,237,1085,1547,403,166,1491,212,445,441,393,1319,172
50139,464,354,64,166,88,36,119,198,25,12,110,20,32,23,35,101,9
50140,1043,606,132,237,195,42,214,307,46,39,437,165,83,67,122,346,91
50141,257,195,20,98,61,16,75,93,12,15,62,13,31,4,14,47,15
50142,356,274,67,122,57,28,95,128,43,8,82,11,25,32,14,73,9
50143,245,210,36,100,65,9,80,106,19,5,35,18,2,4,11,22,13
50144,1171,801,166,364,207,64,283,403,80,35,370,45,80,108,137,347,23
50145,11,0,0,0,0,0,0,0,0,0,11,0,5,6,0,11,0
50146,199,156,20,86,36,14,55,80,14,7,43,6,23,14,0,37,6
50147,200,124,20,48,37,19,45,72,2,5,76,24,11,15,26,58,18
50148,165,119,15,59,30,15,35,62,14,8,46,6,6,25,9,36,10
50149,391,276,60,120,75,21,99,140,27,10,115,15,34,39,27,96,19
50150,411,311,73,123,82,33,100,159,46,6,100,12,42,22,24,88,12
50151,283,215,40,91,70,14,80,121,10,4,68,16,16,22,14,67,1
50152,7,7,2,5,0,0,2,3,2,0,0,0,0,0,0,0,0
50153,267,207,38,108,50,11,98,101,6,2,60,11,16,8,25,55,5
50154,180,146,15,76,34,21,62,69,11,4,34,2,6,16,10,34,0
50155,117,86,22,26,25,13,40,40,2,4,31,7,5,9,10,21,10
50156,1587,1195,244,554,284,113,452,598,90,55,392,84,115,103,90,334,58
50157,323,239,44,118,65,12,87,129,9,14,84,15,44,13,12,75,9
50158,11790,7928,1690,3592,2007,639,2627,3633,1089,579,3862,791,1110,1057,904,3298,564
50160,131,93,21,41,22,9,37,38,16,2,38,9,12,12,5,33,5
50161,776,599,125,280,147,47,227,284,50,38,177,25,41,58,53,153,24
50162,462,342,79,178,63,22,125,161,39,17,120,26,39,27,28,99,21
50164,280,217,36,96,75,10,66,115,20,16,63,10,14,13,26,56,7
50165,20,9,7,2,0,0,9,0,0,0,11,1,2,6,2,11,0
50166,528,400,90,195,90,25,166,187,41,6,128,21,24,32,51,111,17
50167,326,247,56,101,90,0,90,132,14,11,79,15,23,25,16,61,18
50168,289,208,26,109,66,7,62,110,26,10,81,9,33,12,27,62,19
50169,993,712,168,336,190,18,326,291,78,17,281,58,88,69,66,245,36
50170,1056,775,148,358,212,57,277,398,66,34,281,65,86,77,53,241,40
50171,1161,837,106,390,270,71,277,469,62,29,324,71,63,114,76,286,38
50173,287,213,30,83,77,23,47,130,8,28,74,20,16,23,15,65,9
50174,545,414,83,167,131,33,139,213,55,7,131,16,40,41,34,127,4
50201,3191,2151,455,1093,467,136,811,932,283,125,1040,251,340,261,188,831,209
50206,230,163,26,69,49,19,46,111,6,0,67,17,25,13,12,53,14
50207,964,729,159,347,151,72,305,328,71,25,235,56,41,70,68,218,17
50208,8344,5575,1105,2474,1513,483,1826,2785,633,331,2769,605,782,747,635,2413,356
50210,600,446,64,161,203,18,126,286,22,12,154,27,24,33,70,141,13
50211,3108,2551,545,1502,428,76,1154,960,327,110,557,113,247,124,73,476,81
50212,1296,927,174,438,242,73,362,437,82,46,369,54,93,101,121,336,33
50213,2667,1826,394,841,426,165,610,888,223,105,841,112,235,243,251,730,111
50214,319,236,46,120,57,13,99,113,17,7,83,31,22,10,20,67,16
50216,1142,817,113,353,262,89,219,515,59,24,325,38,58,124,105,284,41
50217,256,181,20,87,60,14,64,94,14,9,75,10,15,16,34,69,6
50218,62,36,4,18,14,0,8,22,4,2,26,5,8,10,3,21,5
50219,4462,3273,641,1559,771,302,1406,1629,165,73,1189,380,186,284,339,1071,118
50220,3273,2314,482,1151,477,204,757,1064,347,146,959,157,214,283,305,809,150
50222,180,143,14,76,32,21,58,64,6,15,37,9,20,0,8,35,2
50223,163,109,17,42,46,4,37,61,9,2,54,7,11,16,20,49,5
50225,1033,754,145,377,160,72,327,322,73,32,279,56,56,83,84,243,36
50226,1191,924,230,504,167,23,455,353,73,43,267,65,114,67,21,203,64
50227,8,4,1,2,0,1,2,2,0,0,4,0,0,0,4,4,0
50228,815,599,137,271,133,58,218,331,34,16,216,24,44,71,77,194,22
50229,296,248,26,147,69,6,122,106,6,14,48,5,19,15,9,43,5
50230,450,344,53,177,71,43,138,168,23,15,106,25,14,31,36,95,11
50231,71,43,12,14,13,4,7,28,3,5,28,7,3,16,2,28,0
50232,187,146,30,70,36,10,47,78,16,5,41,4,11,17,9,37,4
50233,578,406,61,196,115,34,123,200,46,37,172,34,43,62,33,142,30
50234,192,113,24,54,26,9,49,47,13,4,79,15,33,21,10,65,14
50235,204,159,34,69,47,9,57,77,20,5,45,9,8,13,15,41,4
50236,600,459,96,233,90,40,219,197,31,12,141,23,33,63,22,127,14
50237,883,759,111,455,141,52,321,361,51,26,124,11,35,38,40,96,28
50238,509,356,50,184,86,36,119,187,39,11,153,34,31,45,43,125,28
50239,110,88,2,58,23,5,34,46,7,1,22,0,9,6,7,22,0
50240,790,614,100,321,168,25,213,335,47,19,176,40,56,38,42,135,41
50241,3,0,0,0,0,0,0,0,0,0,3,0,0,0,3,3,0
50242,194,135,26,47,47,15,54,68,8,5,59,4,24,6,25,54,5
50243,92,80,17,40,18,5,34,37,7,2,12,2,4,2,4,10,2
50244,667,470,90,238,99,43,206,216,29,19,197,38,48,57,54,182,15
50246,304,234,25,118,52,39,78,136,14,6,70,8,12,27,23,57,13
50247,870,626,111,315,155,45,230,324,49,23,244,36,49,72,87,221,23
50248,1694,1117,216,538,229,134,515,457,99,46,577,110,161,111,195,528,49
50249,527,344,55,162,94,33,138,169,18,19,183,31,66,40,46,160,23
50250,950,663,124,291,199,49,212,313,80,58,287,53,62,68,104,255,32
50251,512,418,66,178,129,45,180,209,14,15,94,16,13,20,45,89,5
50252,120,101,32,35,28,6,53,39,6,3,19,3,4,6,6,19,0
50254,170,132,13,73,46,0,54,56,20,2,38,4,18,6,10,33,5
50256,190,151,48,45,38,20,36,93,12,10,39,15,4,4,16,39,0
50257,326,266,67,128,54,17,103,142,12,9,60,2,22,17,19,50,10
50258,370,263,56,93,82,32,92,135,20,16,107,10,28,31,38,87,20
50261,596,475,71,273,97,34,192,203,65,15,121,28,42,37,14,82,39
50262,196,143,38,67,23,15,43,90,5,5,53,13,9,29,2,43,10
50263,2362,1849,425,1002,367,55,883,815,120,31,513,88,159,151,115,450,63
50264,177,133,11,64,50,8,33,84,14,2,44,4,21,11,8,41,3
50265,12737,8004,2128,3782,1688,406,3145,3570,804,485,4733,1876,1514,792,551,3625,1108
50266,7302,4137,1264,2021,732,120,1823,1710,437,167,3165,1515,870,521,259,2455,710
50268,458,296,51,119,87,39,86,150,40,20,162,17,34,53,58,153,9
50269,55,39,8,21,8,2,16,17,6,0,16,5,4,5,2,16,0
50271,308,231,52,92,68,19,65,132,14,20,77,19,9,27,22,70,7
50272,84,61,9,27,10,15,15,26,10,10,23,8,0,7,8,20,3
50273,2825,2052,446,962,495,149,724,990,233,105,773,93,150,191,339,714,59
50274,203,137,23,77,25,12,63,58,9,7,66,9,22,21,14,59,7
50275,216,178,38,100,35,5,76,73,16,13,38,0,10,19,9,27,11
50276,937,643,104,353,160,26,219,297,87,40,294,52,113,85,44,250,44
50277,206,156,19,73,54,10,53,82,18,3,50,3,15,19,13,49,1
50278,330,248,61,110,55,22,101,126,15,6,82,18,33,19,12,73,9
50309,2196,509,193,157,110,49,119,165,148,77,1687,276,500,501,410,1566,121
50310,13350,8117,2152,3603,1682,680,3007,3633,850,627,5233,1439,1897,1077,820,4194,1039
50311,7548,3972,1200,1848,632,292,1421,1618,678,255,3576,1512,1255,470,339,2700,876
50312,7744,3819,708,1889,894,328,1377,1857,354,231,3925,1147,1207,697,874,3374,551
50313,6733,4417,1062,1924,1121,310,1449,1811,632,525,2316,428,847,661,380,1884,432
50314,4466,2607,948,946,562,151,768,484,874,481,1859,544,627,482,206,1538,321
50315,14477,9381,2648,4155,1883,695,3041,3886,1489,965,5096,1380,1486,1479,751,4152,944
50316,6104,3948,1255,1849,630,214,1278,1303,800,567,2156,395,763,530,468,1759,397
50317,15811,11189,2668,5012,2825,684,3442,5023,1512,1212,4622,880,1536,1328,878,3747,875
50320,5821,4178,1456,1826,774,122,1669,1463,708,338,1643,494,539,494,116,1244,399
50321,2968,1912,373,986,449,104,654,948,159,151,1056,491,219,254,92,775,281
50322,13357,9200,1880,4687,2152,481,3768,4203,669,560,4157,1195,1358,1022,582,3434,723
50323,284,255,35,211,9,0,165,90,0,0,29,21,8,0,0,13,16
50325,4840,3737,798,2097,742,100,1872,1548,198,119,1103,350,454,252,47,868,235
50401,13172,8126,1598,3872,1928,728,2692,3818,1064,552,5046,1115,1381,1338,1212,4285,761
50420,173,113,17,58,21,17,45,54,9,5,60,4,16,19,21,56,4
50421,1406,909,116,429,260,104,306,500,77,26,497,63,119,132,183,459,38
50423,1305,878,152,346,275,105,291,467,81,39,427,50,115,134,128,398,29
50424,691,497,59,222,155,61,150,298,25,24,194,14,34,61,85,182,12
50426,56,30,9,11,5,5,13,14,3,0,26,3,4,13,6,21,5
50428,4181,2810,394,1300,828,288,870,1460,328,152,1371,257,448,347,319,1226,145
50430,240,174,22,95,39,18,69,80,15,10,66,4,13,24,25,62,4
50431,99,65,19,30,12,4,29,23,10,3,34,4,10,13,7,23,11
50432,77,43,8,19,10,6,13,17,8,5,34,10,8,12,4,25,9
50433,137,95,6,67,22,0,48,36,8,3,42,0,18,12,12,41,1
50434,165,127,19,55,34,19,44,74,9,0,38,7,7,9,15,33,5
50435,281,213,38,97,69,9,73,117,9,14,68,10,27,18,13,60,8
50436,2339,1614,249,854,391,120,655,756,152,51,725,149,205,198,173,640,85
50438,1605,1173,184,614,290,85,463,586,90,34,432,70,93,101,168,402,30
50439,146,104,4,68,32,0,30,58,8,8,42,6,15,10,11,37,5
50440,232,170,22,84,58,6,73,67,27,3,62,15,14,11,22,57,5
50441,2369,1589,295,683,460,151,451,868,193,77,780,170,182,172,256,707,73
50444,196,139,21,67,36,15,52,76,2,9,57,5,22,15,15,51,6
50446,193,146,19,73,42,12,34,83,21,8,47,14,25,6,2,44,3
50447,499,345,67,154,86,38,129,172,40,4,154,19,33,49,53,128,26
50448,301,229,40,126,50,13,83,114,9,23,72,13,12,26,21,59,13
50449,354,279,85,101,47,46,105,121,27,26,75,8,17,9,41,62,13
50450,1301,846,129,418,224,75,292,440,81,33,455,70,110,121,154,420,35
50451,265,180,17,108,35,20,84,85,8,3,85,4,24,14,43,82,3
50452,341,257,34,110,74,39,99,128,14,16,84,9,18,19,38,82,2
50453,229,171,20,70,65,16,58,98,13,2,58,14,19,9,16,46,12
50454,54,45,0,20,15,10,5,25,5,10,9,0,0,9,0,9,0
50455,188,150,39,67,44,0,56,64,13,17,38,9,2,19,8,34,4
50456,747,492,115,220,111,46,185,238,45,24,255,29,78,62,86,221,34
50457,192,129,18,59,41,11,43,73,7,6,63,5,15,14,29,55,8
50458,821,586,118,262,170,36,205,306,60,15,235,44,59,66,66,202,33
50459,1324,859,116,380,278,85,273,443,80,63,465,88,108,100,169,410,55
50460,133,113,22,56,15,20,40,66,2,5,20,8,8,4,0,12,8
50461,2302,1580,217,732,461,170,537,818,149,76,722,103,131,217,271,642,80
50464,292,200,31,80,67,22,70,115,5,10,92,4,25,30,33,87,5
50465,125,59,17,18,18,6,24,27,4,4,66,14,9,18,25,56,10
50466,702,495,72,231,143,49,192,240,35,28,207,38,18,75,76,193,14
50468,691,489,107,218,137,27,201,234,50,4,202,24,70,37,71,183,19
50469,594,453,70,231,121,31,190,205,29,29,141,14,30,41,56,130,11
50470,126,89,15,43,15,16,29,46,4,10,37,4,0,16,17,35,2
50471,305,217,39,107,50,21,81,104,26,6,88,9,36,20,23,64,24
50472,855,612,86,312,159,55,258,279,43,32,243,36,39,44,124,232,11
50473,158,129,28,49,38,14,49,68,6,6,29,3,7,12,7,27,2
50475,603,448,71,201,120,56,164,246,22,16,155,7,25,53,70,144,11
50476,338,218,18,91,67,42,75,133,5,5,120,23,26,45,26,113,7
50477,127,96,19,45,30,2,52,37,7,0,31,4,4,15,8,24,7
50478,409,268,51,98,76,43,74,143,30,21,141,22,40,36,43,123,18
50479,302,206,29,83,74,20,67,120,8,11,96,25,13,23,35,87,9
50480,436,293,44,121,90,38,113,153,17,10,143,18,23,37,65,123,20
50482,349,260,38,127,73,22,120,108,12,20,89,15,18,28,28,83,6
50483,358,240,39,99,78,24,82,136,17,5,118,13,42,34,29,106,12
50484,199,137,17,68,47,5,48,82,7,0,62,6,7,21,28,59,3
50501,12031,7576,1612,3337,2014,613,2475,3487,1096,518,4455,1036,1208,1125,1086,3842,613
50510,476,359,59,200,70,30,147,173,30,9,117,26,28,14,49,112,5
50511,3070,2112,342,978,590,202,813,1026,168,105,958,123,237,310,288,866,92
50514,664,454,68,214,125,47,157,250,34,13,210,35,52,66,57,190,20
50515,155,108,17,42,45,4,38,66,4,0,47,6,16,16,9,40,7
50516,311,231,50,123,44,14,108,93,27,3,80,9,26,28,17,73,7
50517,500,333,60,150,80,43,137,155,27,14,167,21,35,49,62,158,9
50518,177,127,23,58,30,16,66,37,14,10,50,9,21,14,6,41,9
50519,283,189,26,63,72,28,45,120,10,14,94,18,21,25,30,85,9
50520,90,61,7,28,16,10,20,32,6,3,29,6,15,2,6,25,4
50521,43,24,0,10,14,0,3,18,3,0,19,0,4,8,7,19,0
50522,364,261,45,101,71,44,73,166,13,9,103,9,38,25,31,96,7
50523,272,213,25,98,63,27,59,118,27,9,59,13,14,10,22,52,7
50524,183,140,15,81,40,4,62,70,6,2,43,3,25,6,9,31,12
50525,1628,1085,211,475,282,117,412,555,89,29,543,91,109,121,222,488,55
50527,113,90,4,45,31,10,36,40,7,7,23,6,9,0,8,23,0
50528,192,157,15,77,53,12,64,88,2,3,35,13,7,9,6,35,0
50529,335,246,78,98,59,11,107,89,37,13,89,14,26,27,22,76,13
50530,502,346,74,155,86,31,137,142,51,16,156,21,47,42,46,144,12
50531,115,79,10,35,26,8,23,49,7,0,36,3,6,23,4,32,4
50532,421,294,44,122,110,18,104,152,19,19,127,24,30,25,48,112,15
50533,1736,1190,225,521,331,113,423,589,121,57,546,87,117,179,163,473,73
50535,390,279,52,125,69,33,98,148,27,6,111,31,20,22,38,94,17
50536,1909,1179,185,524,348,122,386,612,112,69,730,253,134,160,183,622,108
50538,254,183,27,86,47,23,58,95,13,17,71,4,10,24,33,62,9
50539,281,191,25,96,48,22,86,92,7,6,90,7,6,26,51,90,0
50540,514,355,38,148,114,55,115,183,27,30,159,11,29,43,76,153,6
50541,405,288,41,133,87,27,102,145,33,8,117,19,34,26,38,112,5
50542,440,294,43,131,77,43,98,157,27,12,146,31,27,44,44,129,17
50543,592,412,75,202,101,34,168,189,40,15,180,18,29,62,71,168,12
50544,259,152,12,71,53,16,47,94,4,7,107,11,33,26,37,91,16
50545,112,101,21,39,24,17,52,34,13,2,11,3,1,6,1,8,3
50546,224,172,11,88,63,10,89,71,10,2,52,2,24,9,17,49,3
50548,2488,1658,195,758,505,200,574,889,116,79,830,121,206,246,257,790,40
50551,61,36,3,16,17,0,11,23,0,2,25,8,7,6,4,21,4
50552,42,23,3,7,7,6,0,21,0,2,19,6,6,4,3,13,6
50554,848,557,84,265,137,71,205,277,56,19,291,41,72,65,113,271,20
50556,145,101,20,23,41,17,30,63,2,6,44,4,14,12,14,44,0
50557,325,206,32,90,57,27,64,119,14,9,119,9,49,36,25,96,23
50558,277,186,31,71,79,5,60,89,21,16,91,10,20,29,32,79,12
50559,159,115,19,43,38,15,41,66,4,4,44,4,6,4,30,44,0
50560,278,192,18,89,61,24,73,88,20,11,86,16,17,26,27,73,13
50561,248,186,31,80,39,36,76,76,15,19,62,12,16,15,19,60,2
50562,211,152,25,71,41,15,72,60,14,6,59,0,15,18,26,54,5
50563,1147,808,106,402,224,76,266,416,92,34,339,49,64,72,154,321,18
50565,254,164,24,71,49,20,52,99,6,7,90,22,18,24,26,73,17
50566,161,130,20,57,37,16,55,63,8,4,31,0,7,16,8,26,5
50567,96,83,6,43,20,14,27,48,3,5,13,5,3,3,2,10,3
50568,559,406,61,217,87,41,155,199,44,8,153,26,52,41,34,145,8
50569,349,247,58,120,65,4,90,125,24,8,102,6,38,43,15,89,13
50570,120,94,17,57,17,3,52,30,6,6,26,2,4,12,8,24,2
50571,210,134,7,68,44,15,51,76,4,3,76,22,9,26,19,70,6
50573,35,22,6,12,4,0,2,13,5,2,13,2,3,8,0,13,0
50574,1059,660,101,306,205,48,256,335,51,18,399,41,77,110,171,370,29
50575,487,310,53,128,97,32,109,166,25,10,177,35,26,57,59,174,3
50576,165,126,31,69,17,9,66,49,3,8,39,5,16,7,11,32,7
50577,193,130,12,77,17,24,73,52,3,2,63,19,20,13,11,52,11
50578,320,203,36,92,42,33,75,97,13,18,117,17,33,31,36,117,0
50579,1066,736,118,305,238,75,213,435,64,24,330,10,58,112,150,317,13
50581,475,339,42,143,103,51,101,198,16,24,136,13,14,51,58,129,7
50582,122,95,15,43,28,9,36,52,7,0,27,4,7,8,8,25,2
50583,1383,865,134,344,295,92,249,473,87,56,518,53,126,131,208,495,23
50585,531,336,49,136,105,46,85,198,34,19,195,26,49,41,79,182,13
50586,155,131,17,57,42,15,41,67,18,5,24,4,7,7,6,17,7
50588,4254,2858,522,1334,733,269,1050,1363,292,153,1396,303,472,284,337,1154,242
50590,422,263,32,125,77,29,101,124,28,10,159,22,53,45,39,141,18
50591,160,85,17,22,29,17,26,46,5,8,75,13,12,15,35,69,6
50592,41,26,3,9,10,4,8,12,0,6,15,2,9,2,2,14,1
50593,29,25,5,5,13,2,5,13,3,4,4,0,3,0,1,3,1
50594,143,105,19,47,18,21,46,41,9,9,38,0,7,17,14,38,0
50595,3948,2630,501,1135,762,232,892,1340,247,151,1318,207,444,283,384,1175,143
50597,548,374,69,155,105,45,152,189,21,12,174,26,48,33,67,157,17
50598,386,261,31,135,66,29,113,114,22,12,125,23,19,42,41,116,9
50599,201,134,10,57,55,12,32,95,5,2,67,7,11,31,18,64,3
50601,1127,798,132,318,248,100,301,424,30,43,329,56,58,91,124,311,18
50602,668,489,83,219,153,34,180,251,29,29,179,28,33,54,64,165,14
50603,231,176,39,57,63,17,68,85,6,17,55,8,13,14,20,53,2
50604,745,553,91,217,162,83,188,303,26,36,192,16,36,72,68,185,7
50605,60,39,3,18,10,8,9,19,4,7,21,0,13,3,5,21,0
50606,426,320,18,177,94,31,131,143,21,25,106,9,27,32,38,93,13
50607,229,167,23,63,61,20,53,86,12,16,62,2,6,27,27,61,1
50609,201,152,23,73,39,17,58,72,12,10,49,15,20,6,8,46,3
50611,169,145,45,45,38,17,59,73,11,2,24,5,6,3,10,18,6
50612,163,122,41,30,43,8,38,84,0,0,41,12,11,10,8,29,12
50613,13849,8437,1569,4022,2155,691,3085,4080,802,470,5412,2627,1159,774,852,3436,1976
50616,4391,2919,516,1249,847,307,967,1434,362,156,1472,303,270,363,536,1328,144
50619,964,707,121,358,177,51,272,356,58,21,257,53,50,54,100,221,36
50621,630,464,77,211,124,52,153,267,30,14,166,17,45,43,61,155,11
50622,1106,920,146,458,268,48,348,473,75,24,186,23,52,48,63,180,6
50623,50,44,12,21,9,2,8,28,8,0,6,0,0,3,3,6,0
50624,540,412,57,209,117,29,164,218,17,13,128,26,25,35,42,119,9
50625,450,296,52,145,61,38,116,137,23,20,154,36,24,40,54,134,20
50626,580,471,114,206,128,23,223,194,43,11,109,10,51,29,19,91,18
50627,1572,1005,152,459,272,122,353,489,135,28,567,114,163,108,182,504,63
50628,572,394,52,142,164,36,124,227,16,27,178,31,23,55,69,158,20
50629,864,627,128,330,135,34,272,291,38,26,237,48,77,63,49,221,16
50630,760,557,100,263,131,63,188,280,70,19,203,31,39,66,67,184,19
50631,66,49,10,16,14,9,12,34,0,3,17,0,3,0,14,17,0
50632,500,361,56,187,92,26,151,159,33,18,139,23,29,41,46,115,24
50633,169,111,32,55,24,0,57,47,0,7,58,10,4,14,30,41,17
50634,291,201,28,107,56,10,92,92,9,8,90,14,22,30,24,81,9
50635,670,470,69,212,134,55,172,245,40,13,200,33,66,40,61,169,31
50636,848,586,59,245,173,109,185,334,25,42,262,31,38,90,103,243,19
50638,1354,956,155,383,299,119,299,547,73,37,398,45,81,131,141,381,17
50641,697,522,153,226,115,28,238,208,51,25,175,39,37,60,39,143,32
50642,205,166,50,55,35,26,69,84,4,9,39,13,11,4,11,32,7
50643,1015,800,99,402,255,44,302,410,60,28,215,47,46,78,44,182,33
50644,3382,2357,517,1093,547,200,904,1119,221,113,1025,143,247,326,309,914,111
50645,485,338,31,212,73,22,159,154,21,4,147,60,38,32,17,123,24
50647,693,540,67,256,185,32,197,283,23,37,153,15,43,38,57,126,27
50648,1395,1108,206,508,299,95,429,542,85,52,287,47,41,64,135,266,21
50649,15,9,2,3,4,0,0,7,2,0,6,0,0,0,6,6,0
50650,325,216,46,93,60,17,79,108,21,8,109,11,47,25,26,101,8
50651,1406,1051,195,468,287,101,374,506,123,48,355,54,53,115,133,309,46
50652,66,39,8,19,12,0,18,16,5,0,27,5,4,4,14,21,6
50653,284,218,33,92,80,13,50,133,26,9,66,8,14,21,23,62,4
50654,219,179,18,102,33,26,70,87,15,7,40,15,5,15,5,37,3
50655,346,224,41,102,62,19,80,101,25,18,122,12,33,27,50,114,8
50658,1020,698,118,273,239,68,226,381,59,32,322,69,75,77,101,274,48
50659,2283,1564,296,668,420,180,594,779,119,72,719,127,177,168,247,636,83
50660,489,369,74,178,84,33,132,187,35,15,120,28,36,21,35,95,25
50662,3180,2115,442,875,570,228,634,972,325,184,1065,169,258,333,305,912,153
50665,1190,865,126,419,230,90,304,442,80,39,325,43,74,90,118,308,17
50666,385,258,45,112,79,22,97,149,8,4,127,21,42,30,34,108,19
50667,82,68,17,21,21,9,20,35,7,6,14,6,2,4,2,14,0
50668,480,367,91,153,104,19,154,182,20,11,113,15,15,24,59,108,5
50669,1059,766,113,333,224,96,259,404,58,45,293,44,67,58,124,270,23
50670,786,584,107,282,164,31,200,306,49,29,202,21,57,49,75,189,13
50671,98,94,10,38,36,10,25,58,11,0,4,0,0,3,1,4,0
50672,241,163,23,74,50,16,59,81,13,10,78,19,15,16,28,67,11
50673,67,59,9,24,23,3,17,28,10,4,8,2,2,2,2,6,2
50674,1499,1059,172,483,298,106,379,566,85,29,440,68,59,125,188,394,46
50675,1022,701,121,288,208,84,240,385,43,33,321,27,79,86,129,282,39
50676,795,577,91,273,153,60,226,251,60,40,218,33,60,39,86,198,20
50677,4159,2849,450,1323,858,218,1052,1419,250,128,1310,351,299,256,404,1086,224
50680,490,325,34,137,119,35,119,189,8,9,165,24,26,38,77,155,10
50681,177,117,13,56,41,7,50,63,2,2,60,9,21,13,17,48,12
50682,583,409,83,185,108,33,148,206,29,26,174,11,49,63,51,160,14
50701,12431,8052,1824,3656,2070,502,2766,4039,802,445,4379,1243,1305,986,845,3557,822
50702,8078,5032,1288,2134,1095,515,1584,2369,686,393,3046,737,744,686,879,2535,511
50703,8124,5284,1215,2429,1233,407,1336,1971,1239,738,2840,496,907,882,555,2376,464
50706,411,302,61,139,84,18,85,177,34,6,109,28,48,27,6,89,20
50707,3209,2281,579,1040,520,142,759,947,341,234,928,169,207,347,205,757,171
50801,3971,2474,452,1197,602,223,811,1264,318,81,1497,322,329,379,467,1316,181
50830,727,538,98,260,143,37,186,293,44,15,189,22,30,58,79,168,21
50833,1083,725,146,302,183,94,285,356,54,30,358,54,68,89,147,307,51
50835,55,52,5,18,21,8,14,33,3,2,3,0,3,0,0,3,0
50836,234,149,38,43,54,14,41,97,7,4,85,13,20,18,34,65,20
50837,196,121,32,46,21,22,35,58,24,4,75,9,21,33,12,67,8
50840,278,190,29,86,61,14,59,103,21,7,88,9,17,34,28,78,10
50841,1329,837,104,354,269,110,241,527,50,19,492,71,85,163,173,454,38
50843,284,193,28,85,60,20,71,107,9,6,91,13,26,18,34,83,8
50845,337,241,34,101,71,35,77,132,15,17,96,15,29,25,27,91,5
50846,533,356,64,131,108,53,107,209,24,16,177,11,48,49,69,166,11
50847,51,29,5,7,16,1,10,15,0,4,22,0,12,5,5,22,0
50848,186,144,8,69,42,25,43,86,7,8,42,8,6,20,8,41,1
50849,1241,876,123,367,265,121,274,496,72,34,365,52,75,86,152,346,19
50851,860,574,103,267,143,61,206,309,44,15,286,51,69,83,83,246,40
50853,336,241,44,109,67,21,86,130,20,5,95,16,10,27,42,85,10
50854,934,619,109,253,175,82,202,321,69,27,315,48,37,96,134,291,24
50857,178,130,25,55,38,12,67,56,3,4,48,5,15,20,8,48,0
50858,349,263,54,116,62,31,117,120,20,6,86,14,20,28,24,74,12
50859,190,146,17,67,49,13,52,83,5,6,44,3,10,10,21,39,5
50860,122,88,15,52,20,1,52,26,0,10,34,6,0,2,26,34,0
50861,129,97,18,36,33,10,18,61,15,3,32,11,4,6,11,25,7
50862,67,51,7,14,20,10,14,30,5,2,16,4,0,8,4,16,0
50863,142,92,14,27,41,10,21,55,7,9,50,2,10,11,27,43,7
50864,920,620,102,245,201,72,197,319,67,37,300,40,85,92,83,265,35
51001,930,630,104,270,186,70,232,329,46,23,300,55,53,71,121,280,20
51002,1150,808,119,418,200,71,305,382,82,39,342,72,85,63,122,295,47
51003,608,438,74,239,97,28,220,171,21,26,170,27,48,47,48,159,11
51004,498,337,42,155,91,49,119,160,27,31,161,30,24,51,56,145,16
51005,641,485,67,203,161,54,183,263,22,17,156,39,35,38,44,138,18
51006,486,311,42,139,97,33,117,169,13,12,175,27,38,57,53,154,21
51007,232,177,29,68,70,10,72,79,10,16,55,8,16,20,11,46,9
51008,47,37,0,22,9,6,7,26,4,0,10,4,0,6,0,6,4
51010,219,146,23,61,51,11,46,76,20,4,73,3,23,26,21,64,9
51011,42,23,3,13,7,0,5,13,3,2,19,1,4,11,3,16,3
51012,2860,1779,248,862,511,158,614,877,191,97,1081,174,311,305,291,968,113
51014,312,249,27,128,75,19,100,130,9,10,63,0,18,19,26,63,0
51016,564,400,78,160,115,47,124,213,41,22,164,25,50,27,62,145,19
51018,212,163,26,81,42,14,65,79,7,12,49,4,11,11,23,46,3
51019,367,265,29,136,92,8,100,139,18,8,102,11,8,37,46,97,5
51020,282,212,17,99,60,36,76,126,2,8,70,13,14,19,24,66,4
51022,297,216,29,119,48,20,95,91,18,12,81,19,21,14,27,75,6
51023,1232,827,157,392,188,90,307,410,88,22,405,73,91,132,109,368,37
51024,726,603,80,338,137,48,266,269,47,21,123,27,23,38,35,94,29
51025,858,596,87,268,152,89,207,307,48,34,262,60,38,69,95,250,12
51026,360,259,46,143,42,28,113,116,17,13,101,17,29,22,33,96,5
51027,470,391,91,160,102,38,189,189,10,3,79,6,17,25,31,74,5
51028,816,585,104,255,161,65,221,323,33,8,231,35,47,69,80,214,17
51029,115,81,7,33,18,23,11,60,8,2,34,8,14,7,5,33,1
51030,569,477,78,256,111,32,218,197,15,47,92,22,37,3,30,70,22
51031,4530,3225,704,1502,740,279,1374,1384,310,157,1305,273,391,342,299,1157,148
51033,231,163,5,83,59,16,41,102,7,13,68,10,34,13,11,58,10
51034,863,565,109,235,161,60,231,256,43,35,298,49,39,92,118,282,16
51035,707,492,55,238,133,66,189,249,41,13,215,41,29,65,80,195,20
51036,207,187,32,88,50,17,62,124,1,0,20,5,9,2,4,14,6
51037,204,158,14,67,73,4,29,102,25,2,46,0,18,18,10,44,2
51038,569,453,71,210,112,60,169,239,23,22,116,20,20,38,38,104,12
51039,943,707,141,352,155,59,312,328,47,20,236,44,42,76,74,210,26
51040,1548,956,148,367,280,161,306,444,97,109,592,93,132,185,182,530,62
51041,2001,1535,353,693,360,129,704,732,69,30,466,133,79,105,149,448,18
51044,106,81,29,29,17,6,23,35,15,8,25,3,8,2,12,22,3
51045,30,20,8,6,6,0,11,3,0,6,10,2,6,2,0,8,2
51046,912,623,81,245,228,69,222,358,18,25,289,44,75,73,97,269,20
51047,341,232,44,111,46,31,84,119,24,5,109,13,28,32,36,97,12
51048,242,178,23,80,51,24,68,92,11,7,64,17,11,15,21,57,7
51049,264,179,40,70,56,13,64,95,16,4,85,14,21,28,22,76,9
51050,1060,767,141,329,212,85,335,363,39,30,293,48,58,91,96,275,18
51051,38,18,6,7,2,3,7,9,1,1,20,0,5,12,3,20,0
51052,444,336,58,166,77,35,126,156,29,25,108,30,33,27,18,97,11
51053,512,368,46,188,99,35,131,182,34,21,144,33,25,39,47,125,19
51054,1396,1140,272,600,234,34,472,443,171,54,256,72,87,68,29,227,29
51055,551,361,76,185,76,24,158,141,39,23,190,15,41,77,57,186,4
51056,203,168,34,69,53,12,64,82,8,14,35,12,5,6,12,35,0
51058,437,286,60,98,95,33,87,159,14,26,151,24,29,34,64,141,10
51059,123,106,9,51,36,10,24,67,12,3,17,8,5,0,4,13,4
51060,280,197,19,65,82,31,53,114,13,17,83,12,18,29,24,74,9
51061,216,138,23,61,41,13,45,69,17,7,78,20,13,28,17,60,18
51062,265,181,20,103,51,7,92,60,19,10,84,14,31,35,4,53,31
51063,419,291,50,123,76,42,94,149,30,18,128,28,29,22,49,100,28
51101,355,76,30,17,21,8,7,34,24,11,279,23,92,106,58,268,11
51103,6247,4341,1211,1888,946,296,1496,1591,815,439,1906,429,508,470,499,1567,339
51104,8645,5659,1226,2749,1271,413,2235,2344,637,443,2986,711,780,694,801,2487,499
51105,4350,2741,862,1286,443,150,938,800,649,354,1609,456,570,385,198,1262,347
51106,10359,7120,1616,3312,1680,512,2619,3211,910,380,3239,875,908,743,713,2658,581
51108,2003,1473,294,785,332,62,560,701,132,80,530,85,170,186,89,434,96
51109,1197,776,150,373,167,86,253,345,94,84,421,103,110,147,61,350,71
51111,34,34,10,13,11,0,11,18,5,0,0,0,0,0,0,0,0
51201,2427,1677,388,685,432,172,677,886,81,33,750,210,159,170,211,659,91
51230,142,125,23,62,27,13,65,54,6,0,17,3,5,1,8,17,0
51231,88,76,6,38,20,12,33,39,4,0,12,0,7,0,5,12,0
51232,368,277,52,126,75,24,107,119,22,29,91,13,20,31,27,80,11
51234,454,358,72,161,92,33,154,169,8,27,96,12,16,31,37,88,8
51235,357,290,68,140,66,16,167,116,5,2,67,22,18,21,6,58,9
51237,747,519,74,219,162,64,195,284,21,19,228,36,34,67,91,226,2
51238,419,325,65,149,78,33,157,149,6,13,94,24,21,15,34,77,17
51239,1027,834,203,342,223,66,392,400,29,13,193,61,24,50,58,184,9
51240,610,448,116,188,110,34,184,205,43,16,162,16,72,24,50,146,16
51241,625,506,101,240,108,57,231,218,34,23,119,21,20,46,32,115,4
51242,83,50,7,21,16,6,17,31,2,0,33,11,8,10,4,25,8
51243,342,259,49,100,84,26,100,147,5,7,83,24,10,13,36,72,11
51244,12,12,4,5,3,0,9,3,0,0,0,0,0,0,0,0,0
51245,521,344,50,140,114,40,102,189,31,22,177,11,41,42,83,161,16
51246,1485,1061,152,479,300,130,409,567,42,43,424,73,105,91,155,401,23
51247,1602,1179,276,447,365,91,492,595,56,36,423,61,130,68,164,395,28
51248,726,532,92,222,168,50,236,272,14,10,194,18,54,65,57,180,14
51249,1502,1028,153,480,280,115,387,526,82,33,474,94,92,129,159,446,28
51250,2197,1678,276,882,335,185,803,733,99,43,519,112,93,124,190,446,73
51301,5465,3579,771,1615,837,356,1199,1737,419,224,1886,434,450,463,539,1711,175
51331,500,291,55,89,118,29,67,182,27,15,209,42,65,60,42,174,35
51333,209,176,30,96,46,4,75,85,11,5,33,9,9,8,7,29,4
51334,3233,2118,377,894,609,238,670,1083,228,137,1115,300,250,219,346,976,139
51338,446,330,82,155,78,15,134,154,32,10,116,27,31,29,29,99,17
51341,16,13,5,8,0,0,2,2,9,0,3,3,0,0,0,0,3
51342,532,337,38,168,100,31,126,168,25,18,195,54,34,47,60,179,16
51343,116,82,15,49,11,7,42,32,3,5,34,5,21,4,4,30,4
51344,36,31,8,12,11,0,13,15,0,3,5,2,1,0,2,2,3
51345,181,138,21,50,47,20,52,77,4,5,43,12,17,4,10,35,8
51346,1109,781,114,399,198,70,341,355,60,25,328,70,63,68,127,293,35
51347,588,414,83,179,113,39,140,234,27,13,174,51,34,31,58,158,16
51349,27,16,0,16,0,0,0,16,0,0,11,0,0,11,0,11,0
51350,196,125,9,67,37,12,46,73,4,2,71,2,19,25,25,69,2
51351,1786,1224,220,535,370,99,359,653,160,52,562,85,133,152,192,485,77
51354,428,300,74,137,67,22,128,134,27,11,128,28,18,31,51,113,15
51355,463,238,29,94,85,30,68,146,13,11,225,49,46,79,51,203,22
51357,287,195,36,90,39,30,78,87,18,12,92,22,18,22,30,80,12
51358,588,390,78,158,99,55,127,190,43,30,198,22,58,57,61,165,33
51360,3350,2295,293,1095,703,204,732,1273,167,123,1055,191,294,258,312,932,123
51363,68,43,6,16,21,0,9,30,2,2,25,1,11,8,5,22,3
51364,293,201,49,67,70,15,70,113,7,11,92,22,33,10,27,85,7
51365,157,119,23,61,24,11,49,64,5,1,38,0,19,7,12,36,2
51366,181,140,18,72,34,16,58,63,12,7,41,1,18,10,12,40,1
51401,4856,3210,586,1526,795,303,1250,1504,352,104,1646,396,347,480,423,1459,187
51430,338,254,39,110,81,24,104,123,11,16,84,6,20,22,36,79,5
51431,191,134,13,59,45,17,57,69,5,3,57,16,8,8,25,54,3
51433,289,216,32,101,58,25,76,98,8,34,73,21,12,22,18,47,26
51436,369,248,32,134,48,34,99,119,14,16,121,35,23,26,37,104,17
51439,471,327,41,131,124,31,102,192,22,11,144,28,28,36,52,135,9
51440,158,108,13,61,28,6,61,33,6,8,50,14,9,10,17,46,4
51441,166,130,25,53,35,17,39,69,17,5,36,3,19,9,5,31,5
51442,3250,2254,440,963,624,227,838,1001,233,182,996,148,323,199,326,876,120
51443,718,483,87,254,111,31,217,210,30,26,235,45,60,54,76,203,32
51444,102,70,25,32,12,1,57,11,2,0,32,3,8,7,14,30,2
51445,1301,854,122,388,272,72,315,416,84,39,447,91,109,86,161,403,44
51446,250,175,32,71,52,20,68,97,10,0,75,20,6,20,29,66,9
51447,102,85,0,53,30,2,18,62,5,0,17,6,3,8,0,9,8
51448,287,173,18,79,56,20,61,89,16,7,114,15,51,27,21,94,20
51449,936,615,115,276,147,77,222,314,58,21,321,30,58,111,122,304,17
51450,804,521,92,180,154,95,142,299,58,22,283,29,75,98,81,249,34
51451,59,32,4,9,10,9,11,21,0,0,27,6,10,6,5,27,0
51452,74,53,13,29,7,4,34,11,4,4,21,9,2,7,3,16,5
51453,350,219,38,105,58,18,97,106,14,2,131,17,36,46,32,116,15
51454,571,426,101,176,113,36,196,202,18,10,145,20,37,53,35,123,22
51455,983,655,79,299,192,85,236,335,43,41,328,67,67,84,110,310,18
51458,689,452,82,194,128,48,197,219,17,19,237,30,47,61,99,222,15
51459,9,4,0,4,0,0,4,0,0,0,5,5,0,0,0,5,0
51461,492,343,51,138,102,52,110,200,19,14,149,27,33,28,61,142,7
51462,521,352,51,160,100,41,133,175,15,29,169,29,58,40,42,153,16
51463,257,182,27,85,54,16,65,102,15,0,75,9,15,19,32,65,10
51465,330,242,39,116,67,20,90,122,24,6,88,20,22,27,19,83,5
51466,404,293,55,129,85,24,105,151,31,6,111,25,19,19,48,103,8
51467,235,179,21,77,65,16,69,103,2,5,56,6,22,14,14,53,3
51501,13313,8847,2466,4018,1844,519,2645,3339,1788,1075,4466,893,1477,1407,689,3647,819
51502,8,8,0,8,0,0,0,8,0,0,0,0,0,0,0,0,0
51503,13157,9280,1575,4575,2512,618,3168,4406,1037,669,3877,973,960,1102,842,3228,649
51510,1224,918,149,444,276,49,252,440,114,112,306,58,121,83,44,246,60
51520,107,85,24,38,21,2,37,30,9,9,22,2,4,12,4,19,3
51521,867,635,120,267,186,62,208,334,60,33,232,37,60,66,69,203,29
51523,151,105,13,44,28,20,29,60,6,10,46,2,4,12,28,46,0
51525,446,351,63,174,91,23,110,211,25,5,95,2,14,42,37,90,5
51526,630,527,56,269,166,36,154,301,28,44,103,21,46,22,14,73,30
51527,249,214,35,100,63,16,102,96,13,3,35,1,12,16,6,28,7
51528,450,300,20,166,80,34,95,175,10,20,150,27,48,42,33,134,16
51529,726,493,86,206,158,43,160,221,56,56,233,26,46,61,100,207,26
51530,373,249,37,101,77,34,78,149,11,11,124,24,35,23,42,107,17
51531,364,263,39,99,79,46,87,142,25,9,101,8,28,16,49,93,8
51532,306,245,30,126,63,26,70,126,31,18,61,9,12,19,21,47,14
51533,410,308,55,143,72,38,109,158,33,8,102,7,31,32,32,93,9
51534,2979,2252,445,1136,553,118,878,1009,233,132,727,146,204,201,176,638,89
51535,856,620,97,276,175,72,194,341,49,36,236,44,39,63,90,207,29
51536,212,172,27,78,49,18,45,96,13,18,40,5,9,13,13,37,3
51537,2790,1978,274,988,499,217,801,951,135,91,812,135,180,217,280,743,69
51540,208,158,38,67,41,12,53,81,17,7,50,10,10,13,17,39,11
51541,150,98,5,47,38,8,36,54,5,3,52,18,7,9,18,47,5
51542,357,266,36,136,70,24,83,174,0,9,91,20,41,19,11,59,32
51543,171,117,19,49,44,5,44,55,17,1,54,2,18,9,25,53,1
51544,305,208,47,99,43,19,97,84,22,5,97,0,24,38,35,96,1
51545,200,145,24,55,48,18,33,91,13,8,55,3,17,23,12,50,5
51546,1084,792,169,366,210,47,311,374,68,39,292,47,72,72,101,255,37
51548,191,142,27,80,28,7,62,57,9,14,49,11,12,26,0,43,6
51549,211,136,19,72,37,8,60,56,18,2,75,12,35,16,12,68,7
51550,24,10,5,3,2,0,6,2,2,0,14,0,5,4,5,14,0
51551,693,502,88,239,130,45,171,264,48,19,191,37,53,43,58,172,19
51552,121,94,21,42,26,5,40,45,6,3,27,10,10,5,2,20,7
51553,346,273,59,132,63,19,106,137,14,16,73,12,16,26,19,56,17
51554,83,53,18,28,7,0,39,14,0,0,30,0,0,12,18,30,0
51555,2143,1509,271,691,454,93,569,746,98,96,634,80,186,188,180,542,92
51556,198,127,21,60,31,15,37,81,9,0,71,3,11,41,16,68,3
51557,367,277,37,123,102,15,99,134,23,21,90,7,43,16,24,84,6
51558,282,191,35,84,58,14,67,99,18,7,91,15,33,11,32,77,14
51559,633,488,114,230,105,39,205,196,59,28,145,18,32,48,47,126,19
51560,811,566,91,270,152,53,194,301,43,28,245,48,48,65,84,215,30
51561,564,428,41,240,110,37,122,229,39,38,136,16,55,44,21,100,36
51562,185,135,13,67,36,19,67,57,0,11,50,10,14,18,8,46,4
51563,302,249,66,102,71,10,119,101,13,16,53,7,3,28,15,46,7
51564,238,150,25,62,48,15,47,85,14,4,88,8,21,23,36,76,12
51565,218,162,34,64,59,5,65,84,8,5,56,6,9,30,11,51,5
51566,3197,2109,452,943,503,211,706,960,273,170,1088,129,367,275,317,964,124
51570,440,314,51,140,93,30,108,149,35,22,126,17,33,35,41,108,18
51571,252,196,40,91,49,16,58,116,12,10,56,10,12,18,16,54,2
51572,222,139,19,49,45,26,40,85,6,8,83,11,28,28,16,75,8
51573,474,334,35,172,102,25,125,166,27,16,140,21,48,27,44,130,10
51574,6,4,0,0,2,2,0,2,0,2,2,0,2,0,0,2,0
51575,237,170,19,90,54,7,87,66,3,14,67,3,14,16,34,62,5
51576,547,432,56,274,96,6,227,164,29,12,115,25,31,32,27,98,17
51577,515,380,59,176,105,40,136,193,30,21,135,20,25,43,47,126,9
51578,51,30,3,21,4,2,17,10,3,0,21,3,3,4,11,17,4
51579,948,672,101,341,155,75,254,316,58,44,276,49,44,76,107,254,22
51601,2740,1766,299,689,581,197,486,951,216,113,974,181,186,268,339,903,71
51630,102,65,17,22,22,4,19,38,6,2,37,5,2,11,19,32,5
51631,232,163,26,82,46,9,62,82,11,8,69,17,8,33,11,60,9
51632,2598,1720,335,797,384,204,595,804,212,109,878,183,252,246,197,782,96
51636,211,150,19,72,48,11,45,85,20,0,61,3,17,16,25,58,3
51637,123,102,13,38,39,12,39,53,5,5,21,2,4,6,9,21,0
51638,631,461,78,198,130,55,154,268,17,22,170,37,56,33,44,154,16
51639,333,231,19,114,63,35,74,127,16,14,102,6,30,38,28,91,11
51640,774,537,90,231,155,61,153,271,66,47,237,44,52,71,70,208,29
51645,115,83,7,37,34,5,27,53,0,3,32,6,17,4,5,27,5
51646,339,238,42,114,53,29,60,140,31,7,101,16,23,16,46,90,11
51647,138,104,14,55,21,14,38,56,6,4,34,1,10,1,22,31,3
51648,116,85,6,36,33,10,20,53,5,7,31,4,14,13,0,24,7
51649,128,100,15,57,18,10,37,41,17,5,28,5,5,3,15,22,6
51650,161,98,16,44,30,8,37,48,7,6,63,10,18,22,13,57,6
51652,789,553,112,244,138,59,199,273,57,24,236,20,54,72,90,215,21
51653,552,384,76,158,113,37,118,205,28,33,168,13,32,61,62,152,16
51654,203,143,28,73,36,6,60,64,14,5,60,2,21,19,18,48,12
52001,17416,10692,2423,4639,2779,851,3545,4882,1332,933,6724,1578,2145,1510,1491,5734,990
52002,4182,3173,632,1638,749,154,1399,1346,272,156,1009,259,299,293,158,856,153
52003,4923,3674,600,1801,1034,239,1495,1740,286,153,1249,236,355,386,272,1063,186
52030,149,115,35,57,17,6,51,34,25,5,34,3,7,9,15,30,4
52031,1717,1256,166,614,327,149,511,599,75,71,461,109,94,164,94,394,67
52032,511,348,25,192,112,19,130,181,16,21,163,17,68,36,42,145,18
52033,1135,821,158,413,181,69,355,402,30,34,314,69,78,54,113,290,24
52035,430,319,37,157,101,24,113,186,16,4,111,25,30,19,37,99,12
52036,76,55,6,26,19,4,18,30,7,0,21,2,5,7,7,18,3
52037,459,351,39,169,112,31,131,177,18,25,108,19,34,28,27,101,7
52038,198,163,38,75,32,18,76,69,15,3,35,3,6,10,16,23,12
52039,384,312,44,132,117,19,117,164,26,5,72,28,23,13,8,44,28
52040,1983,1502,269,705,410,118,623,725,98,56,481,119,119,107,136,430,51
52041,594,471,75,258,101,37,229,162,43,37,123,29,26,31,37,103,20
52042,621,457,81,223,110,43,220,191,24,22,164,20,29,59,56,158,6
52043,977,667,83,291,215,78,206,382,39,40,310,39,78,86,107,285,25
52044,81,48,15,20,9,4,17,14,10,7,33,4,4,14,11,27,6
52045,723,594,100,325,140,29,288,224,52,30,129,39,37,35,18,111,18
52046,731,577,114,316,122,25,279,231,43,24,154,36,23,46,49,142,12
52047,315,229,26,119,70,14,84,119,17,9,86,7,21,41,17,83,3
52048,171,134,32,72,24,6,56,69,6,3,37,14,6,11,6,31,6
52049,567,394,40,174,141,39,108,229,41,16,173,16,44,40,73,157,16
52050,217,183,29,77,73,4,40,103,20,20,34,3,10,12,9,31,3
52052,1295,901,136,349,322,94,292,461,78,70,394,77,94,104,119,355,39
52053,377,299,35,161,81,22,148,125,8,18,78,17,23,21,17,65,13
52054,355,278,37,127,88,26,121,136,6,15,77,21,17,26,13,66,11
52056,98,74,12,29,30,3,27,45,0,2,24,0,7,6,11,24,0
52057,3149,2169,435,984,528,222,893,961,191,124,980,223,275,198,284,848,132
52060,3631,2402,483,1064,624,231,815,1120,319,148,1229,186,272,383,388,1098,131
52064,372,271,29,157,71,14,111,135,14,11,101,15,17,32,37,91,10
52065,383,304,38,159,92,15,135,134,18,17,79,16,17,19,27,71,8
52066,22,13,0,1,8,4,1,12,0,0,9,4,2,3,0,5,4
52068,922,818,204,399,186,29,391,348,39,40,104,24,38,27,15,93,11
52069,623,415,71,189,126,29,169,209,15,22,208,47,49,36,76,182,26
52070,522,351,58,137,135,21,86,205,45,15,171,21,58,35,57,152,19
52071,49,40,6,21,10,3,16,18,4,2,9,3,2,3,1,9,0
52072,116,101,20,70,11,0,39,39,18,5,15,11,2,2,0,13,2
52073,518,429,61,206,136,26,157,241,24,7,89,20,17,29,23,75,14
52074,109,82,21,41,20,0,37,28,10,7,27,6,2,10,9,21,6
52075,57,52,7,23,12,10,20,26,2,4,5,0,5,0,0,3,2
52076,876,647,122,307,155,63,244,312,71,20,229,50,43,62,74,209,20
52077,176,121,21,56,23,21,36,71,12,2,55,11,20,12,12,43,12
52078,302,261,41,134,63,23,131,89,19,22,41,10,13,9,9,34,7
52079,282,207,33,118,45,11,82,99,19,7,75,2,25,28,20,66,9
52101,4887,3200,524,1505,826,345,1228,1581,225,166,1687,446,444,343,454,1443,244
52132,737,459,103,231,83,42,221,177,26,35,278,76,70,74,58,235,43
52133,254,196,40,73,74,9,69,107,9,11,58,18,19,15,6,44,14
52134,157,108,12,62,26,8,45,49,6,8,49,9,12,6,22,47,2
52135,394,276,30,134,98,14,94,141,27,14,118,24,28,35,31,99,19
52136,2447,1633,314,716,461,142,685,730,124,94,814,147,262,139,266,708,106
52140,211,165,29,53,63,20,58,107,0,0,46,11,18,12,5,40,6
52141,610,402,51,188,121,42,155,190,30,27,208,27,55,55,71,189,19
52142,606,406,79,184,97,46,149,183,47,27,200,49,60,55,36,179,21
52144,559,416,59,190,110,57,174,217,5,20,143,35,26,30,52,118,25
52146,359,262,22,112,106,22,65,165,22,10,97,33,7,31,26,90,7
52147,490,357,72,171,87,27,163,136,37,21,133,4,17,47,65,126,7
52151,922,632,87,256,225,64,223,329,32,48,290,39,95,77,79,254,36
52154,437,330,28,155,122,25,132,171,16,11,107,15,29,32,31,106,1
52155,540,391,77,143,114,57,154,180,31,26,149,16,58,43,32,133,16
52156,278,188,25,84,57,22,57,81,29,21,90,14,31,31,14,75,15
52157,777,505,112,207,145,41,167,257,57,24,272,46,106,82,38,229,43
52158,133,64,13,20,23,8,16,30,6,12,69,14,25,17,13,60,9
52159,966,678,109,318,186,65,246,336,64,32,288,58,77,65,88,247,41
52160,351,242,41,95,76,30,92,111,21,18,109,9,30,43,27,97,12
52161,519,376,69,162,112,33,156,178,18,24,143,30,37,20,56,123,20
52162,1257,914,174,447,242,51,374,410,74,56,343,55,95,78,115,294,49
52163,159,77,15,33,21,8,27,39,11,0,82,12,17,15,38,72,10
52164,95,76,10,38,18,10,21,39,12,4,19,1,5,2,11,18,1
52165,350,239,29,122,74,14,100,122,17,0,111,21,49,29,12,99,12
52166,14,7,4,1,0,2,1,6,0,0,7,0,4,0,3,7,0
52168,162,115,19,46,33,17,39,65,11,0,47,12,2,14,19,44,3
52169,170,121,20,54,36,11,34,64,17,6,49,18,7,15,9,42,7
52170,200,165,30,67,62,6,79,72,2,12,35,4,12,12,7,30,5
52171,494,346,32,169,110,35,144,189,5,8,148,27,17,51,53,122,26
52172,2505,1648,270,766,430,182,615,781,140,112,857,201,198,189,269,764,93
52175,1516,986,178,435,283,90,374,443,104,65,530,117,145,100,168,464,66
52201,431,343,74,159,85,25,130,185,22,6,88,12,28,25,23,77,11
52202,367,298,67,161,59,11,154,106,27,11,69,21,13,15,20,55,14
52203,675,492,73,206,154,59,200,253,12,27,183,21,80,32,50,147,36
52205,2780,1903,386,891,477,149,600,929,234,140,877,152,242,281,202,728,149
52206,568,456,104,240,91,21,220,190,34,12,112,25,28,25,34,112,0
52207,177,135,10,73,43,9,43,68,15,9,42,9,11,18,4,37,5
52208,1457,999,191,480,214,114,357,506,98,38,458,61,96,151,150,422,36
52209,457,342,64,134,104,40,92,197,19,34,115,15,29,41,30,102,13
52210,276,204,44,101,51,8,92,86,12,14,72,22,19,8,23,60,12
52211,1081,712,104,333,204,71,231,362,81,38,369,82,83,100,104,320,49
52212,130,92,6,46,30,10,22,68,0,2,38,3,10,15,10,31,7
52213,1444,1118,261,571,221,65,508,470,105,35,326,59,99,81,87,275,51
52214,1339,1003,178,486,265,74,354,523,80,46,336,52,79,111,94,286,50
52215,333,257,42,116,85,14,96,124,23,14,76,11,32,9,24,66,10
52216,605,443,79,184,118,62,173,241,15,14,162,10,36,38,78,153,9
52217,251,147,30,54,48,15,62,76,2,7,104,13,16,33,42,102,2
52218,661,491,98,220,127,46,188,240,54,9,170,24,46,36,64,154,16
52219,39,27,3,9,13,2,8,10,4,5,12,0,1,11,0,11,1
52220,27,19,5,9,5,0,14,5,0,0,8,0,0,8,0,8,0
52221,92,55,7,21,22,5,20,28,5,2,37,8,2,12,15,31,6
52222,294,228,35,99,73,21,89,117,18,4,66,18,13,17,18,61,5
52223,537,418,48,192,143,35,145,224,35,14,119,28,51,26,14,100,19
52224,772,585,94,267,151,73,217,299,52,17,187,19,49,51,68,172,15
52225,156,137,26,65,37,9,60,59,11,7,19,4,5,3,7,15,4
52226,40,27,8,12,7,0,11,9,4,3,13,2,7,4,0,11,2
52227,655,498,108,275,94,21,226,211,38,23,157,55,48,20,34,117,40
52228,562,470,72,210,154,34,191,225,32,22,92,15,34,35,8,73,19
52229,285,211,45,92,57,17,59,123,23,6,74,16,15,23,20,62,12
52231,137,106,13,61,18,14,49,45,4,8,31,18,0,4,9,18,13
52232,96,66,1,40,21,4,25,37,4,0,30,6,4,8,12,30,0
52233,2720,1545,459,640,421,25,505,676,228,136,1175,523,383,220,49,925,250
52235,5,3,3,0,0,0,3,0,0,0,2,2,0,0,0,0,2
52236,176,129,6,55,43,25,35,88,0,6,47,5,12,15,15,42,5
52237,605,472,77,243,107,45,231,196,12,33,133,22,45,33,33,115,18
52240,12729,6171,1595,3090,1193,293,2305,2658,633,575,6558,3798,1551,812,397,3848,2710
52241,6522,3386,1147,1717,448,74,1399,1201,525,261,3136,1707,896,322,211,2305,831
52242,0,0,0,0,0,0,0,0,0,0,0,0,0,0,0,0,0
52245,7280,3822,601,2012,828,381,1398,1829,285,310,3458,1664,968,459,367,2297,1161
52246,8773,4053,1410,1928,580,135,1722,1610,404,317,4720,3076,961,371,312,3063,1657
52247,1884,1346,275,654,313,104,659,561,76,50,538,90,182,147,119,484,54
52248,741,513,67,246,131,69,190,259,35,29,228,33,69,38,88,204,24
52249,398,290,62,114,78,36,133,130,15,12,108,14,19,15,60,104,4
52251,234,161,39,71,41,10,61,69,24,7,73,14,29,14,16,60,13
52253,1038,816,180,435,154,47,404,315,76,21,222,42,76,55,49,197,25
52254,393,284,76,119,68,21,79,155,39,11,109,8,22,39,40,96,13
52255,498,341,54,163,88,36,151,162,16,12,157,14,41,33,69,141,16
52257,70,60,4,45,7,4,30,18,10,2,10,0,3,2,5,10,0
52301,1723,1158,254,527,311,66,393,577,132,56,565,66,200,128,171,483,82
52302,11051,7717,1886,3566,1920,345,3090,3393,759,475,3334,1019,1086,784,445,2694,640
52305,196,159,29,87,33,10,55,85,6,13,37,5,15,4,13,30,7
52306,718,516,76,279,116,45,208,224,58,26,202,45,53,56,48,171,31
52307,85,44,0,23,7,14,23,21,0,0,41,17,13,6,5,41,0
52308,38,21,0,15,2,4,6,7,6,2,17,4,8,5,0,15,2
52309,183,138,26,64,43,5,60,62,8,8,45,5,17,19,4,37,8
52310,2452,1713,374,699,482,158,608,883,126,96,739,129,196,199,215,616,123
52312,35,18,0,12,6,0,6,8,4,0,17,4,8,2,3,12,5
52313,171,142,24,63,48,7,49,80,6,7,29,12,0,13,4,18,11
52314,1639,1193,169,691,285,48,503,551,101,38,446,87,106,144,109,358,88
52315,500,363,23,189,109,42,145,191,20,7,137,22,30,42,43,116,21
52316,668,476,79,217,123,57,185,228,39,24,192,33,48,41,70,165,27
52317,2643,1695,657,839,180,19,679,686,245,85,948,372,394,160,22,684,264
52318,426,334,62,144,100,28,142,151,15,26,92,17,28,28,19,90,2
52320,495,357,58,152,113,34,117,178,31,31,138,33,40,29,36,114,24
52321,203,143,14,69,38,22,35,77,23,8,60,3,8,29,20,57,3
52322,922,693,92,362,171,68,255,344,48,46,229,39,74,56,60,203,26
52323,378,243,56,104,62,21,114,94,23,12,135,17,26,48,44,114,21
52324,547,393,58,225,86,24,168,203,6,16,154,26,73,33,22,123,31
52325,279,198,40,106,45,7,99,84,6,9,81,14,36,28,3,65,16
52326,215,153,24,79,39,11,50,81,18,4,62,10,17,24,11,45,17
52327,1080,803,164,431,169,39,315,365,75,48,277,74,90,63,50,230,47
52328,408,356,28,249,71,8,223,114,11,8,52,2,36,12,2,41,11
52329,322,252,25,128,74,25,76,154,15,7,70,13,22,15,20,67,3
52330,339,240,63,74,92,11,121,108,5,6,99,19,21,38,21,88,11
52332,776,557,107,283,150,17,220,244,66,27,219,53,79,62,25,177,42
52333,1864,1507,207,880,351,69,643,744,80,40,357,87,136,76,58,270,87
52334,110,79,34,13,32,0,23,49,0,7,31,8,16,7,0,20,11
52335,275,188,32,90,57,9,60,103,11,14,87,8,28,26,25,82,5
52336,895,648,107,316,184,41,241,328,49,30,247,57,58,62,70,205,42
52337,338,225,48,96,55,26,84,106,20,15,113,19,44,20,30,88,25
52338,1011,830,122,515,166,27,400,380,31,19,181,26,58,67,30,142,39
52339,1524,1087,217,482,311,77,425,480,110,72,437,65,94,120,158,394,43
52340,519,303,116,142,39,6,100,140,49,14,216,96,78,16,26,159,57
52341,359,291,33,142,85,31,90,141,27,33,68,17,22,23,6,41,27
52342,1369,936,191,431,246,68,321,401,122,92,433,74,90,115,154,381,52
52345,368,301,90,156,39,16,139,118,32,12,67,21,20,10,16,57,10
52346,428,298,36,160,79,23,122,147,17,12,130,30,41,27,32,104,26
52347,605,442,56,233,91,62,160,225,42,15,163,24,41,54,44,153,10
52348,25,20,7,8,2,3,11,8,0,1,5,4,1,0,0,3,2
52349,2960,2081,360,944,574,203,728,1012,194,147,879,149,221,214,295,767,112
52351,360,326,101,187,30,8,194,92,24,16,34,9,13,2,10,30,4
52352,655,526,104,275,113,34,225,240,37,24,129,26,23,48,32,95,34
52353,3662,2533,467,1150,614,302,968,1123,229,213,1129,178,269,265,417,1019,110
52354,136,108,16,47,16,29,26,49,16,17,28,0,22,6,0,28,0
52355,139,104,4,59,27,14,48,50,4,2,35,19,6,2,8,27,8
52356,944,659,115,280,192,72,217,355,58,29,285,38,81,75,91,260,25
52358,1330,968,177,503,233,55,369,445,88,66,362,72,140,80,70,288,74
52359,104,66,8,33,25,0,18,41,5,2,38,5,11,19,3,26,12
52361,1561,1083,205,557,244,77,526,457,74,26,478,125,94,119,140,422,56
52362,479,336,52,159,106,19,105,181,42,8,143,11,45,41,46,138,5
52401,1061,363,152,99,95,17,103,145,70,45,698,140,159,249,150,625,73
52402,16442,10114,2447,4899,2145,623,3960,4492,1157,505,6328,2096,1944,1285,1003,5100,1228
52403,10152,6622,1165,3277,1624,556,2413,3023,707,479,3530,851,1123,793,763,3010,520
52404,13414,8299,2149,3701,1860,589,2665,3597,1313,724,5115,1850,1544,1085,636,3906,1209
52405,10274,6849,1569,3183,1575,522,2457,3060,845,487,3425,979,1011,748,687,2719,706
52411,1826,1620,144,1038,411,27,778,751,56,35,206,25,92,75,14,178,28
52501,12603,8263,1632,3693,2173,765,2502,4052,1082,627,4340,880,1160,1291,1009,3630,710
52530,423,288,33,130,92,33,91,170,17,10,135,10,25,53,47,114,21
52531,2400,1591,304,688,424,175,573,781,164,73,809,143,190,221,255,715,94
52533,476,348,60,181,82,25,144,169,23,12,128,21,34,37,36,111,17
52534,105,64,13,34,15,2,17,31,12,4,41,10,15,11,5,29,12
52535,512,359,51,160,118,30,103,222,28,6,153,22,48,34,49,114,39
52536,406,271,36,129,68,38,79,142,32,18,135,40,46,26,23,106,29
52537,2527,1771,290,882,483,116,649,887,148,87,756,87,180,244,245,663,93
52540,618,423,74,197,125,27,119,246,37,21,195,40,51,58,46,159,36
52542,178,109,35,27,40,7,36,55,15,3,69,20,13,15,21,58,11
52543,111,95,1,41,53,0,33,62,0,0,16,0,0,9,7,16,0
52544,3564,2305,452,986,594,273,778,1075,260,192,1259,253,274,396,336,1150,109
52548,17,15,3,6,6,0,2,4,5,4,2,2,0,0,0,0,2
52549,299,207,50,88,59,10,80,88,32,7,92,23,16,19,34,69,23
52550,280,170,32,79,43,16,66,76,16,12,110,14,28,30,38,96,14
52551,75,61,13,8,34,6,9,50,2,0,14,0,14,0,0,14,0
52552,354,245,45,104,83,13,116,118,10,1,109,16,19,31,43,86,23
52553,744,508,107,232,135,34,177,239,56,36,236,58,71,59,48,186,50
52554,562,371,98,141,94,38,114,189,49,19,191,29,49,60,53,159,32
52555,152,113,30,47,30,6,35,55,20,3,39,7,15,10,7,23,16
52556,5178,3239,524,1755,780,180,1118,1476,498,147,1939,316,841,314,468,1680,259
52560,244,191,26,77,56,32,45,122,15,9,53,2,14,17,20,49,4
52561,383,278,56,132,62,28,114,129,17,18,105,21,27,29,28,90,15
52562,29,20,2,9,7,2,6,11,3,0,9,2,4,2,1,7,2
52563,622,466,83,198,133,52,168,224,47,27,156,15,68,40,33,131,25
52565,838,574,109,249,152,64,185,284,65,40,264,16,98,63,87,233,31
52566,56,42,13,21,7,1,17,21,4,0,14,6,2,3,3,12,2
52567,240,173,66,79,18,10,73,58,38,4,67,5,33,7,22,58,9
52568,36,26,4,7,13,2,2,22,0,2,10,3,2,3,2,10,0
52569,222,167,13,51,83,20,44,90,10,23,55,16,6,20,13,52,3
52570,346,263,58,97,73,35,93,148,12,10,83,12,11,32,28,78,5
52571,615,444,69,178,151,46,114,240,45,45,171,19,32,46,74,156,15
52572,494,340,62,141,101,36,105,167,36,32,154,19,40,47,48,139,15
52573,94,71,10,35,20,6,36,32,2,1,23,3,7,9,4,16,7
52574,394,256,57,124,66,9,113,110,26,7,138,20,47,50,21,105,33
52576,253,185,33,88,54,10,71,106,6,2,68,4,10,17,37,65,3
52577,6022,4005,882,1767,953,403,1406,1869,492,238,2017,494,532,449,542,1753,264
52580,184,117,21,54,32,10,41,59,1,16,67,9,16,11,31,67,0
52581,150,104,6,36,54,8,15,82,0,7,46,5,19,6,16,43,3
52583,199,141,13,43,68,17,29,98,7,7,58,6,10,23,19,58,0
52584,187,151,17,75,39,20,60,86,2,3,36,0,1,14,21,36,0
52585,411,295,52,132,70,41,112,147,28,8,116,27,16,28,45,100,16
52586,249,191,32,88,42,29,66,111,11,3,58,5,32,13,8,51,7
52588,191,113,15,57,35,6,43,60,10,0,78,5,0,30,43,78,0
52590,460,314,47,141,90,36,88,174,29,23,146,20,37,52,37,128,18
52591,1257,868,147,394,241,86,286,452,89,41,389,30,75,110,174,356,33
52593,64,53,12,20,15,6,17,23,7,6,11,2,2,3,4,11,0
52594,122,98,10,50,35,3,46,47,2,3,24,1,8,9,6,22,2
52595,134,95,28,42,18,7,29,49,14,3,39,18,11,8,2,34,5
52601,12730,8380,1675,3756,2172,777,2649,3999,1107,625,4350,792,1129,1312,1117,3817,533
52619,313,214,45,129,34,6,102,82,26,4,99,9,39,39,12,74,25
52620,308,220,26,112,68,14,75,108,24,13,88,18,25,20,25,82,6
52621,274,203,37,96,52,18,72,92,30,9,71,10,32,14,15,60,11
52623,700,554,88,266,160,40,201,287,39,27,146,33,49,32,32,115,31
52624,98,65,13,12,19,21,22,36,7,0,33,9,6,11,7,27,6
52625,1021,766,111,359,231,65,274,409,50,33,255,31,68,63,93,231,24
52626,572,365,58,179,94,34,123,179,41,22,207,32,41,69,65,186,21
52627,5589,3677,581,1717,1071,308,1135,1820,436,286,1912,381,619,393,519,1694,218
52630,325,254,48,114,75,17,84,139,18,13,71,9,21,24,17,60,11
52631,32,26,4,13,7,2,8,18,0,0,6,0,3,0,3,6,0
52632,5621,3702,792,1589,1038,283,1185,1675,524,318,1919,267,557,510,585,1686,233
52635,282,224,69,106,34,15,115,90,17,2,58,7,24,8,19,51,7
52637,985,690,140,326,155,69,240,338,85,27,295,61,61,77,96,247,48
52638,282,226,54,114,46,12,80,95,36,15,56,10,23,13,10,40,16
52639,872,656,89,365,175,27,235,291,87,43,216,29,42,83,62,196,20
52640,574,428,74,191,127,36,155,219,35,19,146,21,53,33,39,118,28
52641,4484,3018,614,1438,709,257,1045,1372,376,225,1466,289,451,346,380,1279,187
52644,175,148,31,77,18,22,78,55,12,3,27,4,19,2,2,20,7
52645,1226,903,186,395,273,49,330,451,88,34,323,77,86,77,83,274,49
52646,308,242,74,96,54,18,89,102,40,11,66,3,21,20,22,62,4
52647,94,65,26,27,8,4,22,20,20,3,29,12,6,3,8,25,4
52649,413,264,80,130,39,15,103,121,32,8,149,15,29,41,64,123,26
52650,312,229,20,154,48,7,106,97,14,12,83,29,34,9,11,66,17
52651,147,102,18,36,38,10,32,57,10,3,45,11,7,20,7,38,7
52652,47,27,4,5,18,0,9,18,0,0,20,0,5,7,8,20,0
52653,1429,1100,261,482,274,83,432,510,109,49,329,60,81,79,109,293,36
52654,620,482,89,200,146,47,175,242,45,20,138,24,38,30,46,120,18
52655,2002,1330,199,665,371,95,366,684,188,92,672,148,195,191,138,601,71
52656,1019,725,71,387,191,76,274,373,45,33,294,54,79,89,72,242,52
52658,440,343,82,141,76,44,139,168,13,23,97,0,28,53,16,81,16
52659,590,405,68,198,104,35,175,175,40,15,185,17,51,26,91,171,14
52660,105,68,8,31,22,7,15,46,7,0,37,0,19,0,18,25,12
52701,50,29,7,13,7,2,10,17,2,0,21,0,0,17,4,19,2
52720,460,317,36,192,74,15,112,153,30,22,143,20,51,49,23,122,21
52721,331,257,46,104,84,23,80,147,14,16,74,18,14,19,23,66,8
52722,13364,9476,1547,5112,2337,480,4015,4232,831,398,3888,887,1252,988,761,3409,479
52726,1587,1317,167,720,403,27,515,671,88,43,270,52,98,72,48,191,79
52727,167,126,20,71,35,0,66,54,6,0,41,9,16,12,4,30,11
52728,324,231,53,98,63,17,71,117,18,25,93,19,35,27,12,82,11
52729,354,265,50,128,72,15,123,110,12,20,89,8,19,33,29,85,4
52730,1999,1375,159,694,425,97,435,716,131,93,624,176,148,164,136,539,85
52731,354,277,44,142,76,15,112,144,15,6,77,26,4,32,15,63,14
52732,12006,7913,1569,3533,2114,697,2565,3632,1068,648,4093,786,1195,1034,1078,3509,584
52737,67,49,8,24,15,2,21,21,6,1,18,0,4,10,4,18,0
52738,1403,1010,237,468,230,75,411,420,111,68,393,62,117,132,82,332,61
52739,271,201,55,84,45,17,82,98,19,2,70,10,13,23,24,59,11
52742,2868,2012,364,1011,433,204,834,932,104,142,856,213,152,296,195,746,110
52745,245,199,29,102,62,6,90,96,11,2,46,0,16,13,17,42,4
52746,367,291,46,183,47,15,128,135,7,21,76,29,19,18,10,61,15
52747,743,530,104,262,126,38,206,241,57,26,213,15,34,83,81,189,24
52748,2493,1982,389,1126,410,57,935,740,212,95,511,127,227,71,86,448,63
52749,275,243,36,162,38,7,99,98,19,27,32,7,11,7,7,21,11
52750,212,161,25,95,32,9,66,73,14,8,51,14,12,20,5,51,0
52751,416,330,75,149,84,22,131,153,27,19,86,16,22,30,18,74,12
52752,202,136,41,63,24,8,54,42,32,8,66,20,13,25,8,55,11
52753,1621,1224,148,630,383,63,403,664,103,54,397,90,169,82,56,328,69
52754,524,423,50,235,126,12,192,188,27,16,101,6,28,29,38,93,8
52755,697,500,99,264,91,46,210,209,61,20,197,29,69,67,32,158,39
52756,758,606,55,350,162,39,243,277,46,40,152,48,41,35,28,105,47
52757,111,81,28,18,25,10,34,40,2,5,30,11,7,8,4,28,2
52758,45,30,5,14,8,3,9,19,0,2,15,2,0,11,2,15,0
52760,218,173,21,91,54,7,48,97,15,13,45,10,0,14,21,32,13
52761,11617,8174,1852,3908,1897,517,3148,3490,962,574,3443,713,1035,974,721,2900,543
52765,168,144,25,75,28,16,58,66,15,5,24,4,8,7,5,19,5
52766,349,225,38,129,49,9,80,113,30,2,124,34,49,26,15,91,33
52767,76,53,5,15,33,0,0,31,7,15,23,0,6,11,6,17,6
52768,556,416,73,243,85,15,169,202,37,8,140,18,35,52,35,117,23
52769,270,210,23,105,72,10,64,112,24,10,60,16,44,0,0,53,7
52772,1976,1406,240,643,405,118,517,698,112,79,570,138,111,160,161,500,70
52773,912,693,130,319,178,66,226,368,67,32,219,48,73,61,37,193,26
52774,44,36,14,14,8,0,17,10,7,2,8,2,2,2,2,4,4
52776,1508,1124,296,538,221,69,478,465,131,50,384,63,105,83,133,313,71
52777,534,383,67,180,88,48,126,199,41,17,151,23,45,46,37,134,17
52778,1518,1133,204,565,261,103,417,563,103,50,385,94,128,75,88,319,66
52801,593,52,10,25,17,0,0,26,16,10,541,109,157,159,116,498,43
52802,4363,2860,863,1200,636,161,825,938,715,382,1503,261,529,418,295,1223,280
52803,9635,5700,1492,2621,1196,391,1802,2231,1027,640,3935,1458,1268,732,477,3209,726
52804,10565,7266,1639,3180,1866,581,2238,3209,1118,701,3299,686,1095,886,632,2727,572
52806,9954,7025,1917,3349,1406,353,2641,2928,1061,395,2929,765,913,686,565,2307,622
52807,4819,2605,643,1203,601,158,907,1236,332,130,2214,1097,498,349,270,1793,421
53001,715,559,105,305,114,35,233,268,38,20,156,42,42,36,36,121,35
53002,806,646,143,352,133,18,277,283,48,38,160,34,67,42,17,121,39
53003,80,66,14,29,23,0,21,33,5,7,14,3,6,0,5,14,0
53004,988,746,165,371,154,56,333,331,42,40,242,49,100,41,52,197,45
53005,7382,5979,417,2993,2003,566,2298,3066,243,372,1403,201,419,450,333,1211,192
53006,624,476,70,253,116,37,197,227,21,31,148,33,38,49,28,116,32
53007,924,478,98,210,128,42,139,236,54,49,446,76,89,103,178,386,60
53010,2699,2023,346,1044,499,134,805,984,136,98,676,151,218,184,123,527,149
53011,734,551,85,288,145,33,212,291,25,23,183,17,88,43,35,154,29
53012,6650,5089,506,2812,1455,316,2296,2321,304,168,1561,313,487,452,309,1356,205
53013,1109,852,155,415,214,68,388,386,40,38,257,44,82,84,47,229,28
53014,2956,2094,380,1077,495,142,882,944,151,117,862,238,203,185,236,731,131
53015,967,753,116,404,189,44,266,429,36,22,214,48,69,51,46,184,30
53016,44,30,8,17,5,0,21,5,2,2,14,2,5,2,5,14,0
53017,1619,1393,153,839,347,54,628,638,73,54,226,19,105,93,9,175,51
53018,2680,2197,224,1352,527,94,981,976,130,110,483,60,191,158,74,402,81
53019,639,498,90,266,110,32,211,210,40,37,141,42,34,50,15,124,17
53020,1410,1091,133,607,286,65,424,571,45,51,319,74,116,78,51,252,67
53021,1428,1150,213,660,224,53,521,498,91,40,278,78,84,67,49,212,66
53022,6694,4981,846,2863,1105,167,2128,2106,404,343,1713,350,616,512,235,1381,332
53023,507,388,61,199,116,12,163,188,22,15,119,33,34,31,21,92,27
53024,5611,4148,682,2280,1004,182,1684,1983,266,215,1463,320,435,346,362,1240,223
53027,7218,5327,992,2767,1221,347,2097,2341,537,352,1891,428,621,524,318,1553,338
53029,6330,4977,725,3023,1044,185,2342,1975,495,165,1353,314,471,354,214,1096,257
53032,1925,1438,251,763,308,116,562,645,123,108,487,128,133,130,96,445,42
53033,1896,1657,130,1009,462,56,697,827,45,88,239,44,126,50,19,193,46
53034,734,503,102,240,128,33,204,233,38,28,231,33,78,59,61,189,42
53035,744,549,110,279,130,30,254,248,22,25,195,39,62,52,42,162,33
53036,725,582,97,289,178,18,219,282,38,43,143,29,57,26,31,132,11
53037,2698,1980,530,1020,307,123,837,934,119,90,718,203,237,201,77,576,142
53038,1096,783,180,392,170,41,308,345,73,57,313,84,80,90,59,235,78
53039,1692,1219,266,544,323,86,434,626,95,64,473,82,154,127,110,387,86
53040,2480,1934,316,1014,470,134,763,901,168,102,546,148,200,119,79,427,119
53042,2509,1818,332,887,468,131,759,860,92,107,691,145,193,184,169,586,105
53044,716,545,75,305,133,32,261,246,23,15,171,17,35,68,51,157,14
53045,7832,6121,462,3442,1865,352,2614,3030,275,202,1711,177,355,579,600,1552,159
53046,485,320,42,154,108,16,109,155,21,35,165,32,55,50,28,144,21
53047,24,17,2,3,8,4,4,13,0,0,7,2,0,0,5,5,2
53048,1225,910,238,452,177,43,417,327,109,57,315,85,84,77,69,266,49
53049,915,715,92,342,226,55,281,335,44,55,200,33,62,62,43,179,21
53050,2615,1863,347,924,440,152,703,812,204,144,752,136,186,225,205,680,72
53051,12784,9296,1389,4688,2651,568,3673,4474,585,564,3488,596,916,1070,906,3026,462
53057,560,436,58,233,128,17,180,207,27,22,124,29,28,31,36,107,17
53058,1396,1031,168,542,248,73,395,503,83,50,365,50,142,112,61,287,78
53059,653,534,83,307,123,21,220,237,37,40,119,19,54,31,15,91,28
53061,2027,1412,231,667,400,114,492,737,130,53,615,172,199,107,137,525,90
53063,567,458,86,237,98,37,215,193,22,28,109,23,33,24,29,85,24
53065,773,598,96,314,146,42,260,272,33,33,175,33,54,39,49,138,37
53066,10579,7921,1129,4301,1913,578,3162,3847,494,418,2658,521,739,694,704,2212,446
53069,295,191,48,64,69,10,66,117,8,0,104,25,50,12,17,75,29
53070,1683,1357,228,671,378,80,544,714,72,27,326,91,70,78,87,270,56
53072,8496,5765,1021,2961,1539,244,2272,2805,346,342,2731,755,991,712,273,2179,552
53073,5277,3685,621,2013,826,225,1458,1695,339,193,1592,375,389,358,470,1319,273
53074,4760,3270,650,1657,746,217,1309,1462,346,153,1490,369,493,321,307,1247,243
53075,1263,949,151,508,244,46,362,452,93,42,314,66,121,70,57,268,46
53076,1011,867,87,546,211,23,378,384,54,51,144,17,58,53,16,110,34
53078,636,528,75,296,120,37,241,242,8,37,108,20,46,28,14,80,28
53079,534,421,65,217,101,38,181,208,16,16,113,19,39,25,30,96,17
53080,2200,1620,313,924,344,39,658,700,182,80,580,198,171,146,65,470,110
53081,17683,11018,2497,4974,2632,915,3865,4841,1504,808,6665,1924,1982,1312,1447,5647,1018
53083,7697,5576,1049,2886,1296,345,2238,2700,427,211,2121,471,639,466,545,1771,350
53085,4039,2899,512,1438,778,171,1071,1535,170,123,1140,239,427,256,218,971,169
53086,2705,2041,338,1215,406,82,904,822,172,143,664,114,239,183,128,544,120
53088,95,66,6,43,10,7,29,23,12,2,29,7,4,12,6,20,9
53089,5819,4598,782,2588,1046,182,1993,2035,335,235,1221,211,369,407,234,972,249
53090,7239,5510,1117,2992,1164,237,2365,2421,448,276,1729,404,593,417,315,1393,336
53091,737,573,119,274,131,49,206,301,43,23,164,35,51,49,29,138,26
53092,7842,6075,462,3238,1887,488,2429,3066,303,277,1767,159,578,589,441,1566,201
53093,709,560,96,281,156,27,201,292,32,35,149,25,66,35,23,114,35
53094,6224,4441,990,2138,980,333,1639,1935,506,361,1783,422,547,440,374,1473,310
53095,9827,6801,1284,3260,1700,557,2480,3352,654,315,3026,713,878,655,780,2487,539
53097,1728,1390,118,818,416,38,631,648,69,42,338,54,138,98,48,293,45
53098,4308,3153,583,1553,741,276,1276,1445,252,180,1155,207,269,299,380,962,193
53103,1350,1152,106,705,306,35,470,571,44,67,198,28,81,51,38,147,51
53104,1896,1438,188,784,359,107,540,669,91,138,458,84,129,164,81,374,84
53105,10199,7589,1250,4009,1890,440,2987,3372,675,555,2610,647,773,593,597,2077,533
53108,1198,963,136,502,296,29,317,546,42,58,235,70,70,62,33,185,50
53110,7926,4901,1095,2155,1263,388,1494,2120,760,527,3025,636,995,789,605,2603,422
53114,830,658,154,337,128,39,267,262,64,65,172,28,79,38,27,145,27
53115,5725,3919,813,1913,974,219,1521,1700,391,307,1806,428,578,401,399,1486,320
53118,2493,1925,268,1074,518,65,703,930,187,105,568,52,190,167,159,493,75
53119,1753,1442,252,847,323,20,706,630,62,44,311,57,141,82,31,225,86
53120,3257,2508,453,1294,651,110,905,1207,207,189,749,108,271,205,165,631,118
53121,5714,4072,842,1955,950,325,1563,1775,506,228,1642,292,590,467,293,1325,317
53122,2506,1829,92,905,629,203,700,1042,42,45,677,88,150,236,203,620,57
53125,893,627,63,263,241,60,181,390,14,42,266,51,93,72,50,227,39
53126,2168,1818,217,981,504,116,762,783,125,148,350,50,96,124,80,273,77
53128,2445,1806,405,938,345,118,711,672,239,184,639,134,246,135,124,520,119
53129,5920,4181,515,1836,1433,397,1390,2152,302,337,1739,234,414,559,532,1579,160
53130,3187,2091,343,1013,529,206,769,1009,122,191,1096,214,303,294,285,930,166
53132,10512,7743,1069,4462,1935,277,3170,3572,461,540,2769,656,1055,703,355,2307,462
53137,481,396,68,188,115,25,152,203,17,24,85,9,25,21,30,73,12
53139,1003,730,106,403,174,47,325,329,54,22,273,74,92,54,53,213,60
53140,11016,6762,1984,2780,1490,508,2006,2455,1440,861,4254,934,1412,1021,887,3562,692
53142,10894,7801,1481,4115,1744,461,3277,3172,710,642,3093,694,847,950,602,2562,531
53143,9193,6093,1440,2892,1286,475,2144,2318,1087,544,3100,668,1150,595,687,2566,534
53144,8671,5675,1524,2693,1206,252,2021,2230,915,509,2996,1050,1115,544,287,2418,578
53146,2702,2168,255,1160,664,89,785,1164,129,90,534,50,213,198,73,412,122
53147,6141,3965,688,1905,1133,239,1406,1860,409,290,2176,470,706,567,433,1806,370
53148,109,80,5,54,13,8,32,42,6,0,29,0,9,0,20,29,0
53149,5953,4875,714,3001,971,189,2104,2163,438,170,1078,288,291,276,223,852,226
53150,7673,6213,898,3611,1478,226,2588,2852,434,339,1460,276,473,383,328,1157,303
53151,11775,8787,1127,4668,2434,558,3634,4275,408,470,2988,715,1077,696,500,2361,627
53153,726,610,76,385,133,16,269,269,33,39,116,26,42,30,18,72,44
53154,11231,7552,1878,3863,1512,299,3400,3142,560,450,3679,1232,1263,778,406,2821,858
53156,1148,830,150,384,235,61,279,402,72,77,318,56,108,100,54,261,57
53158,3926,3104,514,1730,758,102,1382,1418,162,142,822,196,271,207,148,633,189
53167,56,25,3,13,9,0,12,9,4,0,31,7,18,6,0,29,2
53168,2975,2209,354,1308,472,75,987,925,191,106,766,150,330,188,98,584,182
53170,769,556,131,311,79,35,249,190,79,38,213,21,92,49,51,179,34
53172,8623,5627,1050,2861,1259,457,2000,2396,722,509,2996,714,938,706,638,2560,436
53176,49,40,8,26,6,0,26,14,0,0,9,0,0,9,0,9,0
53177,2287,1641,279,821,423,118,569,779,219,74,646,140,290,126,90,483,163
53178,1144,839,141,436,227,35,291,446,48,54,305,67,84,103,51,249,56
53179,1766,1354,294,736,273,51,560,551,188,55,412,103,181,81,47,328,84
53181,2482,1780,350,844,478,108,743,770,183,84,702,141,270,156,135,553,149
53182,2818,2061,400,1000,578,83,811,910,209,131,757,172,295,132,158,626,131
53183,900,788,63,557,156,12,412,307,44,25,112,20,51,29,12,80,32
53184,1293,948,152,482,249,65,396,400,91,61,345,69,104,88,84,286,59
53185,6042,4802,752,2782,1078,190,2255,2081,268,198,1240,249,500,297,194,934,306
53186,13565,8369,1881,4217,1822,449,3345,3547,841,636,5196,1591,1569,1088,948,4102,1094
53188,13012,8822,1941,4591,1846,444,3652,3876,852,442,4190,1197,1347,795,851,3368,822
53189,7332,6098,1090,3627,1202,179,2769,2429,532,368,1234,316,473,350,95,1056,178
53190,5866,3085,706,1368,781,230,1057,1423,370,235,2781,1634,437,348,362,1639,1142
53191,944,653,86,323,201,43,251,283,82,37,291,64,76,101,50,249,42
53192,16,8,4,2,0,2,4,2,0,2,8,2,2,4,0,8,0
53195,12,8,0,6,2,0,1,5,2,0,4,0,0,2,2,2,2
53202,13768,2212,767,719,549,177,246,1382,185,399,11556,5788,3212,1676,880,9508,2048
53203,237,58,15,31,12,0,0,48,10,0,179,55,112,12,0,142,37
53204,12278,8436,3478,3514,1243,201,2990,1554,2400,1492,3842,766,1584,1059,433,3012,830
53205,3724,2277,876,911,352,138,363,306,1108,500,1447,253,379,646,169,1295,152
53206,10770,7660,2389,3067,1792,412,1094,1357,3253,1956,3110,443,1207,1034,426,2638,472
53207,16285,9282,2233,4375,1864,810,2810,3896,1345,1231,7003,1785,2731,1457,1030,5653,1350
53208,12841,7394,2693,3553,849,299,1789,1444,3074,1087,5447,1563,2427,1109,348,4454,993
53209,19179,12639,3361,5815,2700,763,2714,3836,3963,2126,6540,1206,2226,1915,1193,5725,815
53210,10551,7279,2364,3740,978,197,1723,1390,2800,1366,3272,841,1356,724,351,2667,605
53211,15979,6818,1544,3378,1468,428,2424,3018,638,738,9161,5009,2030,1143,979,6055,3106
53212,11782,6539,2229,2905,1090,315,1142,1244,2755,1398,5243,1814,1965,1043,421,4152,1091
53213,11175,6628,1429,3532,1249,418,2689,2675,674,590,4547,1462,1566,746,773,3731,816
53214,15828,8666,2185,4091,1667,723,2674,3509,1444,1039,7162,1965,2396,1555,1246,5914,1248
53215,19439,12619,4117,5673,2083,746,4465,3707,2781,1666,6820,1376,2308,1790,1346,5476,1344
53216,12839,8485,2213,4166,1702,404,1798,2206,2822,1659,4354,773,1884,1110,587,3746,608
53217,11726,8222,947,4217,2236,822,3247,4027,528,420,3504,665,1056,923,860,3064,440
53218,14414,10382,2994,4846,1956,586,2486,2839,3501,1556,4032,662,1634,1149,587,3417,615
53219,15707,8896,1817,3880,2140,1059,2685,4174,966,1071,6811,1483,2145,1580,1603,5888,923
53220,11162,6617,1319,2671,1925,702,1900,3278,696,743,4545,947,1354,1286,958,3887,658
53221,15371,9439,1865,4000,2579,995,2640,4428,1090,1281,5932,1266,1755,1617,1294,4867,1065
53222,11344,6685,1568,2773,1437,907,2089,2996,734,866,4659,863,1469,1183,1144,4093,566
53223,12382,7538,1739,3199,2022,578,2178,3237,1286,837,4844,970,1523,1265,1086,4235,609
53224,7144,4855,1698,2099,916,142,1482,1559,1339,475,2289,565,818,579,327,1819,470
53225,10163,6735,2159,2911,1272,393,1826,2294,1835,780,3428,881,1055,720,772,2799,629
53226,8394,4828,804,2170,1255,599,1784,2357,261,426,3566,659,925,859,1123,3168,398
53227,10975,6063,1320,2597,1431,715,1837,2946,777,503,4912,1327,1431,981,1173,4080,832
53228,5907,3884,649,1885,982,368,1269,2016,272,327,2023,410,557,506,550,1693,330
53233,5110,1262,724,415,110,13,221,218,616,207,3848,2320,873,467,188,2895,953
53235,4110,2192,424,988,597,183,662,1009,218,303,1918,470,676,352,420,1689,229
53402,12708,9198,1818,4674,2098,608,3285,4169,1064,680,3510,647,1215,936,712,2986,524
53403,10549,6696,1517,3202,1526,451,1968,2563,1357,808,3853,1039,1303,882,629,3282,571
53404,5687,3939,1130,1768,774,267,1100,1230,1122,487,1748,383,634,414,317,1369,379
53405,10242,7076,1421,3443,1713,499,2448,2986,1066,576,3166,706,1046,810,604,2717,449
53406,9355,6254,1141,2915,1674,524,2028,3237,631,358,3101,483,743,1025,850,2780,321
53502,868,626,115,327,143,41,259,277,49,41,242,42,70,74,56,187,55
53503,655,489,85,280,102,22,193,243,26,27,166,43,50,37,36,136,30
53504,789,541,86,254,151,50,207,252,46,36,248,37,83,67,61,202,46
53505,140,99,17,46,28,8,38,51,6,4,41,7,14,8,12,34,7
53506,482,325,59,147,90,29,97,136,41,51,157,23,61,44,29,134,23
53507,733,554,122,300,110,22,235,219,61,39,179,16,74,47,42,151,28
53508,1591,1204,235,666,257,46,463,556,129,56,387,74,132,101,80,295,92
53510,518,367,59,176,95,37,130,181,23,33,151,33,34,30,54,126,25
53511,17932,12483,2841,5756,3001,885,3931,5465,2055,1032,5449,851,1770,1580,1248,4595,854
53515,799,605,106,320,129,50,254,274,46,31,194,33,62,65,34,160,34
53516,699,508,85,249,131,43,204,250,29,25,191,41,73,38,39,155,36
53517,616,468,109,266,88,5,239,169,43,17,148,20,74,33,21,115,33
53518,556,380,53,185,106,36,124,164,46,46,176,34,46,52,44,159,17
53520,2481,1874,354,889,481,150,663,832,249,130,607,123,167,177,140,511,96
53521,1089,862,150,511,139,62,374,353,92,43,227,46,79,47,55,172,55
53522,407,312,57,159,73,23,104,155,38,15,95,22,41,18,14,74,21
53523,1833,1285,202,679,288,116,526,578,111,70,548,103,175,152,118,432,116
53525,1424,1030,170,571,229,60,414,445,113,58,394,81,138,77,98,301,93
53526,231,159,30,77,32,20,61,70,18,10,72,12,26,14,20,62,10
53527,2743,2264,576,1281,316,91,1092,889,186,97,479,135,215,92,37,339,140
53528,1922,1446,273,770,343,60,626,658,116,46,476,122,172,111,71,377,99
53529,608,464,106,251,93,14,214,186,39,25,144,38,60,27,19,94,50
53530,1707,1188,193,559,330,106,441,562,120,65,519,88,98,161,172,457,62
53531,1343,1007,223,516,225,43,411,422,126,48,336,65,126,80,65,249,87
53532,4051,3178,664,1843,569,102,1458,1299,270,151,873,256,262,193,162,673,200
53533,2593,1812,295,940,448,129,656,815,210,131,781,163,230,197,191,676,105
53534,4332,3014,562,1581,734,137,1169,1371,220,254,1318,255,322,387,354,1090,228
53536,2683,1909,418,988,385,118,809,777,192,131,774,179,280,151,164,630,144
53537,130,93,29,41,17,6,34,44,11,4,37,14,13,2,8,35,2
53538,6914,4741,924,2343,1130,344,1818,2151,450,322,2173,614,611,482,466,1769,404
53540,60,36,18,6,8,4,11,17,3,5,24,2,4,14,4,20,4
53541,388,292,45,162,67,18,122,120,35,15,96,15,20,29,32,83,13
53543,621,452,80,237,98,37,193,186,34,39,169,39,44,38,48,145,24
53544,325,230,38,123,48,21,90,99,21,20,95,14,26,21,34,77,18
53545,16826,10914,2288,5273,2639,714,3793,4898,1450,773,5912,1531,1847,1463,1071,4846,1066
53546,10738,7691,1748,3670,1948,325,2874,3354,980,483,3047,900,1100,684,363,2355,692
53549,3817,2606,498,1298,643,167,841,1283,332,150,1211,290,310,322,289,970,241
53550,432,357,65,171,96,25,155,170,13,19,75,16,30,18,11,56,19
53551,2816,1985,368,1009,450,158,809,891,135,150,831,198,211,230,192,669,162
53553,247,175,57,82,32,4,79,61,19,16,72,14,16,23,19,60,12
53554,399,284,51,140,72,21,114,140,16,14,115,20,23,37,35,96,19
53555,3051,2271,408,1176,554,133,908,1112,130,121,780,138,236,220,186,639,141
53556,1115,750,172,361,171,46,273,364,85,28,365,68,129,89,79,278,87
53557,175,119,24,63,28,4,54,43,12,10,56,7,13,19,17,46,10
53558,3361,2548,360,1625,519,44,1239,1010,202,97,813,137,351,168,157,612,201
53559,2016,1531,336,785,332,78,665,617,145,104,485,98,175,114,98,382,103
53560,1355,1031,191,535,259,46,382,492,90,67,324,52,134,77,61,261,63
53561,650,457,51,228,150,28,134,258,46,19,193,21,69,69,34,146,47
53562,8386,4955,914,2792,960,289,2064,2139,511,241,3431,1433,1074,586,338,2712,719
53563,3516,2624,453,1454,589,128,1030,1187,286,121,892,200,289,244,159,730,162
53565,1777,1232,246,578,311,97,500,572,82,78,545,117,187,134,107,455,90
53566,6097,3960,669,1998,988,305,1444,1796,481,239,2137,422,575,588,552,1830,307
53569,413,304,45,169,72,18,118,131,34,21,109,23,30,29,27,84,25
53570,895,640,118,322,167,33,251,312,51,26,255,41,86,70,58,210,45
53571,71,53,0,45,8,0,23,30,0,0,18,0,9,0,9,9,9
53572,3134,2273,463,1243,408,159,983,1017,193,80,861,226,270,150,215,673,188
53573,1284,882,164,396,260,62,305,424,93,60,402,82,116,87,117,347,55
53574,1273,903,164,488,175,76,365,376,108,54,370,56,88,121,105,306,64
53575,4766,3717,707,2234,644,132,1664,1499,400,154,1049,276,402,223,148,807,242
53576,791,618,118,323,135,42,224,272,86,36,173,29,74,43,27,123,50
53577,569,406,61,204,104,37,168,189,25,24,163,24,46,48,45,144,19
53578,1941,1383,247,740,315,81,554,638,127,64,558,123,183,99,153,443,115
53579,736,522,90,293,122,17,207,233,54,28,214,60,60,41,53,175,39
53580,222,152,30,86,31,5,76,44,19,13,70,16,20,28,6,59,11
53581,4153,2725,472,1225,727,301,934,1258,364,169,1428,272,349,369,438,1250,178
53582,445,305,55,180,56,14,116,138,27,24,140,23,64,39,14,101,39
53583,2048,1416,240,697,351,128,513,653,180,70,632,157,166,107,202,559,73
53585,782,584,112,296,153,23,235,259,49,41,198,46,74,41,37,180,18
53586,883,605,110,302,163,30,229,284,58,34,278,49,75,67,87,247,31
53587,505,362,55,185,90,32,139,156,39,28,143,16,40,38,49,128,15
53588,1445,1059,204,556,227,72,460,473,60,66,386,48,141,102,95,342,44
53589,7334,5249,1074,2760,1102,313,2201,2230,540,278,2085,453,629,533,470,1683,402
53590,9806,7036,1578,3897,1313,248,3110,2698,887,341,2770,930,867,518,455,2102,668
53593,4589,3530,412,2215,775,128,1702,1428,291,109,1059,160,447,244,208,810,249
53594,1858,1379,251,725,325,78,537,605,153,84,479,138,166,91,84,377,102
53597,4837,3666,649,2057,743,217,1670,1595,323,78,1171,274,370,264,263,938,233
53598,840,640,137,314,169,20,243,319,73,5,200,93,51,45,11,126,74
53703,12663,1541,659,620,161,101,337,765,192,247,11122,8679,1775,368,300,6688,4434
53704,19731,9941,2797,4703,1848,593,3051,4216,1587,1087,9790,3476,3775,1616,923,6754,3036
53705,13383,6912,1611,3110,1599,592,2372,3409,572,559,6471,2708,1590,1085,1088,4722,1749
53706,13,13,0,13,0,0,0,0,13,0,0,0,0,0,0,0,0
53711,17195,10870,1997,5850,2292,731,4298,4758,1033,781,6325,2312,2051,1180,782,4571,1754
53713,9959,4791,2104,1913,626,148,1523,1627,1132,509,5168,2554,1816,579,219,3549,1619
53714,6997,4186,915,2063,877,331,1268,1866,702,350,2811,819,1104,585,303,2062,749
53715,4509,1046,377,442,159,68,304,434,108,200,3463,2275,623,396,169,1969,1494
53716,8167,5281,757,2749,1412,363,1831,2613,521,316,2886,688,874,731,593,2229,657
53717,4879,2770,486,1553,609,122,1158,1228,273,111,2109,835,569,463,242,1724,385
53718,1580,1054,165,522,278,89,366,604,39,45,526,142,201,108,75,401,125
53719,8053,4459,1749,2051,512,147,1816,1824,538,281,3594,2108,1115,292,79,2498,1096
53801,321,234,26,93,91,24,77,140,10,7,87,10,30,32,15,79,8
53803,454,302,53,152,82,15,110,139,28,25,152,31,40,44,37,130,22
53804,630,463,72,237,119,35,175,216,36,36,167,34,36,36,61,149,18
53805,2061,1438,287,665,356,130,531,579,202,126,623,120,187,167,149,525,98
53806,831,569,73,281,168,47,187,281,73,28,262,28,62,96,76,240,22
53807,1860,1421,229,707,371,114,581,663,101,76,439,78,134,104,123,387,52
53808,249,177,37,66,63,11,52,105,7,13,72,16,19,21,16,57,15
53809,1535,1060,173,510,286,91,371,530,110,49,475,107,106,124,138,391,84
53810,219,160,31,77,45,7,55,71,11,23,59,11,14,21,13,44,15
53811,1149,853,146,391,263,53,293,441,76,43,296,66,85,78,67,241,55
53813,2412,1651,278,815,424,134,661,794,123,73,761,177,155,190,239,645,116
53816,253,180,29,81,61,9,54,105,12,9,73,7,21,25,20,62,11
53817,16,14,4,7,0,3,4,8,0,2,2,0,0,0,2,2,0
53818,4524,2672,465,1306,698,203,904,1253,284,231,1852,938,290,334,290,1279,573
53820,1153,853,158,377,285,33,330,421,54,48,300,57,84,95,64,264,36
53821,3274,2163,409,994,603,157,771,1019,247,126,1111,184,304,349,274,985,126
53825,150,114,26,61,27,0,54,45,15,0,36,9,5,11,11,34,2
53826,643,457,94,256,85,22,199,178,54,26,186,38,43,53,52,158,28
53827,109,93,11,47,30,5,36,52,2,3,16,3,2,4,7,16,0
53901,5367,3438,592,1690,833,323,1217,1584,374,263,1929,446,570,487,426,1628,301
53910,1444,912,178,387,254,93,264,404,149,95,532,73,143,179,137,459,73
53911,390,297,64,147,64,22,108,143,31,15,93,12,43,18,20,70,23
53913,7267,4744,941,2403,1111,289,1735,2116,613,280,2523,662,716,534,611,2072,451
53916,8566,5710,1059,2739,1492,420,2074,2517,696,423,2856,600,888,739,629,2402,454
53919,931,759,158,372,175,54,335,327,44,53,172,26,50,39,57,160,12
53920,208,140,20,46,52,22,34,78,12,16,68,3,17,32,16,61,7
53922,410,330,52,177,87,14,124,178,18,10,80,9,19,36,16,72,8
53923,761,582,90,279,177,36,231,277,42,32,179,33,43,46,57,164,15
53924,539,392,58,181,120,33,141,196,32,23,147,22,51,39,35,122,25
53925,2901,2030,376,1019,453,182,776,960,163,131,871,198,254,185,234,755,116
53926,455,341,70,162,76,33,143,148,30,20,114,19,29,30,36,95,19
53928,15,9,1,4,2,2,3,4,2,0,6,2,0,0,4,4,2
53929,1111,779,135,377,188,79,291,358,82,48,332,54,109,106,63,276,56
53930,449,353,57,179,88,29,134,156,46,17,96,17,42,18,19,78,18
53931,109,86,14,39,27,6,27,49,8,2,23,7,6,0,10,20,3
53932,747,553,102,273,148,30,218,266,40,29,194,50,62,38,44,148,46
53933,1146,762,113,357,223,69,269,401,44,48,384,77,113,105,89,311,73
53934,1798,1229,154,475,457,143,287,766,123,53,569,39,170,221,139,470,99
53935,59,49,7,27,11,4,29,20,0,0,10,0,2,2,6,10,0
53936,583,405,63,147,152,43,95,249,38,23,178,25,73,54,26,154,24
53937,314,246,40,117,66,23,88,121,17,20,68,6,22,11,29,58,10
53939,72,49,10,18,19,2,11,27,9,2,23,2,9,4,8,19,4
53940,11,8,0,4,2,2,2,4,0,2,3,0,0,3,0,0,3
53941,1003,792,120,360,257,55,264,429,80,19,211,39,53,66,53,163,48
53943,395,303,63,136,89,15,129,143,15,16,92,19,31,27,15,72,20
53944,793,539,88,250,163,38,167,247,56,69,254,34,96,76,48,202,52
53946,1753,1246,197,578,377,94,441,652,88,65,507,86,111,141,169,447,60
53947,56,42,3,9,28,2,8,31,0,3,14,2,4,7,1,7,7
53948,3104,2087,393,947,568,179,691,946,310,140,1017,195,274,317,231,856,161
53949,2465,1665,220,656,606,183,473,927,131,134,800,119,231,266,184,671,129
53950,1745,1249,195,535,435,84,350,695,118,86,496,50,153,177,116,428,68
53951,874,637,133,304,148,52,234,314,58,31,237,36,88,55,58,193,44
53952,1218,833,123,371,274,65,251,460,67,55,385,44,138,125,78,313,72
53953,76,57,9,33,13,2,18,22,9,8,19,7,2,10,0,14,5
53954,2460,1800,319,889,475,117,673,881,146,100,660,120,212,205,123,518,142
53955,2185,1556,286,825,376,69,557,773,138,88,629,87,231,198,113,525,104
53956,1230,903,183,417,232,71,340,438,82,43,327,60,88,73,106,283,44
53959,4445,3040,670,1346,767,257,1144,1390,353,153,1405,378,382,289,356,1114,291
53960,1191,888,139,486,212,51,366,405,68,49,303,55,112,67,69,244,59
53961,310,233,46,105,65,17,80,118,21,14,77,12,23,24,18,55,22
53962,20,13,0,11,2,0,7,6,0,0,7,0,0,7,0,5,2
53963,4200,2973,600,1387,773,213,1129,1412,311,121,1227,234,294,341,358,1104,123
53964,1235,849,138,399,261,51,282,411,99,57,386,58,92,118,118,342,44
53965,3651,2468,407,1136,713,212,801,1243,235,189,1183,253,371,362,197,930,253
53968,946,654,111,310,162,71,229,297,65,63,292,45,74,91,82,258,34
53969,59,32,10,11,9,2,12,16,4,0,27,5,14,4,4,19,8
54001,3164,2251,360,1022,671,198,785,1118,202,146,913,138,225,264,286,775,138
54002,1815,1309,277,608,325,99,525,616,122,46,506,122,144,75,165,414,92
54003,372,310,49,163,74,24,112,158,13,27,62,10,24,14,14,47,15
54004,853,599,120,297,151,31,229,277,69,24,254,49,101,56,48,203,51
54005,1089,783,122,414,197,50,330,353,59,41,306,52,87,71,96,250,56
54006,300,222,30,108,74,10,61,119,22,20,78,20,29,12,17,55,23
54007,436,337,65,171,86,15,133,174,20,10,99,23,28,32,16,80,19
54009,810,581,106,276,158,41,205,278,61,37,229,77,87,39,26,173,56
54011,2308,1673,317,885,371,100,678,754,166,75,635,135,161,135,204,534,101
54012,264,216,37,126,39,14,95,88,16,17,48,16,19,6,7,37,11
54013,892,657,122,340,159,36,274,271,75,37,235,37,63,67,68,204,31
54014,817,622,117,312,163,30,225,320,43,34,195,58,62,46,29,139,56
54015,701,534,126,272,107,29,213,227,61,33,167,46,74,27,20,125,42
54016,8334,6273,1395,3501,1210,167,2839,2784,432,218,2061,668,679,438,276,1570,491
54017,4563,3137,716,1620,672,129,1301,1365,340,131,1426,371,457,277,321,1120,306
54020,2344,1728,368,941,316,103,731,707,213,77,616,148,246,128,94,499,117
54021,1991,1464,251,843,303,67,642,628,134,60,527,137,203,98,89,386,141
54022,6547,4164,879,2333,743,209,1858,1655,414,237,2383,1166,630,306,281,1555,828
54023,960,717,121,428,144,24,301,317,64,35,243,68,85,54,36,172,71
54024,1777,1184,197,594,305,88,433,587,118,46,593,86,186,156,165,509,84
54025,1650,1207,339,637,193,38,536,446,170,55,443,150,150,103,40,330,113
54026,565,416,93,197,110,16,165,183,34,34,149,35,56,40,18,120,29
54027,332,269,41,135,77,16,84,152,20,13,63,10,18,25,10,50,13
54028,784,561,123,276,140,22,201,262,69,29,223,55,55,58,55,189,34
54082,540,429,71,226,128,4,164,228,21,16,111,8,47,49,7,90,21
54101,821,642,109,366,142,25,263,295,44,40,179,29,57,51,42,151,28
54102,434,275,21,120,105,29,70,161,28,16,159,15,45,60,39,146,13
54103,265,168,18,78,55,17,57,89,13,9,97,5,25,32,35,94,3
54104,525,384,28,121,201,34,59,289,9,27,141,7,49,64,21,131,10
54106,1612,1235,279,620,266,70,529,573,85,48,377,83,151,71,72,290,87
54107,1374,1013,239,430,269,75,390,501,66,56,361,83,102,78,98,303,58
54110,1907,1408,246,703,376,83,568,657,108,75,499,160,126,110,103,423,76
54111,841,642,89,277,222,54,199,347,60,36,199,36,47,62,54,173,26
54112,956,675,97,336,178,64,236,330,62,47,281,51,65,95,70,259,22
54113,908,739,159,310,262,8,262,413,57,7,169,41,56,47,25,134,35
54114,2181,1497,150,632,558,157,367,888,143,99,684,63,193,247,181,602,82
54115,11218,7898,1571,4307,1600,420,3547,3308,691,352,3320,1094,929,666,631,2615,705
54119,254,173,35,66,70,2,45,113,9,6,81,5,17,39,20,65,16
54120,146,102,15,39,30,18,25,64,9,4,44,3,14,22,5,37,7
54121,1352,905,155,424,239,87,322,475,70,38,447,20,159,174,94,383,64
54123,76,61,25,26,7,3,26,20,13,2,15,6,5,4,0,13,2
54124,1450,1028,174,500,263,91,388,492,97,51,422,56,106,132,128,369,53
54125,312,206,31,74,74,27,73,118,11,4,106,19,23,43,21,93,13
54126,1222,1009,212,538,214,45,478,429,45,57,213,65,76,50,22,165,48
54127,14,11,0,5,2,4,4,7,0,0,3,0,0,3,0,3,0
54128,662,472,77,197,167,31,150,210,49,63,190,35,40,64,51,158,32
54129,1298,985,140,509,275,61,412,459,52,62,313,53,96,78,86,265,48
54130,7877,5801,1236,2977,1212,376,2563,2400,516,322,2076,541,592,418,525,1697,379
54135,1040,818,184,361,230,43,189,240,244,145,222,15,73,105,29,172,50
54136,2373,1622,374,768,387,93,678,713,142,89,751,194,189,170,198,647,104
54137,427,318,68,157,69,24,119,151,27,21,109,7,36,33,33,99,10
54138,409,286,31,90,137,28,70,189,18,9,123,14,45,41,23,108,15
54139,1201,867,157,426,212,72,334,414,70,49,334,69,122,67,76,269,65
54140,3222,2294,545,1168,446,135,906,943,327,118,928,261,251,257,159,742,186
54141,741,581,63,336,159,23,165,331,31,54,160,0,91,37,32,115,45
54143,6746,4335,768,2171,1092,304,1523,2016,507,289,2411,407,636,652,716,2115,296
54149,591,416,32,153,185,46,91,275,19,31,175,19,50,57,49,155,20
54150,259,211,45,125,35,6,67,39,70,35,48,6,20,12,10,34,14
54151,1606,1099,184,533,297,85,411,512,94,82,507,79,145,155,128,444,63
54152,103,61,25,24,8,4,27,22,11,1,42,8,23,7,4,36,6
54153,2836,2004,412,945,510,137,675,929,246,154,832,102,252,272,206,718,114
54154,2024,1365,269,672,325,99,482,620,200,63,659,150,193,145,171,548,111
54155,1340,1106,194,622,246,44,456,432,125,93,234,26,55,95,58,178,56
54156,771,538,64,252,186,36,157,326,29,26,233,29,85,79,40,206,27
54157,2096,1470,277,756,322,115,540,710,143,77,626,127,118,209,172,561,65
54159,548,418,57,182,158,21,142,236,17,23,130,17,54,32,27,103,27
54160,16,12,6,6,0,0,6,0,2,4,4,0,0,2,2,4,0
54161,1089,782,102,337,253,90,245,442,54,41,307,59,74,88,86,256,51
54162,2587,1975,466,936,423,150,836,776,208,155,612,131,188,121,172,494,118
54165,2574,1926,398,1018,422,88,819,798,219,90,648,216,133,122,177,504,144
54166,6714,4457,787,1977,1285,408,1485,2225,518,229,2257,459,531,581,686,1911,346
54169,584,485,94,240,124,27,193,255,10,27,99,34,21,22,22,76,23
54170,1365,1038,215,498,284,41,421,488,70,59,327,66,149,70,42,262,65
54171,995,815,157,537,107,14,441,323,40,11,180,22,72,51,35,134,46
54173,1203,986,182,574,213,17,460,423,64,39,217,33,131,44,9,151,66
54174,1243,872,123,380,316,53,272,464,96,40,371,59,100,96,116,312,59
54175,457,337,17,118,178,24,69,239,10,19,120,11,30,50,29,107,13
54177,1334,925,109,434,318,64,317,479,74,55,409,43,121,141,104,354,55
54180,703,535,160,257,96,22,252,187,60,36,168,66,46,28,28,138,30
54201,2354,1563,240,749,413,161,471,826,167,99,791,170,167,208,246,697,94
54202,608,410,38,164,165,43,117,259,19,15,198,29,69,65,35,171,27
54204,657,495,74,239,149,33,189,253,27,26,162,36,37,47,42,118,44
54205,789,645,110,324,156,55,271,305,36,33,144,27,43,20,54,126,18
54207,49,33,7,19,7,0,13,15,0,5,16,3,0,5,8,15,1
54208,2115,1599,279,861,354,105,662,711,141,85,516,107,150,111,148,444,72
54209,468,338,38,150,126,24,105,195,25,13,130,11,50,45,24,117,13
54210,455,328,38,114,140,36,76,219,22,11,127,6,31,52,38,114,13
54211,88,65,0,33,25,7,18,45,0,2,23,3,5,11,4,23,0
54212,518,355,30,142,167,16,83,246,20,6,163,29,53,43,38,135,28
54213,463,352,55,206,79,12,140,151,34,27,111,10,39,23,39,99,12
54214,52,39,9,17,11,2,15,16,5,3,13,8,0,5,0,13,0
54215,11,9,0,3,6,0,1,6,0,2,2,0,2,0,0,2,0
54216,2315,1656,287,757,466,146,628,773,121,134,659,118,195,160,186,595,64
54217,2273,1778,376,879,425,98,734,815,151,78,495,116,135,110,134,396,99
54220,16660,10778,1959,4989,2865,965,3760,5140,1191,687,5882,1290,1684,1354,1554,5074,808
54227,554,449,70,263,87,29,223,195,20,11,105,21,31,34,19,84,21
54228,1058,783,116,382,227,58,307,371,60,45,275,60,99,63,53,228,47
54229,1256,1037,210,584,217,26,472,492,53,20,219,62,80,54,23,152,67
54230,1694,1309,180,683,360,86,530,607,63,109,385,93,106,94,92,335,50
54232,168,111,23,54,22,12,43,45,14,9,57,15,18,18,6,44,13
54234,786,461,26,187,191,57,117,305,13,26,325,41,39,112,133,296,29
54235,7296,4855,682,2378,1401,394,1617,2451,470,317,2441,555,601,618,667,2129,312
54240,9,7,0,3,4,0,0,4,1,2,2,0,2,0,0,2,0
54241,6459,4420,808,2158,1178,276,1538,2165,498,219,2039,479,540,482,538,1745,294
54245,954,710,134,338,187,51,286,317,60,47,244,46,76,62,60,201,43
54246,281,191,10,87,76,18,57,111,15,8,90,9,20,25,36,86,4
54247,894,696,145,341,163,47,268,307,69,52,198,51,73,39,35,164,34
54301,9739,5961,1242,2881,1379,459,2079,2705,842,335,3778,1103,1175,722,778,3153,625
54302,12748,7141,2255,3135,1285,466,2301,2738,1413,689,5607,1955,1823,1064,765,4304,1303
54303,12088,6601,2055,2824,1287,435,2263,2605,1200,533,5487,1746,1757,982,1002,4386,1101
54304,12755,7977,1808,3734,1868,567,2681,3541,1086,669,4778,1642,1258,1067,811,3899,879
54311,9535,6881,1470,3873,1277,261,2913,2885,747,336,2654,1077,849,412,316,1843,811
54313,11005,9013,1396,5535,1893,189,4321,3693,679,320,1992,540,755,514,183,1512,480
54401,11977,8080,1505,3913,1998,664,2971,3938,719,452,3897,1075,1184,784,854,3213,684
54403,9628,6217,1153,3056,1459,549,2244,2781,706,486,3411,720,928,828,935,2899,512
54405,1092,745,138,328,214,65,266,371,69,39,347,75,61,80,131,300,47
54406,1266,953,164,538,200,51,411,398,101,43,313,80,88,65,80,264,49
54407,665,509,83,269,129,28,203,258,18,30,156,35,46,31,44,125,31
54408,479,375,101,166,91,17,131,174,38,32,104,28,35,24,17,82,22
54409,5497,3707,720,1704,938,345,1309,1745,407,246,1790,302,397,523,568,1535,255
54410,738,576,129,294,107,46,263,222,57,34,162,26,64,34,38,131,31
54411,1752,1423,297,674,357,95,653,589,72,109,329,58,69,91,111,294,35
54412,807,624,78,344,151,51,275,272,42,35,183,45,47,59,32,147,36
54413,84,57,11,20,18,8,25,21,4,7,27,11,5,7,4,24,3
54414,1243,960,187,469,247,57,380,413,99,68,283,54,69,83,77,246,37
54416,601,445,81,202,133,29,140,176,81,48,156,37,34,39,46,135,21
54417,29,18,1,4,10,3,0,15,1,2,11,0,3,5,3,8,3
54418,458,361,52,175,112,22,140,175,31,15,97,9,26,42,20,85,12
54420,418,337,69,166,86,16,160,138,27,12,81,22,19,25,15,65,16
54421,1169,866,150,457,190,69,404,347,62,53,303,46,77,76,104,261,42
54422,362,295,71,108,78,38,143,120,12,20,67,18,16,25,8,48,19
54423,722,562,75,296,148,43,225,290,16,31,160,39,61,32,28,108,52
54424,696,541,67,229,184,61,161,331,33,16,155,31,52,39,33,135,20
54425,701,533,108,257,125,43,219,227,57,30,168,37,61,27,43,137,31
54426,1448,1134,217,540,278,99,487,514,73,60,314,76,80,61,97,262,52
54427,400,282,41,156,59,26,121,118,23,20,118,24,39,36,19,93,25
54428,552,352,33,105,158,56,78,237,15,22,200,21,51,66,62,175,25
54430,44,38,6,14,14,4,15,17,2,4,6,1,0,4,1,6,0
54433,699,488,63,218,153,54,155,244,47,42,211,46,54,68,43,177,34
54435,893,646,92,325,196,33,216,355,46,29,247,39,90,65,53,220,27
54436,726,564,120,277,123,44,253,241,44,26,162,30,45,49,38,138,24
54437,1099,834,153,412,204,65,379,350,67,38,265,53,51,53,108,241,24
54440,1046,805,168,398,185,54,316,376,54,59,241,71,65,58,47,189,52
54441,281,229,46,146,32,5,136,76,13,4,52,14,14,13,11,42,10
54442,353,267,47,139,67,14,107,121,30,9,86,14,36,31,5,71,15
54443,840,650,98,363,146,43,259,304,46,41,190,37,61,41,51,157,33
54446,1047,786,184,317,209,76,305,366,56,59,261,59,58,66,78,236,25
54447,207,148,13,73,48,14,45,77,11,15,59,6,12,16,25,51,8
54448,1431,1106,180,541,298,87,475,513,69,49,325,84,103,56,82,280,45
54449,10637,6887,1233,3479,1634,541,2669,3266,638,314,3750,1041,1009,716,984,3220,530
54451,4411,3099,562,1553,730,254,1172,1459,301,167,1312,327,360,326,299,1114,198
54452,7586,5423,1038,2659,1350,376,1990,2500,614,319,2163,464,475,519,705,1856,307
54454,444,326,47,182,76,21,136,140,27,23,118,29,40,30,19,97,21
54455,5865,4491,919,2322,1035,215,1846,2116,361,168,1374,352,421,341,260,1096,278
54456,2519,1703,316,762,467,158,596,857,174,76,816,122,215,203,276,714,102
54457,3434,2548,442,1079,865,162,815,1355,206,172,886,154,255,298,179,755,131
54459,517,381,64,158,125,34,134,193,33,21,136,26,42,30,38,98,38
54460,882,639,141,273,143,82,247,279,67,46,243,26,61,59,97,208,35
54462,168,121,14,41,61,5,22,73,16,10,47,5,16,16,10,35,12
54463,269,187,23,70,80,14,49,102,21,15,82,21,24,23,14,73,9
54465,339,247,20,83,117,27,44,178,9,16,92,10,33,33,16,68,24
54466,1084,818,124,382,248,64,308,403,61,46,266,49,74,75,68,221,45
54467,4540,3310,736,1805,664,105,1394,1445,312,159,1230,473,371,272,114,905,325
54469,695,510,95,210,154,51,201,225,60,24,185,37,44,46,58,163,22
54470,774,532,77,268,140,47,196,263,45,28,242,31,49,79,83,220,22
54471,542,461,51,275,116,19,184,243,14,20,81,17,25,25,14,62,19
54473,884,703,136,351,174,42,315,305,44,39,181,27,44,62,48,154,27
54474,1450,1063,159,530,300,74,382,491,111,79,387,101,98,85,103,327,60
54475,589,464,79,216,139,30,180,239,22,23,125,25,45,24,31,109,16
54476,5851,4071,1030,2041,823,177,1540,1703,604,224,1780,629,515,391,245,1383,397
54479,1372,1020,193,519,240,68,398,475,87,60,352,74,99,89,90,288,64
54480,449,348,80,160,73,35,152,136,42,18,101,27,26,22,26,96,5
54481,13939,8326,1739,4082,1997,508,3095,3775,873,583,5613,2392,1262,962,997,3924,1689
54484,1633,1269,273,632,289,75,511,601,90,67,364,97,85,78,104,305,59
54485,139,96,10,26,43,17,26,59,3,8,43,3,11,23,6,41,2
54486,988,668,107,294,205,62,237,337,59,35,320,42,77,107,94,284,36
54487,4150,2909,440,1271,1031,167,943,1601,220,145,1241,173,296,417,355,1076,165
54488,409,321,75,159,62,25,161,112,22,26,88,24,32,19,13,69,19
54489,577,422,78,200,103,41,156,213,32,21,155,9,66,47,33,129,26
54490,277,196,49,76,58,13,88,75,14,19,81,17,29,9,26,66,15
54491,714,478,53,209,170,46,121,272,57,28,236,16,71,104,45,201,35
54493,304,204,19,93,79,13,72,99,14,19,100,14,23,20,43,91,9
54494,10959,7718,1302,3880,1967,569,2964,3662,695,397,3241,542,933,1068,698,2798,443
54495,3264,2134,448,979,516,191,710,1030,251,143,1130,272,329,233,296,1009,121
54498,780,598,106,284,155,53,234,268,54,42,182,25,38,62,57,162,20
54499,1150,796,138,376,202,80,282,357,101,56,354,57,110,81,106,300,54
54501,8123,5521,954,2723,1451,393,1957,2546,655,363,2602,534,755,781,532,2148,454
54511,619,454,59,222,136,37,151,239,34,30,165,24,41,50,50,142,23
54512,416,262,34,100,98,30,74,160,16,12,154,16,42,42,54,135,19
54513,248,159,19,55,60,25,46,101,2,10,89,18,18,30,23,82,7
54514,831,577,65,273,175,64,213,303,21,40,254,43,65,69,77,221,33
54515,242,161,28,81,31,21,54,78,18,11,81,8,25,19,29,77,4
54517,70,50,2,16,24,8,5,40,3,2,20,2,5,8,5,14,6
54519,432,289,30,123,118,18,77,172,16,24,143,17,43,50,33,115,28
54520,1640,1097,256,427,322,92,326,496,199,76,543,68,170,172,133,501,42
54521,3386,2322,268,1059,812,183,667,1310,182,163,1064,114,295,369,286,915,149
54524,290,189,26,87,59,17,61,103,13,12,101,13,34,34,20,89,12
54525,121,71,14,28,21,8,16,42,7,6,50,7,9,17,17,43,7
54526,333,234,45,113,55,21,85,92,20,37,99,14,24,32,29,85,14
54527,544,382,55,187,112,28,118,185,62,17,162,20,44,44,54,142,20
54529,437,329,43,152,119,15,83,210,23,13,108,23,29,43,13,85,23
54530,319,236,38,91,81,26,61,144,18,13,83,18,26,25,14,65,18
54531,632,516,35,238,200,43,134,334,22,26,116,18,40,38,20,86,30
54534,1272,756,115,346,219,76,227,382,75,72,516,72,138,137,169,462,54
54536,110,71,4,36,27,4,23,38,4,6,39,6,13,4,16,33,6
54537,225,176,40,84,42,10,86,68,13,9,49,10,14,19,6,46,3
54538,924,690,160,266,235,29,151,293,174,72,234,29,71,102,32,193,41
54539,661,458,42,192,197,27,110,288,39,21,203,39,55,62,47,168,35
54540,451,301,20,109,139,33,60,195,20,26,150,14,57,43,36,130,20
54541,592,407,81,166,120,40,133,186,65,23,185,26,51,56,52,171,14
54542,254,164,27,40,83,14,43,108,6,7,90,9,21,42,18,83,7
54543,15,12,2,7,3,0,4,6,2,0,3,0,0,0,3,3,0
54545,408,292,22,99,144,27,52,227,8,5,116,9,32,34,41,102,14
54546,620,403,59,185,120,39,138,221,25,19,217,33,66,69,49,194,23
54547,849,534,50,206,232,46,125,342,35,32,315,31,85,119,80,270,45
54548,2406,1600,111,643,672,174,410,1012,96,82,806,109,314,235,148,714,92
54550,326,209,44,94,51,20,70,103,23,13,117,17,40,20,40,97,20
54552,2098,1358,179,620,425,134,390,706,156,106,740,100,179,237,224,647,93
54554,531,387,32,168,135,52,104,234,25,24,144,10,38,61,35,125,19
54555,2280,1524,230,737,416,141,513,760,155,96,756,135,182,213,226,647,109
54556,566,365,52,179,108,26,118,185,44,18,201,31,48,57,65,179,22
54557,406,294,21,96,137,40,53,208,16,17,112,3,38,45,26,88,24
54558,867,625,80,206,272,67,140,433,34,18,242,36,47,97,62,215,27
54559,277,227,49,108,50,20,58,100,50,19,50,6,15,18,11,45,5
54560,290,185,26,82,59,18,53,106,15,11,105,14,35,33,23,96,9
54561,46,38,0,14,19,5,5,33,0,0,8,0,3,3,2,8,0
54562,902,589,39,188,280,82,116,384,33,56,313,71,81,96,65,256,57
54563,281,216,32,117,48,19,81,106,12,17,65,18,14,14,19,54,11
54564,192,115,11,44,48,12,32,75,5,3,77,2,23,34,18,64,13
54565,23,9,2,2,5,0,4,5,0,0,14,2,2,7,3,12,2
54566,649,469,76,197,167,29,118,246,77,28,180,25,49,70,36,162,18
54568,2094,1387,198,551,475,163,367,813,108,99,707,80,236,222,169,609,98
54601,19248,10059,2194,4432,2602,831,3425,4744,1123,767,9189,3795,2115,1592,1687,6634,2555
54603,6322,3711,953,1661,910,187,1177,1547,658,329,2611,753,850,565,443,2027,584
54610,750,530,58,237,174,61,164,299,26,41,220,49,70,68,33,180,40
54611,447,317,67,166,57,27,141,125,39,12,130,39,19,41,31,108,22
54612,1785,1173,249,526,317,81,436,484,156,97,612,170,157,156,129,515,97
54613,789,547,42,208,236,61,107,364,31,45,242,24,65,99,54,207,35
54614,921,722,145,348,147,82,302,317,50,53,199,45,52,41,61,161,38
54615,3720,2459,472,1119,635,233,855,1155,292,157,1261,240,338,374,309,1070,191
54616,962,651,124,263,186,78,237,334,47,33,311,51,76,51,133,266,45
54618,846,625,132,282,169,42,263,294,50,18,221,31,62,80,48,185,36
54619,1319,1009,227,466,246,70,457,403,90,59,310,52,66,98,94,275,35
54621,378,276,56,141,62,17,118,132,11,15,102,27,26,25,24,90,12
54622,986,698,121,315,205,57,250,371,47,30,288,50,98,68,72,259,29
54623,590,431,66,198,141,26,147,235,35,14,159,21,34,47,57,129,30
54624,614,441,59,206,143,33,141,252,29,19,173,22,53,53,45,143,30
54625,109,81,19,35,21,6,35,34,9,3,28,7,12,3,6,24,4
54626,353,260,50,95,91,24,92,118,9,41,93,17,29,30,17,85,8
54627,771,534,84,258,147,45,207,253,45,29,237,47,60,63,67,194,43
54628,483,344,34,165,118,27,92,209,21,22,139,10,36,44,49,124,15
54629,1056,720,133,332,197,58,290,353,33,44,336,74,107,95,60,293,43
54630,1404,950,145,510,226,69,344,419,102,85,454,88,128,119,119,399,55
54631,696,477,64,237,147,29,156,241,47,33,219,30,47,95,47,194,25
54632,476,345,53,162,107,23,134,168,29,14,131,21,33,43,34,106,25
54634,1406,1009,185,443,268,113,382,486,59,82,397,53,96,125,123,356,41
54635,635,469,83,209,134,43,149,255,29,36,166,35,49,43,39,139,27
54636,3578,2880,695,1537,550,98,1275,1177,307,121,698,184,266,140,108,549,149
54637,19,6,0,3,1,2,2,4,0,0,13,0,0,10,3,9,4
54638,558,420,67,183,130,40,173,201,18,28,138,13,44,50,31,119,19
54639,818,583,80,304,162,37,218,274,58,33,235,24,63,86,62,210,25
54640,33,22,3,7,12,0,3,12,2,5,11,0,5,4,2,9,2
54642,709,516,64,266,138,48,191,233,39,53,193,25,49,59,60,156,37
54644,458,341,75,179,77,10,142,149,33,17,117,32,32,21,32,91,26
54645,26,13,0,7,4,2,5,4,2,2,13,3,3,0,7,10,3
54646,1388,999,198,411,292,98,339,475,114,71,389,42,124,139,84,338,51
54648,553,422,98,199,100,25,153,180,51,38,131,14,37,38,42,113,18
54650,7784,5542,1143,2858,1265,276,2193,2407,616,326,2242,769,764,452,257,1715,527
54651,448,296,59,142,73,22,113,120,32,31,152,13,41,48,50,132,20
54652,338,222,36,93,75,18,74,118,19,11,116,21,18,31,46,96,20
54653,327,247,53,141,37,16,103,114,20,10,80,21,18,29,12,71,9
54654,102,92,12,36,34,10,36,47,5,4,10,2,4,2,2,8,2
54655,673,495,62,231,152,50,149,254,57,35,178,36,64,40,38,152,26
54656,6088,4217,865,2000,1070,282,1482,1965,507,263,1871,338,572,515,446,1541,330
54657,151,124,14,59,42,9,51,63,10,0,27,4,7,7,9,22,5
54658,1057,788,117,448,191,32,324,386,43,35,269,47,76,88,58,226,43
54659,444,342,66,160,90,26,127,149,50,16,102,20,39,24,19,76,26
54660,5540,3772,845,1865,824,238,1417,1640,514,201,1768,238,564,497,469,1520,248
54661,1147,785,147,399,198,41,306,375,70,34,362,52,134,116,60,294,68
54664,620,441,56,196,134,55,124,236,45,36,179,26,65,50,38,151,28
54665,3284,2108,379,967,548,214,757,996,209,146,1176,181,280,386,329,1035,141
54666,974,730,122,376,200,32,294,341,52,43,244,45,106,62,31,187,57
54667,1437,1037,187,491,267,92,395,476,105,61,400,58,99,113,130,364,36
54669,2742,2124,497,1091,428,108,974,829,223,98,618,135,205,162,116,510,108
54670,510,394,100,174,94,26,183,153,24,34,116,10,41,28,37,104,12
54701,13575,8099,1630,3925,1915,629,3135,3585,793,586,5476,2185,1163,954,1174,4163,1313
54703,15452,9476,2216,4625,2003,632,3490,4223,1227,536,5976,2739,1525,1028,684,3868,2108
54720,3030,1903,395,946,438,124,791,765,251,96,1127,341,268,231,287,911,216
54721,544,385,64,193,102,26,156,172,31,26,159,23,60,32,44,125,34
54722,1395,1014,194,471,278,71,387,466,106,55,381,60,98,106,117,330,51
54723,463,337,61,178,79,19,134,158,30,15,126,40,38,36,12,86,40
54724,2630,1883,318,941,470,154,710,955,129,89,747,137,201,217,192,643,104
54725,1087,791,155,350,217,69,279,373,94,45,296,62,79,87,68,236,60
54726,645,478,93,231,117,37,203,207,32,36,167,44,25,46,52,130,37
54727,1652,1262,214,647,303,98,447,595,150,70,390,94,90,94,112,324,66
54728,2417,1716,247,774,531,164,538,953,139,86,701,97,209,168,227,602,99
54729,11046,7489,1475,3630,1842,542,2790,3256,895,548,3557,820,1180,830,727,2916,641
54730,1784,1327,244,679,314,90,525,636,107,59,457,103,137,122,95,377,80
54731,275,196,41,92,53,10,82,90,11,13,79,4,28,23,24,65,14
54732,1086,767,152,355,187,73,305,328,81,53,319,47,85,94,93,283,36
54733,498,372,69,182,87,34,143,164,40,25,126,24,29,32,41,106,20
54734,304,225,32,118,51,24,94,108,11,12,79,15,23,28,13,53,26
54736,1518,1062,168,549,268,77,458,462,99,43,456,93,99,92,172,404,52
54737,168,126,24,47,45,10,42,66,6,12,42,6,9,17,10,29,13
54738,1041,784,137,396,210,41,304,372,63,45,257,67,64,63,63,217,40
54739,1381,1136,244,610,231,51,472,488,126,50,245,69,93,56,27,166,79
54740,809,568,110,255,161,42,220,270,64,14,241,34,76,54,77,216,25
54741,544,387,84,167,107,29,139,178,36,34,157,18,46,50,43,133,24
54742,1504,1183,213,613,302,55,447,622,60,54,321,24,131,94,72,286,35
54745,856,614,88,267,215,44,191,345,36,42,242,29,79,93,41,207,35
54746,253,189,34,93,49,13,62,105,11,11,64,14,27,12,11,52,12
54747,1007,622,110,290,145,77,227,284,57,54,385,78,97,98,112,328,57
54748,461,360,67,165,102,26,127,196,27,10,101,17,37,28,19,77,24
54749,382,272,63,133,58,18,119,118,23,12,110,24,30,30,26,94,16
54750,385,304,59,146,70,29,125,151,19,9,81,19,31,20,11,63,18
54751,8254,4853,1070,2365,1116,302,1861,2100,554,338,3401,1736,679,457,529,2224,1177
54754,599,386,62,155,132,37,93,224,48,21,213,26,64,77,46,186,27
54755,2709,1908,393,919,461,135,729,874,179,126,801,135,228,215,223,685,116
54756,420,279,52,124,80,23,101,140,26,12,141,37,37,40,27,118,23
54757,1153,819,124,387,257,51,278,409,82,50,334,38,120,100,76,263,71
54758,1736,1233,223,577,336,97,418,627,123,65,503,92,130,139,142,412,91
54759,644,437,47,202,124,64,134,248,22,33,207,42,43,66,56,188,19
54760,21,4,2,2,0,0,2,2,0,0,17,0,0,7,10,17,0
54761,436,309,31,156,71,51,108,155,25,21,127,23,30,48,26,108,19
54762,492,350,66,182,75,27,131,159,32,28,142,14,42,51,35,107,35
54763,410,282,40,154,65,23,104,144,20,14,128,13,42,30,43,117,11
54766,537,392,57,204,101,30,164,166,35,27,145,21,32,48,44,131,14
54767,1015,731,142,369,156,64,306,312,65,48,284,49,90,70,75,229,55
54768,1543,1052,200,506,236,110,424,438,121,69,491,62,139,138,152,443,48
54769,142,97,7,57,31,2,31,56,4,6,45,8,14,18,5,28,17
54770,790,566,91,277,139,59,191,265,60,50,224,35,51,59,79,201,23
54771,1416,994,199,452,237,106,428,410,83,73,422,62,111,83,166,374,48
54772,381,259,52,132,58,17,113,101,27,18,122,17,56,32,17,105,17
54773,1351,922,188,410,267,57,336,443,93,50,429,65,135,97,132,366,63
54801,2705,1825,258,828,532,207,589,983,147,106,880,118,212,295,255,770,110
54805,574,411,81,196,106,28,125,192,57,37,163,28,47,48,40,137,26
54806,4620,2882,548,1438,654,242,1015,1216,376,275,1738,440,419,415,464,1449,289
54810,1047,704,92,297,238,77,180,408,68,48,343,61,104,113,65,296,47
54812,2129,1470,311,661,389,109,472,671,202,125,659,128,162,171,198,548,111
54813,247,187,9,120,51,7,72,94,9,12,60,8,27,10,15,48,12
54814,954,676,129,315,201,31,190,273,140,73,278,43,110,93,32,226,52
54817,891,637,72,258,265,42,153,383,63,38,254,20,97,91,46,212,42
54819,1120,759,116,327,223,93,227,428,62,42,361,39,88,136,98,310,51
54820,320,223,29,130,48,16,104,90,20,9,97,24,24,29,20,84,13
54821,653,423,50,184,142,47,89,264,47,23,230,35,87,75,33,183,47
54822,1541,1123,256,536,274,57,421,534,118,50,418,70,132,128,88,345,73
54824,835,600,121,295,138,46,242,248,77,33,235,49,94,55,37,199,36
54826,329,243,44,94,84,21,75,135,17,16,86,12,26,24,24,68,18
54827,104,62,6,27,27,2,10,39,10,3,42,4,16,14,8,36,6
54828,315,226,32,99,81,14,48,120,31,27,89,7,17,39,26,76,13
54829,2185,1522,245,702,420,155,491,738,177,116,663,75,214,186,188,561,102
54830,1298,874,63,269,466,76,138,633,56,47,424,35,148,171,70,363,61
54832,183,128,16,60,44,8,36,80,12,0,55,2,13,22,18,50,5
54834,10,10,0,4,6,0,0,8,2,0,0,0,0,0,0,0,0
54835,411,286,30,126,104,26,74,169,18,25,125,16,38,35,36,112,13
54836,426,330,56,159,107,8,128,169,25,8,96,10,39,27,20,76,20
54837,1632,1098,123,566,298,111,347,578,101,72,534,65,151,154,164,483,51
54838,466,296,37,123,117,19,60,198,28,10,170,14,48,72,36,146,24
54839,135,73,20,23,26,4,26,29,11,7,62,10,19,21,12,48,14
54840,1796,1221,207,577,350,87,421,601,130,69,575,119,184,144,128,464,111
54841,10,4,2,0,0,2,0,2,2,0,6,2,2,0,2,4,2
54842,0,0,0,0,0,0,0,0,0,0,0,0,0,0,0,0,0
54843,4376,3032,480,1375,984,193,868,1530,453,181,1344,191,456,427,270,1124,220
54844,85,50,5,10,28,7,7,29,4,10,35,4,15,11,5,24,11
54845,42,28,4,12,12,0,2,18,3,5,14,2,2,6,4,12,2
54846,196,152,30,67,41,14,43,75,15,19,44,5,10,10,19,38,6
54847,915,610,78,279,208,45,158,342,64,46,305,39,84,96,86,264,41
54848,2611,1718,303,821,440,154,623,778,169,148,893,248,204,230,211,754,139
54849,794,592,68,300,183,41,183,340,46,23,202,23,71,60,48,180,22
54850,122,73,2,38,32,1,24,41,8,0,49,10,15,13,11,43,6
54853,1487,1069,153,520,306,90,358,537,114,60,418,70,145,107,96,350,68
54854,363,265,41,133,71,20,81,144,26,14,98,13,29,34,22,84,14
54855,259,187,52,76,41,18,83,77,17,10,72,16,23,24,9,67,5
54856,597,447,55,220,139,33,158,241,28,20,150,24,39,50,37,140,10
54857,53,31,8,11,2,10,6,18,7,0,22,6,6,4,6,16,6
54858,633,380,67,158,117,38,105,185,53,37,253,41,56,91,65,220,33
54859,836,574,98,229,205,42,157,326,45,46,262,24,75,123,40,223,39
54861,110,76,12,47,13,4,10,5,40,21,34,0,12,19,3,30,4
54862,105,87,10,36,31,10,28,47,2,10,18,0,0,16,2,15,3
54864,469,340,50,179,87,24,142,162,16,20,129,14,43,48,24,115,14
54865,248,165,15,87,54,9,33,98,27,7,83,9,26,14,34,75,8
54867,219,117,17,44,48,8,34,66,11,6,102,17,34,26,25,80,22
54868,6287,4249,906,1981,1014,348,1637,1956,437,219,2038,465,515,583,475,1722,316
54870,687,498,51,213,184,50,140,297,35,26,189,32,51,66,40,155,34
54871,1152,812,141,355,248,68,262,434,76,40,340,55,82,87,116,284,56
54872,1169,750,112,300,271,67,215,409,80,46,419,55,129,141,94,353,66
54873,1049,740,92,313,281,54,205,438,59,38,309,35,94,114,66,264,45
54874,1212,958,148,519,239,52,374,446,73,65,254,37,100,79,38,199,55
54875,440,332,50,128,135,19,99,177,20,36,108,12,44,27,25,94,14
54876,666,452,70,153,172,57,99,265,39,49,214,25,73,60,56,182,32
54880,12853,7704,1675,3679,1684,666,2407,3417,1264,616,5149,1301,1505,1258,1085,4184,965
54888,573,414,43,201,149,21,125,241,33,15,159,15,57,49,38,133,26
54889,1098,761,135,342,224,60,254,366,87,54,337,47,124,63,103,303,34
54891,1480,990,100,565,252,73,351,454,140,45,490,64,201,108,117,427,63
54893,1611,1074,139,442,397,96,269,600,132,73,537,56,156,181,144,455,82
54895,469,330,51,140,108,31,88,167,30,45,139,20,33,42,44,123,16
54896,671,458,52,196,160,50,122,255,54,27,213,6,59,85,63,185,28
54901,12975,7021,1671,3360,1516,474,2583,2957,973,508,5954,2356,1679,1070,849,4177,1777
54902,9840,6017,1297,2586,1590,544,1930,2931,654,502,3823,1022,984,762,1055,3217,606
54904,6812,5180,913,2825,1223,219,2171,2430,407,172,1632,483,525,408,216,1274,358
54909,819,594,114,317,134,29,231,284,54,25,225,51,61,68,45,179,46
54911,11099,6775,1509,3262,1494,510,2582,2987,863,343,4324,1206,1317,797,1004,3678,646
54913,3411,2800,368,1662,668,102,1422,1224,103,51,611,267,175,96,73,479,132
54914,12662,7958,1728,4144,1642,444,3281,3342,784,551,4704,2009,1219,836,640,3613,1091
54915,14034,10099,2461,5323,1933,382,4690,4048,941,420,3935,1168,1459,723,585,3151,784
54921,488,357,44,183,102,28,140,167,20,30,131,23,52,34,22,113,18
54922,549,435,97,201,108,29,153,196,43,43,114,32,33,24,25,81,33
54923,3372,2418,398,1205,622,193,867,1170,210,171,954,174,259,234,287,864,90
54927,125,104,37,39,24,4,53,46,0,5,21,4,3,10,4,18,3
54928,146,114,19,47,37,11,31,69,7,7,32,4,6,11,11,27,5
54929,3672,2569,485,1184,653,247,898,1189,288,194,1103,176,259,310,358,970,133
54930,644,478,82,178,186,32,138,280,26,34,166,17,47,51,51,140,26
54932,331,283,38,153,80,12,117,137,15,14,48,4,23,14,7,38,10
54933,67,56,7,27,20,2,18,31,2,5,11,2,2,7,0,9,2
54934,41,24,6,11,2,5,8,15,0,1,17,7,4,6,0,14,3
54935,18639,12283,2605,5991,2799,888,4486,5526,1487,784,6356,1795,1852,1356,1353,5280,1076
54937,3836,2682,560,1297,674,151,1012,1264,242,164,1154,217,380,323,234,948,206
54940,1647,1258,158,643,347,110,405,725,75,53,389,35,119,133,102,313,76
54941,1265,826,96,397,242,91,257,494,40,35,439,72,126,144,97,379,60
54942,1612,1348,330,784,209,25,733,525,76,14,264,101,99,16,48,192,72
54943,770,544,64,245,201,34,147,315,49,33,226,30,59,82,55,180,46
54944,2607,2121,396,1117,512,96,937,987,115,82,486,115,164,122,85,403,83
54945,1422,980,143,440,302,95,339,501,82,58,442,71,126,130,115,383,59
54947,971,727,102,367,224,34,257,393,44,33,244,34,101,45,64,191,53
54948,136,101,3,36,46,16,31,61,2,7,35,10,12,9,4,26,9
54949,1339,982,163,501,259,59,395,461,65,61,357,64,88,85,120,304,53
54950,1184,814,128,386,206,94,304,393,59,58,370,64,103,101,102,320,50
54952,9523,6076,1341,2940,1437,358,2193,2668,791,424,3447,1131,1005,704,607,2824,623
54956,14662,10472,2126,5429,2368,549,4193,4521,1175,583,4190,1105,1446,844,795,3396,794
54960,1151,830,89,317,350,74,193,547,57,33,321,42,98,106,75,269,52
54961,5264,3744,817,1848,845,234,1558,1653,317,216,1520,350,546,293,331,1295,225
54962,437,323,44,173,90,16,95,184,26,18,114,16,38,30,30,101,13
54963,2378,1752,301,862,465,124,662,880,127,83,626,103,193,184,146,532,94
54964,361,295,40,158,84,13,115,154,13,13,66,8,22,16,20,54,12
54965,499,372,57,170,114,31,115,218,15,24,127,10,44,42,31,112,15
54966,771,559,104,257,159,39,204,242,64,49,212,23,67,68,54,184,28
54967,150,101,11,41,32,17,23,61,10,7,49,10,16,13,10,41,8
54968,1216,813,110,373,251,79,275,425,55,58,403,46,96,129,132,354,49
54970,1186,810,112,382,242,74,230,459,86,35,376,49,97,134,96,319,57
54971,4045,2658,462,1294,719,183,1042,1259,196,161,1387,269,327,362,429,1180,207
54974,548,437,80,234,100,23,197,199,18,23,111,34,20,34,23,85,26
54976,17,15,0,9,4,2,6,6,3,0,2,0,0,2,0,2,0
54977,481,355,38,166,120,31,132,194,22,7,126,14,43,42,27,99,27
54978,15,15,0,13,1,1,7,8,0,0,0,0,0,0,0,0,0
54979,477,380,41,205,116,18,161,189,7,23,97,29,23,18,27,80,17
54980,69,42,6,21,12,3,15,25,2,0,27,1,15,5,6,21,6
54981,5745,3973,713,1926,1026,308,1355,1927,449,242,1772,337,485,458,492,1495,277
54982,2830,1887,288,785,644,170,551,1034,193,109,943,135,287,285,236,798,145
54983,1654,1193,225,618,283,67,513,519,87,74,461,100,151,115,95,361,100
54984,1313,914,108,380,325,101,253,518,86,57,399,39,120,145,95,349,50
54985,0,0,0,0,0,0,0,0,0,0,0,0,0,0,0,0,0
54986,1753,1333,144,748,388,53,502,667,98,66,420,45,126,133,116,337,83
55001,931,779,35,486,224,34,312,377,38,52,152,7,75,45,25,118,34
55003,764,489,74,224,141,50,148,227,66,48,275,54,86,41,94,238,37
55005,1272,1083,277,605,179,22,550,345,125,63,189,42,91,43,13,155,34
55006,1244,898,191,430,203,74,314,414,121,49,346,62,93,105,86,290,56
55007,780,600,111,299,163,27,204,272,75,49,180,35,72,52,21,142,38
55008,4566,3257,626,1665,724,242,1263,1418,416,160,1309,214,368,347,380,1111,198
55009,2967,2165,350,1142,550,123,869,985,185,126,802,161,222,227,192,675,127
55010,10,8,4,4,0,0,8,0,0,0,2,0,2,0,0,2,0
55011,2876,2345,378,1526,408,33,1055,922,189,179,531,163,268,66,34,372,159
55012,513,426,53,231,101,41,147,223,34,22,87,18,50,9,10,75,12
55013,1829,1244,276,655,236,77,537,475,161,71,585,92,175,114,204,464,121
55014,8269,6641,1291,4260,978,112,3648,2047,643,303,1628,426,774,287,141,1244,384
55016,9711,8374,2098,4585,1586,105,4112,3194,720,348,1337,360,578,293,106,1058,279
55017,249,195,38,101,41,15,97,74,14,10,54,3,23,12,16,35,19
55018,313,261,22,162,59,18,101,121,22,17,52,13,17,18,4,46,6
55019,382,286,46,174,52,14,137,119,14,16,96,23,35,20,18,72,24
55020,783,670,134,403,118,15,350,246,30,44,113,26,50,26,11,81,32
55021,9839,6804,1478,3281,1621,424,2581,2912,881,430,3035,567,985,777,706,2521,514
55024,7030,5759,2086,2900,674,99,3138,1830,541,250,1271,315,476,216,264,992,279
55025,7234,5485,919,3027,1305,234,2211,2549,444,281,1749,372,693,358,326,1411,338
55026,151,104,13,60,31,0,40,49,10,5,47,9,14,10,14,45,2
55027,941,697,140,337,177,43,323,297,39,38,244,59,73,66,46,203,41
55030,436,337,62,127,136,12,106,196,30,5,99,18,44,28,9,86,13
55031,589,490,86,280,108,16,240,207,31,12,99,27,41,21,10,69,30
55032,1063,829,133,467,193,36,356,367,60,46,234,68,93,48,25,169,65
55033,9183,6898,1232,3724,1634,308,2859,2956,703,380,2285,537,753,587,408,1800,485
55036,64,44,8,26,6,4,14,16,9,5,20,4,13,3,0,9,11
55037,1716,1194,222,629,287,56,431,509,182,72,522,98,163,158,103,445,77
55038,3557,2965,763,1723,398,81,1641,1055,186,83,592,180,243,118,51,424,168
55040,3218,2523,540,1340,581,62,1046,1025,314,138,695,172,292,164,67,533,162
55041,2980,2132,370,999,587,176,742,1058,203,129,848,181,205,200,262,731,117
55042,2551,2150,210,1374,517,49,967,921,180,82,401,78,199,103,21,308,93
55043,1509,1156,166,655,285,50,468,554,89,45,353,35,195,76,47,276,77
55044,11029,9440,2001,6102,1178,159,5513,3037,740,150,1589,406,699,351,133,1175,414
55045,1967,1492,298,666,408,120,553,763,145,31,475,91,158,114,112,411,64
55046,1025,788,171,405,177,35,337,347,60,44,237,69,70,51,47,193,44
55047,943,739,28,434,236,41,303,375,22,39,204,19,103,51,31,170,34
55049,820,602,159,269,150,24,221,277,75,29,218,66,63,40,49,169,49
55051,3592,2524,410,1265,651,198,878,1188,320,138,1068,180,252,346,290,936,132
55052,761,589,97,277,171,44,213,287,53,36,172,29,44,53,46,146,26
55053,241,199,38,110,39,12,108,77,5,9,42,5,6,22,9,36,6
55055,1433,999,226,558,163,52,394,348,175,82,434,106,129,100,99,343,91
55056,3826,2996,783,1484,587,142,1335,1171,302,188,830,159,279,221,171,641,189
55057,6555,4666,806,2647,978,235,2035,1944,503,184,1889,570,543,446,330,1506,383
55060,10057,7057,1528,3441,1604,484,2858,3068,791,340,3000,706,954,699,641,2508,492
55063,3148,2174,382,1023,601,168,706,1031,278,159,974,203,219,298,254,789,185
55065,323,248,43,137,56,12,109,117,12,10,75,13,38,15,9,57,18
55066,7374,4871,877,2480,1120,394,1827,2269,544,231,2503,584,640,688,591,2098,405
55068,6650,5556,1328,3370,732,126,2870,1800,593,293,1094,276,453,228,137,871,223
55069,1634,1182,235,568,318,61,405,531,175,71,452,71,161,111,109,356,96
55070,1887,1483,530,710,224,19,679,499,239,66,404,129,173,61,41,250,154
55071,1920,1405,285,710,316,94,508,558,233,106,515,96,217,157,45,407,108
55072,1220,818,141,418,211,48,265,412,104,37,402,58,156,122,66,338,64
55073,963,807,74,536,197,0,294,446,44,23,156,7,55,53,41,114,42
55074,294,237,43,117,63,14,97,90,35,15,57,12,27,15,3,51,6
55075,8085,5342,1165,2681,1119,377,1959,2039,786,558,2743,634,925,588,596,2321,422
55076,6965,5072,1150,2783,982,157,1964,2095,718,295,1893,453,827,435,178,1535,358
55077,4087,2665,660,1401,468,136,1053,1061,411,140,1422,650,513,203,56,889,533
55079,2388,1965,380,1156,395,34,833,788,197,147,423,109,179,79,56,309,114
55080,799,611,82,324,170,35,224,296,60,31,188,51,81,34,22,132,56
55082,11085,8426,997,5080,2012,337,3490,3747,808,381,2659,549,866,690,554,2287,372
55084,541,383,78,178,91,36,131,179,46,27,158,33,48,32,45,123,35
55085,90,61,3,34,13,11,26,32,0,3,29,2,8,8,11,23,6
55087,82,73,25,38,10,0,35,30,2,6,9,2,4,3,0,7,2
55088,547,461,31,278,120,32,193,216,22,30,86,5,60,21,0,55,31
55089,599,477,56,280,114,27,208,215,23,31,122,16,55,27,24,93,29
55090,157,111,23,51,28,9,29,52,22,8,46,6,26,12,2,36,10
55092,3176,2638,592,1452,520,74,1224,1020,283,111,538,78,259,108,93,440,98
55101,8359,4085,1619,1741,567,158,1385,1070,1167,463,4274,1326,1569,877,502,3631,643
55102,8666,3104,849,1552,550,153,840,1061,727,476,5562,1987,1996,1039,540,4618,944
55103,5132,2992,1114,1289,457,132,1063,795,752,382,2140,698,797,367,278,1849,291
55104,17677,9470,2586,4856,1589,439,3219,2762,1981,1508,8207,3405,2811,1194,797,6085,2122
55105,11274,5659,1112,3083,1055,409,2297,2334,505,523,5615,2356,1732,912,615,4331,1284
55106,18648,12240,3970,5677,1953,640,4730,3400,2606,1504,6408,1484,2646,1292,986,5122,1286
55107,5583,3553,1147,1584,646,176,1327,1112,654,460,2030,395,831,366,438,1598,432
55108,6335,3327,998,1679,433,217,1341,1376,327,283,3008,1428,777,420,383,2153,855
55109,11998,7917,1726,3694,1905,592,3044,3382,848,643,4081,933,1289,908,951,3360,721
55110,14906,11141,1837,6072,2530,702,4620,4778,1036,707,3765,741,1210,1109,705,3093,672
55112,16882,11482,2366,5515,3111,490,4067,5252,1358,805,5400,1678,1651,1324,747,4131,1269
55113,17245,10024,1577,4462,2899,1086,3035,5316,838,835,7221,2075,1988,1620,1538,5955,1266
55114,705,254,73,130,36,15,81,99,42,32,451,186,174,52,39,367,84
55115,3055,2410,245,1564,540,61,1272,843,232,63,645,85,197,208,155,517,128
55116,10854,5469,1079,2621,1131,638,1954,2588,480,447,5385,1633,1417,1053,1282,4429,956
55117,15650,9456,2682,4359,1745,670,3069,3358,1937,1092,6194,1889,2134,1238,933,4873,1321
55118,11690,7257,1132,3338,2024,763,2339,3572,792,554,4433,850,1335,1059,1189,3798,635
55119,15153,9645,2492,4496,2027,630,3109,3741,1825,970,5508,1520,1990,1188,810,4421,1087
55120,1673,1236,132,757,261,86,610,487,75,64,437,82,142,134,79,377,60
55121,3353,1850,527,966,297,60,732,769,260,89,1503,667,584,211,41,1018,485
55122,11432,7286,1785,3910,1401,190,3119,2875,844,448,4146,1654,1677,621,194,3196,950
55123,9064,7314,1470,5024,776,44,4415,2098,550,251,1750,652,741,262,95,1342,408
55124,16684,12753,2324,7780,2358,291,6027,4857,1163,706,3931,1217,1426,862,426,3160,771
55125,14472,10911,2662,6256,1739,254,5411,4198,848,454,3561,1081,1471,755,254,2793,768
55126,9914,7016,902,4109,1714,291,2862,3074,664,416,2898,559,1081,853,405,2410,488
55127,6401,4754,657,2750,1155,192,2161,2018,340,235,1647,236,788,472,151,1355,292
55128,10498,7304,1594,4019,1370,321,3111,2795,973,425,3194,760,1280,762,392,2675,519
55129,2219,1790,345,1077,326,42,961,718,62,49,429,180,118,90,41,342,87
55150,52,23,1,13,8,1,9,10,2,2,29,8,13,4,4,17,12
55301,1415,1120,465,475,125,55,525,377,186,32,295,93,98,47,57,223,72
55302,2597,1854,319,874,515,146,685,879,182,108,743,144,198,212,189,615,128
55303,14999,11250,2870,5972,2152,256,4975,4477,1223,575,3749,1075,1442,562,670,2981,768
55304,12222,10626,2125,6646,1754,101,5745,3950,595,336,1596,424,695,305,172,1149,447
55305,8794,5002,770,2566,1181,485,1730,2442,460,370,3792,1159,1008,831,794,3023,769
55306,5751,3838,1118,1892,745,83,1554,1483,497,304,1913,715,799,339,60,1336,577
55307,1415,1011,228,448,234,101,401,451,92,67,404,76,75,117,136,369,35
55308,2042,1707,462,952,254,39,893,549,190,75,335,145,127,46,17,219,116
55309,4060,3286,1049,1745,434,58,1689,1147,318,132,774,310,282,96,86,513,261
55310,721,467,55,222,136,54,188,215,33,31,254,38,67,63,86,227,27
55311,6625,5571,1001,3713,788,69,3108,1931,317,215,1054,397,434,171,52,815,239
55312,620,448,65,217,126,40,171,225,31,21,172,28,38,44,62,157,15
55313,6312,4768,1058,2461,1051,198,2101,1957,472,238,1544,423,520,330,271,1238,306
55314,525,380,66,168,97,49,139,186,37,18,145,32,37,33,43,132,13
55315,842,674,120,404,132,18,303,288,53,30,168,46,86,18,18,119,49
55316,7479,5986,1309,3850,716,111,3175,1869,617,325,1493,423,655,318,97,1066,427
55317,5877,4630,839,3066,633,92,2633,1522,321,154,1247,433,479,239,96,993,254
55318,6742,5053,1252,2961,722,118,2630,1630,538,255,1689,472,669,330,218,1363,326
55319,1491,1216,261,637,273,45,588,533,56,39,275,59,107,67,42,220,55
55320,1273,1009,204,545,227,33,436,454,80,39,264,81,100,45,38,179,85
55321,1659,1201,277,600,231,93,591,442,95,73,458,70,125,111,152,395,63
55322,923,716,155,355,174,32,314,318,34,50,207,62,62,49,34,145,62
55324,476,362,46,189,109,18,120,198,34,10,114,22,36,32,24,98,16
55325,1542,1160,191,580,320,69,484,578,70,28,382,74,98,96,114,340,42
55327,1137,1021,142,668,182,29,487,423,57,54,116,29,57,30,0,78,38
55328,2453,1974,316,1133,447,78,930,760,154,130,479,141,127,132,79,386,93
55329,721,513,103,266,105,39,197,223,57,36,208,40,44,57,67,185,23
55330,8888,7062,1506,4090,1285,181,3481,2672,570,339,1826,487,626,415,298,1327,499
55331,6436,4914,443,3109,1176,186,2269,2067,363,215,1522,371,572,396,183,1242,280
55332,832,547,85,230,173,59,206,277,46,18,285,61,59,62,103,262,23
55333,349,243,30,120,62,31,80,131,24,8,106,18,28,21,39,95,11
55334,1153,792,191,330,198,73,289,392,83,28,361,59,73,88,141,307,54
55335,695,492,80,210,156,46,186,245,38,23,203,32,62,49,60,179,24
55336,3024,2175,454,1016,532,173,908,988,175,104,849,186,193,192,278,701,148
55337,17864,11898,2835,6107,2632,324,4696,5017,1505,680,5966,2127,2002,1390,447,4428,1538
55338,348,265,42,131,75,17,114,125,13,13,83,18,22,22,21,64,19
55339,358,282,46,123,97,16,107,147,14,14,76,26,19,18,13,69,7
55340,1886,1594,230,1026,315,23,753,646,130,65,292,49,172,50,21,209,83
55341,333,275,53,181,34,7,161,95,13,6,58,20,25,6,7,45,13
55342,897,619,90,287,182,60,229,298,48,44,278,39,63,67,109,253,25
55343,11649,5896,1483,2725,1177,511,1865,2565,862,604,5753,1954,1920,1038,841,4608,1145
55344,6020,3194,1080,1540,477,97,1090,1349,530,225,2826,1276,967,396,187,2091,735
55345,8341,6390,629,3756,1676,329,2709,3020,420,241,1951,412,626,576,337,1614,337
55346,6182,4908,771,3166,898,73,2595,1772,399,142,1274,279,635,261,99,1042,232
55347,8279,6534,959,4465,1039,71,3890,2063,347,234,1745,526,847,257,115,1402,343
55349,1368,1007,201,486,261,59,416,445,87,59,361,69,110,81,101,308,53
55350,6821,4670,1084,2248,1038,300,1877,2087,480,226,2151,673,559,386,533,1796,355
55352,2154,1662,426,889,287,60,745,566,223,128,492,68,225,107,92,405,87
55353,983,750,140,373,186,51,295,345,67,43,233,49,71,51,62,196,37
55354,857,660,140,328,155,37,289,293,52,26,197,47,65,54,31,163,34
55355,3725,2545,558,1106,671,210,893,1257,274,121,1180,185,315,289,391,1006,174
55356,1715,1299,111,781,315,92,561,555,103,80,416,92,228,81,15,331,85
55357,1177,975,125,610,226,14,522,379,43,31,202,42,84,36,40,168,34
55358,1652,1197,206,610,279,102,486,557,96,58,455,110,161,88,96,363,92
55359,1926,1536,144,974,358,60,668,686,127,55,390,109,130,77,74,282,108
55360,506,399,67,226,90,16,180,188,18,13,107,13,38,30,26,89,18
55362,4888,3698,1000,1898,628,172,1750,1293,487,168,1190,326,451,281,132,932,258
55363,1041,736,196,357,146,37,315,296,68,57,305,87,98,73,47,235,70
55364,6055,4168,562,2485,934,187,1661,1943,328,236,1887,460,761,398,268,1526,361
55367,345,256,47,110,71,28,98,123,15,20,89,8,31,16,34,77,12
55368,842,595,130,317,117,31,278,216,73,28,247,55,74,51,67,189,58
55369,12132,9204,1640,5743,1576,245,4164,3579,891,570,2928,748,1216,665,299,2322,606
55370,294,221,41,104,56,20,82,124,10,5,73,7,22,23,21,56,17
55371,4584,3418,726,1745,750,197,1327,1535,376,180,1166,248,379,262,277,940,226
55372,7877,6381,1252,3766,1276,87,2983,2675,491,232,1496,335,702,341,118,1079,417
55373,1618,1163,390,589,158,26,492,363,221,87,455,133,167,113,42,356,99
55374,2979,2562,605,1533,389,35,1495,926,82,59,417,80,216,60,61,291,126
55375,709,554,178,281,76,19,248,233,56,17,155,55,54,28,18,125,30
55376,2447,2034,549,1128,314,43,1098,714,117,105,413,126,138,105,44,307,106
55378,7112,6024,1679,3701,587,57,3500,1848,495,181,1088,389,492,158,49,767,321
55379,8360,6070,1962,2822,1056,230,2683,2479,619,289,2290,696,878,442,274,1715,575
55381,719,537,128,246,126,37,207,247,44,39,182,26,57,37,62,164,18
55382,1364,1095,182,547,309,57,459,540,54,42,269,29,93,91,56,225,44
55384,728,303,58,147,45,53,72,145,59,27,425,118,103,61,143,373,52
55385,535,376,58,183,98,37,164,162,30,20,159,33,40,35,51,142,17
55386,1047,877,174,515,164,24,436,354,45,42,170,49,44,67,10,124,46
55387,3194,2364,655,1080,474,155,1067,1039,178,80,830,171,255,187,217,684,146
55388,1585,1189,244,627,237,81,514,493,114,68,396,50,134,105,107,327,69
55389,867,655,122,295,187,51,285,293,46,31,212,32,54,61,65,177,35
55390,640,493,104,229,130,30,213,221,29,30,147,23,57,36,31,123,24
55391,6186,4440,315,2514,1379,232,1873,2192,198,177,1746,269,620,493,364,1449,297
55395,999,682,153,319,150,60,266,268,91,57,317,88,93,73,63,251,66
55396,924,609,90,261,186,72,209,318,57,25,315,42,84,91,98,292,23
55397,879,700,89,425,144,42,303,296,69,32,179,32,62,38,47,151,28
55398,3397,2700,620,1561,451,68,1341,970,288,101,697,202,312,123,60,516,181
55401,2447,501,169,204,97,31,27,363,46,65,1946,718,708,341,179,1717,229
55402,106,10,10,0,0,0,0,4,6,0,96,24,54,7,11,89,7
55403,10206,1746,533,592,482,139,328,996,212,210,8460,4380,2495,948,637,7206,1254
55404,11170,3597,1829,1379,321,68,847,734,1316,700,7573,3612,2477,922,562,6017,1556
55405,7199,2800,855,1418,445,82,837,1001,636,326,4399,2438,1451,342,168,2997,1402
55406,15168,7704,1841,3893,1397,573,2308,2960,1421,1015,7464,1973,3226,1255,1010,5745,1719
55407,13896,7765,2714,3699,998,354,2449,2010,2070,1236,6131,1751,2754,902,724,4467,1664
55408,14627,4622,2033,1967,502,120,1175,1573,1259,615,10005,5743,2787,983,492,6924,3081
55409,8613,4657,1181,2285,869,322,1647,1785,653,572,3956,1411,1567,593,385,2707,1249
55410,8760,4781,1013,2518,930,320,1675,2265,443,398,3979,1079,1745,679,476,3151,828
55411,9490,6553,2268,3174,961,150,1799,1038,2588,1128,2937,659,1244,734,300,2396,541
55412,8828,5516,1551,2900,779,286,1732,1488,1472,824,3312,711,1456,677,468,2541,771
55413,5675,2420,821,1070,358,171,621,908,564,327,3255,1111,1183,512,449,2398,857
55414,9311,2592,985,1038,490,79,745,1150,335,362,6719,5072,1058,408,181,3502,3217
55415,555,72,21,17,28,6,0,42,5,25,483,197,223,55,8,464,19
55416,13787,6296,1595,2866,1299,536,2019,3124,596,557,7491,3072,2357,965,1097,5890,1601
55417,10748,6183,1556,3062,1088,477,1906,2697,900,680,4565,1184,1797,690,894,3564,1001
55418,13327,7217,1731,3237,1446,803,2130,3089,1017,981,6110,1533,2271,1278,1028,4817,1293
55419,7446,4441,1067,2217,760,397,1662,2056,341,382,3005,826,1184,518,477,2256,749
55420,9184,5649,1079,2588,1505,477,1654,2687,725,583,3535,921,1194,892,528,2833,702
55421,11516,6646,1422,2743,1868,613,1700,3196,934,816,4870,1042,1626,1116,1086,4053,817
55422,11774,7269,1440,3303,1736,790,2437,3389,677,766,4505,1024,1426,885,1170,3588,917
55423,15149,8910,2165,3905,1904,936,2688,4056,1174,992,6239,1691,2108,1135,1305,5070,1169
55424,3654,2786,330,1510,727,219,1297,1193,171,125,868,99,256,253,260,732,136
55425,4001,2203,611,866,602,124,617,1076,320,190,1798,565,719,323,191,1413,385
55426,11454,6315,1696,2661,1336,622,1908,2962,816,629,5139,1773,1808,890,668,3938,1201
55427,9805,6264,1022,3003,1805,434,1966,3058,750,490,3541,957,1257,832,495,2827,714
55428,12183,7686,1949,3526,1770,441,2406,3215,1389,676,4497,1136,1401,976,984,3728,769
55429,10504,6593,1643,2933,1588,429,1951,2670,1201,771,3911,1271,1350,842,448,3106,805
55430,8039,5199,1409,2299,1080,411,1609,2047,1014,529,2840,753,931,456,700,2257,583
55431,7878,5227,785,2328,1735,379,1544,2983,358,342,2651,629,694,758,570,2138,513
55432,12419,8126,1793,3459,2483,391,2458,3741,1098,829,4293,1253,1648,884,508,3274,1019
55433,13056,9335,2208,4861,1925,341,3475,3698,1407,755,3721,1103,1266,958,394,2843,878
55434,10109,7493,1664,4042,1650,137,2779,3068,1006,640,2616,707,1104,665,140,1935,681
55435,6361,2487,257,924,767,539,649,1476,173,189,3874,682,768,896,1528,3496,378
55436,5472,3600,264,1744,1121,471,1463,1850,125,162,1872,267,474,611,520,1684,188
55437,8077,5188,626,2395,1710,457,1561,2809,420,398,2889,741,807,879,462,2360,529
55438,7304,4682,555,2519,1329,279,1688,2374,386,234,2622,705,1008,534,375,2056,566
55439,3521,2671,142,1274,997,258,977,1431,112,151,850,105,217,273,255,736,114
55441,7000,4521,890,2429,1010,192,1764,2051,430,276,2479,935,908,475,161,1790,689
55442,4859,3749,496,2358,742,153,1741,1573,263,172,1110,287,443,270,110,880,230
55443,8914,6544,1553,3750,1070,171,2902,2321,873,448,2370,847,864,531,128,1820,550
55444,5201,4148,881,2500,709,58,2020,1481,451,196,1053,352,514,158,29,776,277
55445,3228,2397,667,1270,397,63,1044,966,182,205,831,174,461,154,42,643,188
55446,4530,3338,561,2148,542,87,1748,1164,233,193,1192,462,403,219,108,913,279
55447,8669,6191,1148,3397,1461,185,2801,2422,624,344,2478,741,932,626,179,1848,630
55448,9440,7262,1554,4088,1486,134,3179,2855,820,408,2178,653,886,436,203,1698,480
55449,3797,3149,833,1825,466,25,1534,1171,261,183,648,135,327,100,86,462,186
55450,0,0,0,0,0,0,0,0,0,0,0,0,0,0,0,0,0
55454,2874,1089,467,409,160,53,256,286,343,204,1785,953,502,267,63,1422,363
55455,2,0,0,0,0,0,0,0,0,0,2,2,0,0,0,0,2
55601,99,55,7,24,19,5,5,34,11,5,44,9,13,18,4,38,6
55602,137,82,4,43,21,14,14,50,9,9,55,2,34,13,6,53,2
55603,225,154,20,95,39,0,56,81,10,7,71,9,28,21,13,64,7
55604,1569,943,134,397,315,97,282,513,86,62,626,93,255,152,126,548,78
55605,250,127,42,60,23,2,29,42,56,0,123,18,79,26,0,86,37
55606,126,78,5,41,32,0,22,56,0,0,48,0,6,32,10,37,11
55607,63,43,10,26,7,0,21,13,7,2,20,0,8,10,2,18,2
55609,127,83,0,50,17,16,36,34,5,8,44,0,16,14,14,34,10
55612,214,143,8,83,44,8,45,87,9,2,71,30,18,20,3,65,6
55613,91,63,13,12,30,8,19,39,5,0,28,9,9,6,4,16,12
55614,1159,802,76,344,289,93,236,456,82,28,357,54,106,132,65,330,27
55615,108,75,8,28,28,11,27,46,2,0,33,5,19,9,0,29,4
55616,2819,1922,340,881,570,131,618,1000,217,87,897,121,290,266,220,772,125
55702,150,105,11,56,28,10,31,57,10,7,45,3,13,17,12,40,5
55703,284,212,35,114,48,15,97,102,4,9,72,9,29,26,8,61,11
55704,511,365,43,182,118,22,126,182,40,17,146,29,38,40,39,126,20
55705,1442,990,103,497,280,110,257,582,103,48,452,38,169,107,138,437,15
55706,937,664,58,222,296,88,163,432,37,32,273,22,84,121,46,258,15
55707,1186,899,160,477,205,57,349,443,62,45,287,58,96,74,59,236,51
55708,416,247,41,116,69,21,57,122,50,18,169,14,55,49,51,150,19
55709,1746,1285,172,639,373,101,401,720,109,55,461,59,152,140,110,374,87
55710,572,454,66,225,143,20,169,251,27,7,118,8,57,33,20,95,23
55711,172,125,33,54,26,12,59,55,5,6,47,6,17,11,13,39,8
55712,156,107,7,38,44,18,10,75,7,15,49,7,10,23,9,42,7
55713,404,246,45,116,52,33,64,115,38,29,158,25,43,42,48,138,20
55716,163,100,31,39,16,14,31,37,21,11,63,5,11,29,18,59,4
55717,128,107,6,50,44,7,26,72,2,7,21,2,7,8,4,17,4
55718,1029,796,125,376,224,71,238,404,96,58,233,30,95,54,54,205,28
55719,2588,1632,284,747,411,190,518,749,234,131,956,123,276,234,323,872,84
55720,6404,4255,817,2036,1019,383,1435,1907,594,319,2149,378,647,593,531,1814,335
55721,1142,883,103,452,284,44,263,477,88,55,259,51,77,84,47,233,26
55722,377,261,56,136,46,23,117,115,18,11,116,24,29,26,37,93,23
55723,1089,717,60,366,217,74,204,406,74,33,372,31,108,120,113,333,39
55724,316,242,34,130,69,9,87,119,23,13,74,4,26,31,13,63,11
55725,47,25,9,7,9,0,9,16,0,0,22,0,15,0,7,22,0
55726,354,249,38,92,95,24,66,136,28,19,105,7,31,31,36,95,10
55731,2769,1688,237,731,535,185,455,937,168,128,1081,175,301,256,349,917,164
55732,603,426,54,215,139,18,122,244,46,14,177,22,72,52,31,151,26
55733,1423,1169,132,679,291,67,539,525,67,38,254,58,90,64,42,205,49
55734,2830,1828,287,908,497,136,579,881,250,118,1002,196,270,254,282,883,119
55735,818,556,63,280,180,33,172,293,55,36,262,31,90,96,45,214,48
55736,610,393,60,175,119,39,126,197,43,27,217,32,71,59,55,190,27
55738,242,194,36,111,36,11,76,99,10,9,48,6,20,18,4,43,5
55741,1361,893,108,449,268,68,265,490,68,70,468,55,117,128,168,432,36
55742,191,115,16,57,37,5,30,70,6,9,76,8,30,24,14,69,7
55744,8013,5496,908,2637,1537,414,1799,2791,612,294,2517,344,847,676,650,2174,343
55746,7885,4946,954,2231,1279,482,1554,2402,647,343,2939,571,881,721,766,2575,364
55748,528,342,51,149,121,21,98,180,38,26,186,32,58,73,23,151,35
55749,135,83,8,44,23,8,32,43,6,2,52,3,24,19,6,47,5
55750,926,657,80,291,236,50,175,404,41,37,269,52,65,99,53,237,32
55751,678,481,59,279,111,32,149,251,52,29,197,27,78,50,42,168,29
55752,174,130,13,51,50,16,22,85,14,9,44,5,12,27,0,38,6
55753,476,278,74,112,69,23,78,128,53,19,198,34,62,46,56,173,25
55756,132,100,9,45,39,7,20,60,12,8,32,10,8,9,5,24,8
55757,330,218,36,90,66,26,67,117,13,21,112,15,42,35,20,102,10
55758,71,50,5,23,14,8,14,32,4,0,21,2,12,0,7,19,2
55760,1289,839,99,287,357,96,201,517,74,47,450,16,119,199,116,400,50
55763,263,168,13,74,70,11,43,108,13,4,95,9,40,31,15,67,28
55764,218,137,31,55,40,11,53,66,13,5,81,22,24,15,20,64,17
55765,301,209,30,100,58,21,65,100,25,19,92,8,36,13,35,81,11
55767,1238,799,135,337,245,82,268,417,76,38,439,53,104,148,134,409,30
55768,1206,785,125,375,223,62,250,401,96,38,421,121,98,91,111,364,57
55769,942,654,90,319,186,59,203,343,55,53,288,31,80,96,81,261,27
55771,763,526,70,252,173,31,172,239,49,66,237,21,84,92,40,220,17
55775,585,409,33,191,133,52,111,266,14,18,176,13,53,57,53,153,23
55779,1214,935,134,567,204,30,373,454,85,23,279,37,130,77,35,214,65
55780,38,35,20,12,3,0,24,5,6,0,3,0,1,0,2,3,0
55781,150,117,5,53,50,9,30,76,6,5,33,0,23,8,2,30,3
55782,159,104,22,48,26,8,47,39,11,7,55,9,12,19,15,40,15
55783,828,598,82,261,210,45,201,305,43,49,230,15,68,106,41,193,37
55784,40,30,2,8,18,2,5,25,0,0,10,5,2,3,0,4,6
55785,86,62,9,27,24,2,31,27,0,4,24,2,4,12,6,22,2
55786,119,78,14,43,13,8,36,29,8,5,41,9,6,18,8,38,3
55787,142,89,4,33,42,10,12,65,5,7,53,7,17,18,11,47,6
55790,861,585,29,249,269,38,121,399,39,26,276,40,84,103,49,230,46
55792,5072,2811,525,1351,648,287,764,1366,475,206,2261,406,622,572,661,2015,246
55793,261,202,31,102,50,19,82,103,12,5,59,10,19,18,12,44,15
55795,563,366,81,157,89,39,142,170,27,27,197,42,50,67,38,175,22
55796,76,42,10,9,15,8,8,28,6,0,34,8,8,12,6,30,4
55797,450,355,58,209,68,20,159,147,29,20,95,17,50,16,12,73,22
55798,276,197,20,100,49,28,80,94,15,8,79,8,15,29,27,73,6
55802,1338,360,33,150,134,43,112,199,23,26,978,139,250,264,325,911,67
55803,6282,4656,501,2684,1144,327,1858,2305,287,206,1626,275,490,474,387,1350,276
55804,5513,3932,543,2112,975,302,1515,1887,343,187,1581,257,535,457,332,1342,239
55805,5314,2176,950,805,264,157,549,627,735,265,3138,1238,944,552,404,2301,837
55806,4350,2132,685,966,343,138,575,635,626,296,2218,728,794,377,319,1720,498
55807,4483,2721,629,1340,503,249,782,1084,537,318,1762,299,545,521,397,1542,220
55808,2428,1569,364,744,334,127,537,641,278,113,859,132,212,269,246,692,167
55810,3441,2459,368,1279,650,162,851,1156,262,190,982,188,238,312,244,827,155
55811,8978,5990,946,2923,1608,513,2013,3105,526,346,2988,740,853,737,658,2417,571
55812,3554,1818,382,970,304,162,633,785,237,163,1736,906,431,254,145,1175,561
55901,16509,10805,2722,5364,2228,491,4748,4367,1160,530,5704,2188,1516,978,1022,4637,1067
55902,7404,4963,824,2630,1260,249,2154,2335,294,180,2441,942,717,477,305,2084,357
55904,9246,6092,1490,3012,1335,255,2254,2482,916,440,3154,1012,1107,612,423,2345,809
55906,6488,4395,796,2278,1025,296,1798,1936,461,200,2093,653,606,422,412,1755,338
55909,584,429,60,187,124,58,167,208,26,28,155,23,28,38,66,146,9
55910,599,445,90,202,121,32,159,223,38,25,154,36,41,30,47,126,28
55912,11653,7536,1518,3168,2030,820,2417,3589,996,534,4117,811,1064,944,1298,3612,505
55917,1363,1006,157,488,252,109,382,486,86,52,357,71,76,98,112,312,45
55918,411,279,50,121,74,34,95,143,29,12,132,32,36,36,28,109,23
55919,505,386,39,226,101,20,153,162,35,36,119,16,48,23,32,101,18
55920,1940,1594,324,871,337,62,756,625,152,61,346,102,127,75,42,269,77
55921,1955,1357,210,650,367,130,535,607,142,73,598,124,165,155,154,533,65
55922,357,255,42,110,71,32,105,118,11,21,102,23,28,27,24,86,16
55923,1576,1154,208,580,268,98,494,511,95,54,422,76,96,131,119,353,69
55924,502,383,73,177,97,36,148,188,41,6,119,23,39,26,31,97,22
55925,351,268,37,147,69,15,124,117,8,19,83,15,31,25,12,69,14
55926,299,218,34,101,59,24,94,104,9,11,81,6,26,32,17,75,6
55927,1206,918,239,422,198,59,377,372,135,34,288,59,77,70,82,241,47
55929,342,262,47,139,60,16,117,101,35,9,80,20,20,26,14,62,18
55931,125,75,3,30,32,10,29,44,2,0,50,13,10,10,17,45,5
55932,646,488,89,252,119,28,225,201,43,19,158,41,54,26,37,135,23
55933,80,64,16,27,17,4,28,27,7,2,16,0,4,9,3,14,2
55934,1001,783,168,383,178,54,307,335,92,49,218,63,69,47,39,179,39
55935,273,206,33,106,46,21,87,97,8,14,67,28,19,4,16,49,18
55936,671,448,112,208,99,29,204,194,40,10,223,45,68,52,58,195,28
55939,785,544,72,255,156,61,197,279,45,23,241,34,42,76,89,216,25
55940,890,657,118,348,151,40,305,269,51,32,233,42,58,31,102,206,27
55941,430,288,71,155,43,19,105,105,58,20,142,28,59,21,34,115,27
55943,1163,838,154,370,223,91,282,402,97,57,325,49,114,83,79,273,52
55944,2630,2015,446,1075,394,100,912,818,206,79,615,127,162,137,189,506,109
55945,578,417,59,225,100,33,178,189,34,16,161,33,35,42,51,133,28
55946,1269,922,152,448,248,74,374,412,69,67,347,83,85,74,105,294,53
55947,2784,2071,319,1124,517,111,848,949,169,105,713,131,207,201,174,626,87
55949,792,532,70,257,148,57,193,288,32,19,260,48,74,69,69,217,43
55950,56,44,9,13,17,5,9,23,11,1,12,2,0,4,6,8,4
55951,623,414,66,208,98,42,150,214,36,14,209,40,51,50,68,192,17
55952,889,674,146,320,163,45,317,262,53,42,215,41,64,44,66,190,25
55953,353,267,49,135,58,25,115,115,22,15,86,11,27,29,19,71,15
55954,618,407,53,169,124,61,111,234,39,23,211,25,37,87,62,196,15
55955,350,267,69,132,48,18,138,102,15,12,83,10,24,21,28,71,12
55956,685,516,86,269,125,36,202,229,50,35,169,33,39,48,49,155,14
55957,265,177,40,83,41,13,87,79,4,7,88,31,24,19,14,67,21
55959,840,665,139,345,145,36,263,298,82,22,175,50,69,37,19,135,40
55960,1070,789,137,420,193,39,287,372,85,45,281,64,130,56,31,218,63
55961,192,142,18,78,29,17,51,71,6,14,50,6,5,14,25,44,6
55962,303,244,28,119,72,25,84,127,19,14,59,8,19,15,17,50,9
55963,1460,1147,176,635,289,47,467,518,107,55,313,54,67,90,102,264,49
55964,1522,1144,257,578,210,99,534,453,119,38,378,92,89,84,113,319,59
55965,923,615,123,232,201,59,229,323,38,25,308,49,92,79,88,285,23
55967,286,239,48,108,67,16,101,111,8,19,47,9,12,14,12,33,14
55969,505,406,65,217,100,24,177,188,28,13,99,12,25,22,40,87,12
55970,319,242,45,103,59,35,101,117,17,7,77,7,18,27,25,74,3
55971,1145,784,129,378,213,64,297,396,60,31,361,68,74,106,113,319,42
55972,1613,1184,308,554,220,102,553,466,106,59,429,117,97,112,103,341,88
55973,120,105,21,43,38,3,46,37,17,5,15,2,1,8,4,12,3
55974,927,608,106,279,160,63,199,299,81,29,319,54,80,60,125,283,36
55975,1872,1338,257,614,338,129,517,611,128,82,534,112,140,135,147,455,79
55976,2552,1838,493,860,391,94,780,726,242,90,714,89,238,205,182,570,144
55977,68,61,13,20,25,3,27,23,4,7,7,1,0,2,4,5,2
55979,292,242,50,116,61,15,118,108,8,8,50,6,24,11,9,44,6
55981,1689,1142,128,521,383,110,368,645,89,40,547,102,153,159,133,471,76
55982,178,147,13,83,31,20,58,70,10,9,31,2,11,12,6,23,8
55983,543,379,76,180,77,46,176,164,25,14,164,20,56,30,58,138,26
55985,783,577,121,264,143,49,227,269,54,27,206,39,44,68,55,171,35
55987,13274,7503,1444,3545,1940,574,2745,3410,852,496,5771,2274,1409,959,1129,4256,1515
55988,77,56,7,34,12,3,21,22,5,8,21,3,5,8,5,18,3
55990,380,285,43,120,78,44,93,153,25,14,95,23,22,16,34,84,11
55991,534,390,78,214,80,18,149,191,40,10,144,29,51,43,21,120,24
55992,1689,1205,190,617,307,91,475,563,114,53,484,99,139,81,165,433,51
56001,14717,8046,2029,3669,1721,627,2834,3475,1112,625,6671,3344,1493,875,959,4369,2302
56003,5099,3490,840,1790,704,156,1496,1458,386,150,1609,538,479,355,237,1225,384
56007,9032,5832,976,2598,1662,596,1776,2984,752,320,3200,641,741,878,940,2768,432
56009,694,538,81,240,155,62,182,290,33,33,156,28,31,37,60,134,22
56010,514,381,56,175,107,43,138,196,34,13,133,17,30,34,52,123,10
56011,2111,1556,310,851,329,66,658,604,211,83,555,133,119,126,177,447,108
56013,2072,1356,189,637,400,130,497,703,108,48,716,111,153,169,283,656,60
56014,348,243,33,85,90,35,90,135,8,10,105,11,27,38,29,95,10
56016,415,319,62,156,88,13,128,140,31,20,96,25,27,30,14,85,11
56017,615,439,65,243,105,26,183,211,31,14,176,41,54,53,28,138,38
56019,376,269,33,97,99,40,91,158,7,13,107,15,18,36,38,102,5
56020,63,46,11,21,8,6,19,22,3,2,17,3,4,6,4,17,0
56021,350,271,34,152,70,15,135,119,11,6,79,14,31,17,17,64,15
56022,59,49,7,24,9,9,14,25,8,2,10,3,1,2,4,7,3
56023,241,181,26,58,72,25,61,104,4,12,60,5,20,15,20,56,4
56024,802,587,154,315,97,21,278,216,65,28,215,74,78,33,30,157,58
56025,183,133,10,67,48,8,50,67,12,4,50,15,8,23,4,34,16
56026,719,526,65,271,122,68,217,246,37,26,193,27,67,38,61,173,20
56027,475,322,50,122,113,37,92,182,35,13,153,28,47,33,45,137,16
56028,391,278,52,126,81,19,100,142,15,21,113,26,32,31,24,99,14
56029,307,228,41,106,59,22,68,124,28,8,79,8,25,17,29,70,9
56031,5400,3583,623,1591,985,384,1141,1808,430,204,1817,345,443,431,598,1665,152
56032,132,93,10,41,28,14,31,53,7,2,39,7,3,15,14,35,4
56033,168,102,17,45,33,7,35,48,16,3,66,12,11,13,30,60,6
56034,254,196,18,104,62,12,77,98,21,0,58,18,14,14,12,51,7
56035,201,144,37,75,22,10,59,73,3,9,57,7,13,18,19,53,4
56036,855,611,94,270,192,55,212,319,47,33,244,35,57,80,72,208,36
56037,609,472,98,227,125,22,219,205,29,19,137,35,29,20,53,124,13
56039,401,284,31,154,75,24,122,137,9,16,117,14,39,34,30,105,12
56041,474,360,64,142,127,27,124,181,21,34,114,25,33,9,47,100,14
56042,296,220,33,93,75,19,78,121,15,6,76,24,19,15,18,67,9
56043,200,138,18,73,36,11,55,71,7,5,62,6,16,16,24,61,1
56044,721,518,101,247,142,28,228,216,36,38,203,25,72,54,52,172,31
56045,306,219,22,103,56,38,65,118,21,15,87,15,32,16,24,76,11
56048,1411,1039,226,488,233,92,445,462,63,69,372,91,91,85,105,325,47
56050,521,410,80,221,86,23,135,190,47,38,111,22,52,16,21,82,29
56051,354,229,36,96,71,26,68,136,19,6,125,25,35,19,46,113,12
56052,292,209,35,92,74,8,71,110,9,19,83,16,27,21,19,67,16
56054,367,259,58,120,54,27,107,115,23,14,108,27,30,33,18,98,10
56055,1468,1057,181,494,254,128,413,500,94,50,411,72,127,81,131,350,61
56056,54,25,4,9,6,6,9,12,4,0,29,6,5,12,6,22,7
56057,1401,994,202,497,210,85,413,413,95,73,407,78,95,110,124,342,65
56058,2294,1654,248,809,459,138,632,768,153,101,640,151,175,119,195,582,58
56060,205,156,24,66,47,19,58,82,15,1,49,9,11,10,19,41,8
56062,1256,833,180,362,222,69,295,352,124,62,423,56,117,128,122,387,36
56063,936,703,102,368,195,38,291,324,47,41,233,62,62,78,31,181,52
56064,47,30,11,15,2,2,13,5,8,4,17,4,0,11,2,15,2
56065,1032,778,156,356,195,71,319,358,62,39,254,44,62,61,87,217,37
56068,445,307,46,139,84,38,110,169,14,14,138,17,30,36,55,132,6
56069,1643,1134,218,542,269,105,462,452,132,88,509,98,144,129,138,455,54
56071,2998,2291,458,1167,514,152,1071,898,206,116,707,97,222,149,239,593,114
56072,967,686,95,325,186,80,260,346,43,37,281,52,70,66,93,251,30
56073,6746,4607,777,2259,1201,370,1689,2236,450,232,2139,507,533,553,546,1889,250
56074,684,515,89,247,140,39,227,243,19,26,169,42,62,20,45,140,29
56075,73,55,8,19,20,8,13,37,5,0,18,2,4,6,6,18,0
56076,175,144,26,75,38,5,64,66,10,4,31,6,9,9,7,27,4
56078,189,140,42,58,38,2,63,52,13,12,49,11,16,9,13,38,11
56080,253,195,46,99,36,14,85,75,21,14,58,14,7,15,22,47,11
56081,2437,1664,345,694,473,152,630,775,179,80,773,130,182,233,228,698,75
56082,3877,2554,480,1318,607,149,985,1173,313,83,1323,443,320,289,271,1020,303
56083,403,313,56,133,93,31,138,152,9,14,90,19,32,13,26,84,6
56085,2280,1597,264,747,416,170,665,741,106,85,683,86,160,188,249,641,42
56087,1299,887,134,409,264,80,374,416,45,52,412,66,72,66,208,381,31
56088,848,581,77,290,159,55,200,313,43,25,267,47,51,72,97,238,29
56089,101,52,10,29,13,0,15,30,5,2,49,4,21,8,16,44,5
56090,254,195,47,75,50,23,73,112,6,4,59,8,16,15,20,53,6
56091,161,123,18,58,37,10,32,69,14,8,38,7,10,6,15,34,4
56093,4631,3246,647,1664,736,199,1261,1459,373,153,1385,415,350,310,310,1176,209
56096,1237,895,128,406,282,79,294,479,73,49,342,56,99,83,104,293,49
56097,1670,1162,171,517,327,147,427,574,92,69,508,71,112,142,183,455,53
56098,1028,693,98,304,213,78,225,386,45,37,335,39,80,75,141,308,27
56101,2490,1689,250,731,512,196,531,895,152,111,801,148,231,188,234,760,41
56110,732,551,96,241,154,60,229,252,33,37,181,27,38,51,65,170,11
56111,192,159,38,62,41,18,67,81,6,5,33,5,11,5,12,24,9
56113,130,81,16,33,16,16,32,42,3,4,49,10,17,10,12,45,4
56114,166,109,21,43,36,9,48,49,3,9,57,6,25,14,12,51,6
56115,555,402,100,168,93,41,131,224,31,16,153,31,32,36,54,135,18
56116,269,202,28,102,58,14,74,102,9,17,67,6,7,21,33,62,5
56117,145,116,14,56,31,15,51,62,3,0,29,6,11,8,4,26,3
56118,159,124,19,65,32,8,52,60,8,4,35,8,14,10,3,32,3
56119,435,322,60,134,87,41,118,160,25,19,113,23,27,24,39,98,15
56120,493,365,58,158,115,34,134,181,28,22,128,14,36,33,45,124,4
56121,292,195,22,84,55,34,65,115,11,4,97,16,21,25,35,86,11
56122,244,187,27,93,50,17,80,94,2,11,57,11,7,6,33,53,4
56123,300,205,19,86,69,31,63,119,13,10,95,18,27,30,20,86,9
56127,199,146,12,89,43,2,68,64,6,8,53,12,14,12,15,46,7
56128,762,580,56,280,176,68,252,308,10,10,182,34,21,41,86,174,8
56129,327,229,48,96,67,18,77,109,16,27,98,15,21,21,41,95,3
56131,959,658,84,303,188,83,262,340,32,24,301,48,52,97,104,273,28
56132,224,182,31,87,53,11,56,113,11,2,42,10,9,17,6,35,7
56134,147,121,18,47,37,19,54,62,5,0,26,6,6,8,6,26,0
56136,451,303,40,117,102,44,115,167,12,9,148,19,26,31,72,140,8
56137,496,337,55,147,98,37,146,153,24,14,159,45,28,44,42,139,20
56138,310,215,42,101,49,23,91,108,12,4,95,20,17,24,34,93,2
56139,218,165,18,68,58,21,54,87,13,11,53,8,17,15,13,51,2
56140,52,40,5,20,9,6,13,25,2,0,12,2,4,6,0,12,0
56141,154,103,9,53,27,14,52,48,0,3,51,10,9,15,17,46,5
56142,520,323,43,140,95,45,105,165,26,27,197,30,30,56,81,184,13
56143,2061,1331,229,597,348,157,451,698,145,37,730,192,220,117,201,663,67
56144,416,277,46,110,89,32,88,162,25,2,139,13,21,37,68,133,6
56145,283,186,24,87,58,17,53,118,7,8,97,17,22,27,31,84,13
56147,95,66,23,27,12,4,32,34,0,0,29,10,11,2,6,24,5
56149,675,449,73,169,138,69,167,234,22,26,226,43,41,76,66,201,25
56150,1148,788,106,337,242,103,285,422,45,36,360,66,84,97,113,327,33
56151,363,258,39,118,69,32,90,135,19,14,105,21,26,29,29,96,9
56152,668,439,70,163,156,50,159,232,23,25,229,41,34,50,104,209,20
56153,114,85,9,25,34,17,19,61,3,2,29,2,2,4,21,29,0
56155,189,134,20,56,40,18,53,63,2,16,55,9,9,11,26,49,6
56156,2605,1797,296,796,472,233,647,971,132,47,808,109,195,144,360,755,53
56157,241,170,35,82,47,6,87,70,7,6,71,14,16,22,19,47,24
56158,128,89,24,37,20,8,43,37,9,0,39,13,11,4,11,34,5
56159,1142,821,150,339,236,96,309,409,77,26,321,55,61,75,130,303,18
56160,115,74,10,34,23,7,30,40,2,2,41,2,16,15,8,34,7
56161,187,145,29,66,33,17,51,79,15,0,42,4,18,6,14,40,2
56162,109,79,9,51,14,5,36,28,15,0,30,5,4,2,19,28,2
56164,2449,1592,314,710,415,153,572,744,215,61,857,232,159,172,294,769,88
56165,145,120,19,67,32,2,54,56,8,2,25,2,8,5,10,18,7
56166,105,75,8,29,29,9,26,42,6,1,30,7,9,7,7,30,0
56167,361,256,41,132,62,21,118,112,20,6,105,21,29,21,34,99,6
56168,392,310,41,161,82,26,147,132,19,12,82,11,10,24,37,79,3
56169,295,225,45,108,57,15,99,90,18,18,70,18,12,16,24,56,14
56170,270,204,37,98,53,16,73,105,15,11,66,10,10,16,30,66,0
56171,777,523,82,231,154,56,204,247,36,36,254,43,51,74,86,242,12
56172,1299,875,124,340,309,102,273,523,62,17,424,65,89,114,156,381,43
56173,161,125,26,51,40,8,55,61,3,6,36,16,2,6,12,34,2
56174,191,140,26,63,38,13,41,84,7,8,51,4,12,13,22,48,3
56175,1279,810,129,382,226,73,324,412,58,16,469,73,68,156,172,423,46
56176,462,311,48,132,88,43,119,166,14,12,151,17,34,35,65,143,8
56177,40,32,0,19,11,2,10,16,6,0,8,0,1,1,6,8,0
56178,758,537,93,214,145,85,193,294,27,23,221,43,51,51,76,208,13
56180,476,330,36,149,94,51,90,201,24,15,146,25,25,42,54,134,12
56181,495,332,69,140,92,31,125,159,37,11,163,25,46,62,30,145,18
56183,635,429,54,156,136,83,136,244,30,19,206,20,34,51,101,192,14
56185,236,152,23,80,31,18,63,71,4,14,84,17,23,21,23,73,11
56186,178,114,21,54,31,8,50,49,8,7,64,13,6,24,21,64,0
56187,4867,3335,620,1485,886,344,1172,1647,360,156,1532,314,375,346,497,1340,192
56201,8651,5589,1403,2465,1239,482,2138,2399,730,322,3062,902,790,656,714,2469,593
56207,129,109,15,51,30,13,41,58,3,7,20,7,3,5,5,15,5
56208,1052,618,107,268,171,72,200,300,81,37,434,75,83,114,162,405,29
56209,1002,729,100,395,180,54,251,366,60,52,273,34,67,89,83,252,21
56211,280,188,23,97,48,20,77,85,15,11,92,12,20,17,43,88,4
56212,284,198,27,81,70,20,73,105,10,10,86,12,17,20,37,76,10
56214,315,216,39,81,68,28,84,103,16,13,99,12,28,14,45,91,8
56215,2028,1347,250,599,365,133,535,661,81,70,681,88,101,168,324,628,53
56216,279,237,45,125,48,19,117,94,19,7,42,4,13,15,10,35,7
56218,272,188,24,91,60,13,76,95,7,10,84,7,23,30,24,76,8
56219,516,345,56,131,124,34,107,158,61,19,171,31,54,52,34,159,12
56220,1400,899,102,392,247,158,296,479,69,55,501,119,81,126,175,447,54
56221,386,273,26,119,98,30,88,166,13,6,113,21,26,22,44,101,12
56222,865,603,110,247,181,65,248,289,31,35,262,19,35,92,116,237,25
56223,626,434,68,194,115,57,160,219,32,23,192,32,56,38,66,178,14
56224,149,92,13,49,27,3,41,42,5,4,57,10,18,26,3,47,10
56225,307,203,30,92,52,29,82,101,16,4,104,16,27,26,35,95,9
56226,92,74,10,44,18,2,24,34,10,6,18,6,8,0,4,11,7
56227,92,66,4,32,21,9,21,34,4,7,26,6,6,9,5,24,2
56228,404,283,53,122,82,26,99,140,31,13,121,29,40,32,20,101,20
56229,680,515,116,248,118,33,249,224,28,14,165,53,36,30,46,148,17
56230,367,280,57,149,45,29,138,120,13,9,87,19,22,18,28,72,15
56231,175,125,16,71,25,13,70,49,2,4,50,15,13,7,15,46,4
56232,1035,680,99,322,176,83,267,366,31,16,355,46,85,86,138,324,31
56235,273,194,25,98,58,13,62,110,8,14,79,6,20,32,21,69,10
56236,182,136,19,53,43,21,52,78,4,2,46,6,11,14,15,42,4
56237,270,185,28,73,74,10,66,100,9,10,85,15,16,23,31,75,10
56239,206,153,36,83,25,9,57,70,22,4,53,18,10,13,12,46,7
56240,436,284,33,136,81,34,117,144,15,8,152,23,30,52,47,152,0
56241,1825,1156,155,570,311,120,407,560,121,68,669,111,145,169,244,580,89
56243,683,498,86,251,119,42,197,222,54,25,185,37,58,54,36,163,22
56244,494,382,49,201,89,43,161,180,24,17,112,29,32,22,29,94,18
56245,196,150,40,60,40,10,63,73,7,7,46,10,25,2,9,39,7
56246,143,120,19,60,29,12,54,49,9,8,23,7,8,7,1,19,4
56248,391,273,38,118,76,41,91,145,22,15,118,15,24,42,37,110,8
56249,155,124,17,55,40,12,39,75,9,1,31,6,7,8,10,29,2
56251,346,255,41,139,61,14,102,122,22,9,91,34,20,19,18,72,19
56252,495,371,52,179,90,50,136,190,32,13,124,22,25,27,50,120,4
56253,445,300,49,127,91,33,100,158,26,16,145,20,45,38,42,128,17
56255,178,120,21,54,31,14,57,44,11,8,58,9,23,16,10,47,11
56256,1227,813,80,369,230,134,274,436,57,46,414,53,74,112,175,380,34
56257,245,150,18,67,46,19,47,88,10,5,95,18,20,29,28,89,6
56258,5619,3538,816,1786,655,281,1419,1509,413,197,2081,771,413,388,509,1596,485
56260,362,267,41,140,54,32,125,121,10,11,95,15,19,36,25,80,15
56262,323,224,36,84,77,27,83,119,13,9,99,13,21,23,42,92,7
56263,227,173,32,79,47,15,65,79,12,17,54,10,22,12,10,51,3
56264,929,651,112,295,181,63,252,311,64,24,278,69,51,49,109,254,24
56265,3303,2214,397,1022,538,257,764,1084,259,107,1089,235,225,306,323,984,105
56266,680,465,92,182,118,73,160,244,34,27,215,26,62,56,71,189,26
56267,2527,1471,299,676,334,162,584,724,104,59,1056,403,162,176,315,816,240
56270,412,283,66,143,52,22,88,110,62,23,129,27,46,30,26,100,29
56271,520,366,44,195,94,33,156,180,17,13,154,26,46,37,45,133,21
56273,1559,1178,235,544,346,53,462,571,92,53,381,64,102,122,93,333,48
56274,88,65,1,35,20,9,19,37,6,3,23,5,0,12,6,22,1
56276,123,85,6,39,22,18,28,47,3,7,38,5,8,14,11,32,6
56277,1347,856,157,389,224,86,343,436,51,26,491,87,120,135,149,447,44
56278,1231,848,88,369,294,97,253,465,89,41,383,41,66,126,150,366,17
56279,401,331,62,183,56,30,137,141,36,17,70,21,17,21,11,57,13
56280,232,171,14,93,54,10,70,77,12,12,61,9,20,13,19,61,0
56281,233,181,33,64,56,28,72,108,1,0,52,7,10,11,24,48,4
56282,589,454,93,226,103,32,197,205,32,20,135,28,33,26,48,121,14
56283,2878,1837,315,896,420,206,668,886,230,53,1041,203,259,284,295,902,139
56284,822,610,109,263,176,62,262,290,32,26,212,30,53,48,81,198,14
56285,464,315,42,152,89,32,118,160,22,15,149,28,49,38,34,135,14
56287,42,21,0,9,6,6,2,17,0,2,21,2,9,4,6,19,2
56288,1934,1385,166,685,434,100,470,729,125,61,549,117,159,144,129,473,76
56289,248,193,26,71,76,20,57,102,10,24,55,14,17,15,9,45,10
56291,180,120,16,65,26,13,46,65,7,2,60,11,14,17,18,54,6
56292,250,179,52,62,54,11,66,90,16,7,71,9,9,27,26,61,10
56293,462,344,47,148,119,30,141,156,27,20,118,24,17,25,52,111,7
56294,46,30,6,10,9,5,9,16,0,5,16,0,6,8,2,16,0
56295,126,87,11,60,10,6,34,40,11,2,39,6,10,14,9,33,6
56296,1003,640,86,241,217,96,202,349,62,27,363,46,68,100,149,345,18
56297,327,241,47,103,61,30,104,118,12,7,86,16,21,14,35,76,10
56301,9874,5726,1257,2992,1185,292,2476,2209,677,364,4148,2538,759,520,331,2348,1800
56303,9597,5854,1286,2961,1304,303,2173,2422,834,425,3743,1390,1091,756,506,2969,774
56304,6161,3283,901,1412,795,175,1168,1421,482,212,2878,1520,712,307,339,1868,1010
56307,1434,1063,254,482,229,98,510,440,81,32,371,76,71,91,133,323,48
56308,8920,5954,961,2684,1684,625,2047,3055,548,304,2966,786,803,656,721,2454,512
56309,475,350,42,160,110,38,91,210,39,10,125,13,27,35,50,115,10
56310,1753,1413,266,751,340,56,665,587,97,64,340,46,131,102,61,286,54
56311,274,213,33,87,70,23,75,109,14,15,61,5,19,13,24,57,4
56312,976,693,103,351,174,65,285,321,56,31,283,65,71,76,71,247,36
56313,22,16,5,5,4,2,4,9,3,0,6,0,3,0,3,6,0
56314,379,284,58,130,74,22,114,126,22,22,95,9,32,34,20,83,12
56315,604,456,74,218,139,25,162,251,36,7,148,27,42,33,46,130,18
56316,540,378,86,155,89,48,163,178,30,7,162,12,51,54,45,150,12
56318,424,321,42,141,115,23,116,172,12,21,103,25,32,36,10,97,6
56319,438,326,47,143,102,34,130,171,13,12,112,19,40,34,19,89,23
56320,2781,2175,440,1101,540,94,981,948,188,58,606,90,170,139,207,512,94
56323,252,174,29,63,59,23,58,89,13,14,78,17,18,25,18,72,6
56324,431,305,30,130,116,29,103,169,16,17,126,30,32,33,31,104,22
56325,62,40,3,18,15,4,14,22,0,4,22,5,0,5,12,20,2
56326,536,348,53,149,103,43,134,175,17,22,188,22,45,66,55,171,17
56327,280,220,31,108,70,11,90,112,8,10,60,15,16,18,11,51,9
56328,54,40,7,25,4,4,20,11,3,6,14,4,2,1,7,14,0
56329,2160,1651,386,782,375,108,733,665,154,99,509,82,137,125,165,448,61
56330,497,394,83,206,93,12,177,156,41,20,103,27,24,29,23,84,19
56331,620,508,102,247,114,45,244,203,19,42,112,16,19,34,43,105,7
56332,456,333,81,162,71,19,149,143,33,8,123,37,33,41,12,99,24
56334,2240,1456,209,683,420,144,513,773,113,57,784,124,164,194,302,713,71
56335,74,55,9,19,22,5,13,33,5,4,19,7,3,4,5,16,3
56336,665,473,56,232,153,32,196,231,18,28,192,42,47,56,47,166,26
56338,595,443,67,198,146,32,154,235,35,19,152,27,44,53,28,140,12
56339,441,295,46,135,85,29,109,147,22,17,146,27,22,42,55,127,19
56340,751,577,127,282,125,43,263,230,53,31,174,14,46,58,56,157,17
56342,1251,831,106,315,329,81,194,533,60,44,420,40,130,147,103,376,44
56343,372,237,40,93,74,30,88,129,12,8,135,20,47,45,23,114,21
56345,5612,3925,726,1901,981,317,1430,1800,503,192,1687,283,481,400,523,1528,159
56347,2429,1768,326,864,439,139,673,804,178,113,661,110,138,185,228,603,58
56349,269,199,47,85,54,13,91,87,12,9,70,21,7,24,18,64,6
56350,145,90,11,41,27,11,27,47,11,5,55,0,31,13,11,51,4
56352,1962,1434,291,626,369,148,650,608,115,61,528,105,122,139,162,453,75
56353,2746,1943,373,905,507,158,762,869,205,107,803,155,189,232,227,708,95
56354,477,346,57,126,146,17,91,218,25,12,131,15,35,45,36,122,9
56355,180,142,32,75,29,6,53,68,13,8,38,15,8,7,8,30,8
56356,21,4,0,4,0,0,2,2,0,0,17,0,0,7,10,17,0
56357,280,220,34,121,48,17,88,106,16,10,60,11,23,16,10,48,12
56358,1104,816,158,415,194,49,284,350,135,47,288,61,113,80,34,234,54
56359,1290,895,171,395,266,63,228,433,176,58,395,41,126,150,78,334,61
56360,1498,1028,161,408,343,116,369,560,59,40,470,58,115,138,159,416,54
56361,934,640,106,280,183,71,241,310,44,45,294,43,69,99,83,254,40
56362,2118,1576,272,736,438,130,633,767,109,67,542,78,129,140,195,491,51
56364,1855,1392,299,609,351,133,589,587,125,91,463,101,83,130,149,412,51
56367,1892,1492,347,832,273,40,766,566,103,57,400,97,157,103,43,304,96
56368,1395,1088,187,512,318,71,406,585,47,50,307,71,83,83,70,250,57
56369,164,110,43,46,17,4,58,34,12,6,54,21,16,11,6,46,8
56371,38,29,3,17,7,2,17,9,3,0,9,1,0,6,2,7,2
56373,884,680,163,327,144,46,294,289,64,33,204,51,63,46,44,164,40
56374,2369,1799,373,935,414,77,745,775,180,99,570,225,199,79,67,382,188
56375,276,232,63,105,53,11,129,90,4,9,44,18,10,12,4,36,8
56376,63,47,6,25,6,10,21,19,5,2,16,0,2,5,9,16,0
56377,4453,3352,839,1933,485,95,1676,1197,303,176,1101,440,255,197,209,814,287
56378,2726,1922,321,859,560,182,742,936,131,113,804,170,175,219,240,699,105
56379,4778,3269,793,1657,617,202,1381,1331,330,227,1509,521,425,324,239,1170,339
56381,1100,767,93,332,245,97,284,406,46,31,333,37,63,90,143,314,19
56382,531,403,77,199,99,28,187,168,33,15,128,14,29,43,42,118,10
56384,155,74,19,34,16,5,45,22,5,2,81,17,14,16,34,73,8
56385,364,287,46,129,81,31,134,120,17,16,77,18,13,23,23,63,14
56386,389,244,45,94,94,11,79,132,27,6,145,23,35,52,35,115,30
56387,3025,1570,529,596,325,120,486,655,245,184,1455,721,333,219,182,983,472
56401,10982,7258,1728,3237,1756,537,2537,3232,1042,447,3724,816,1136,873,899,3087,637
56425,1956,1633,265,895,438,35,656,777,176,24,323,77,62,101,83,253,70
56431,3586,2462,324,976,903,259,726,1425,169,142,1124,102,262,420,340,997,127
56433,658,456,47,199,174,36,103,264,50,39,202,26,66,74,36,168,34
56434,37,26,2,20,2,2,10,6,4,6,11,0,7,0,4,7,4
56435,1045,754,81,372,252,49,239,417,64,34,291,31,90,108,62,244,47
56436,109,92,12,39,35,6,36,37,10,9,17,2,9,4,2,15,2
56437,467,339,62,154,94,29,141,150,32,16,128,19,27,39,43,115,13
56438,1039,738,117,357,200,64,306,357,47,28,301,19,78,95,109,284,17
56440,483,316,45,149,94,28,135,147,17,17,167,16,41,48,62,153,14
56441,1418,862,158,424,209,71,308,393,119,42,556,101,128,184,143,492,64
56442,1015,698,49,199,368,82,134,505,30,29,317,31,100,112,74,284,33
56443,611,432,32,168,193,39,104,297,19,12,179,15,79,53,32,159,20
56444,1484,1086,109,464,414,99,317,644,64,61,398,31,118,136,113,348,50
56446,648,467,53,223,157,34,160,248,31,28,181,25,48,54,54,158,23
56447,438,276,41,103,106,26,78,174,17,7,162,16,44,58,44,139,23
56448,185,135,4,34,78,19,12,115,6,2,50,2,7,24,17,47,3
56449,533,449,55,225,142,27,176,228,32,13,84,9,42,24,9,79,5
56450,427,264,10,100,126,28,39,175,25,25,163,17,44,71,31,135,28
56452,844,596,58,152,324,62,105,456,26,9,248,18,63,92,75,221,27
56453,333,249,43,112,79,15,76,122,33,18,84,14,9,33,28,63,21
56455,234,147,47,51,31,18,54,76,11,6,87,6,16,31,34,78,9
56456,90,52,13,33,6,0,20,24,6,2,38,5,18,10,5,36,2
56458,125,93,19,35,26,13,34,49,5,5,32,2,8,12,10,24,8
56461,1011,793,133,372,239,49,286,386,71,50,218,46,71,56,45,182,36
56464,1509,1068,177,459,338,94,373,540,100,55,441,45,120,177,99,401,40
56465,689,488,66,223,173,26,172,263,37,16,201,39,69,59,34,168,33
56466,1107,789,145,331,249,64,262,388,93,46,318,57,102,94,65,276,42
56467,950,690,61,299,268,62,179,416,51,44,260,25,52,106,77,242,18
56468,1912,1418,153,606,544,115,403,863,93,59,494,65,154,166,109,395,99
56469,418,322,29,124,127,42,74,201,27,20,96,15,27,39,15,79,17
56470,3965,2703,459,1115,871,258,900,1409,242,152,1262,147,345,427,343,1122,140
56472,2143,1483,179,654,517,133,467,822,149,45,660,111,173,226,150,560,100
56473,908,695,115,325,211,44,239,362,65,29,213,41,78,52,42,168,45
56474,1602,1070,149,509,315,97,365,557,117,31,532,43,117,152,220,482,50
56475,547,441,84,217,106,34,189,187,39,26,106,17,30,32,27,98,8
56477,1091,783,146,321,265,51,284,397,49,53,308,47,82,95,84,269,39
56479,2089,1404,238,662,432,72,484,675,169,76,685,161,158,149,217,576,109
56481,791,581,80,296,170,35,230,268,53,30,210,25,73,72,40,185,25
56482,2772,1800,317,753,510,220,670,811,207,112,972,225,244,224,279,873,99
56484,1390,959,138,428,308,85,261,504,116,78,431,47,96,167,121,362,69
56501,6252,4108,753,1906,1172,277,1393,2042,502,171,2144,345,529,649,621,1882,262
56510,993,631,81,313,165,72,251,300,37,43,362,49,70,84,159,340,22
56511,642,478,90,220,135,33,160,242,48,28,164,27,42,65,30,144,20
56513,66,54,9,21,15,9,20,24,5,5,12,0,5,5,2,4,8
56514,1246,896,162,424,242,68,324,460,91,21,350,57,83,106,104,325,25
56515,1138,822,66,316,340,100,204,533,53,32,316,22,67,128,99,295,21
56516,115,96,20,42,29,5,47,37,7,5,19,5,2,5,7,17,2
56517,121,99,9,50,27,13,36,52,6,5,22,0,3,13,6,20,2
56518,122,101,13,53,19,16,40,44,8,9,21,12,5,0,4,14,7
56519,134,94,21,27,34,12,42,47,2,3,40,13,13,10,4,33,7
56520,1653,1098,237,485,292,84,472,452,112,62,555,119,147,124,165,487,68
56521,289,223,37,116,55,15,105,79,22,17,66,8,25,17,16,60,6
56522,271,212,26,86,72,28,77,113,11,11,59,3,20,20,16,53,6
56523,226,150,22,73,37,18,59,71,11,9,76,8,27,12,29,68,8
56524,300,225,16,95,97,17,64,154,5,2,75,5,20,28,22,72,3
56525,55,45,10,15,16,4,10,30,5,0,10,3,2,0,5,10,0
56527,317,227,36,99,79,13,90,112,9,16,90,11,25,21,33,78,12
56528,670,479,61,194,178,46,147,274,37,21,191,21,59,69,42,169,22
56529,1177,808,218,396,159,35,317,301,142,48,369,71,104,110,84,320,49
56531,897,606,91,270,183,62,239,298,41,28,291,56,50,71,114,258,33
56533,115,82,13,42,21,6,26,32,12,12,33,2,18,11,2,31,2
56534,442,325,36,154,115,20,115,171,29,10,117,9,40,44,24,104,13
56535,505,331,54,113,114,50,102,177,31,21,174,14,43,58,59,156,18
56536,226,164,36,73,50,5,63,90,11,0,62,16,18,13,15,55,7
56537,7618,4945,913,2315,1232,485,1782,2354,566,243,2673,491,697,671,814,2296,377
56540,805,568,95,233,164,76,203,283,42,40,237,32,29,60,116,222,15
56542,1163,748,153,287,221,87,267,339,96,46,415,55,73,136,151,383,32
56543,114,81,9,39,25,8,35,31,4,11,33,5,8,12,8,29,4
56544,1734,1283,246,603,368,66,509,608,111,55,451,68,123,141,119,392,59
56545,321,223,40,90,73,20,89,106,12,16,98,26,26,30,16,85,13
56546,139,107,27,42,34,4,37,55,11,4,32,3,7,13,9,27,5
56547,844,682,149,373,132,28,315,292,50,25,162,23,69,49,21,145,17
56548,347,245,30,116,73,26,84,128,22,11,102,6,24,35,37,99,3
56549,1498,1138,207,556,277,98,477,508,82,71,360,59,95,104,102,322,38
56550,171,118,23,68,24,3,57,52,5,4,53,6,17,23,7,51,2
56551,1006,678,81,272,253,72,204,410,39,25,328,46,53,98,131,299,29
56552,168,131,23,67,28,13,54,56,18,3,37,10,4,12,11,31,6
56553,131,89,15,44,27,3,41,30,14,4,42,10,18,8,6,38,4
56554,994,703,110,308,228,57,237,378,49,39,291,32,84,101,74,260,31
56556,491,322,36,157,98,31,101,177,33,11,169,9,31,53,76,160,9
56557,1088,743,136,334,207,66,224,328,118,73,345,42,61,101,141,311,34
56560,12624,7960,1657,4014,1735,554,3016,3349,1079,516,4664,1840,1057,859,908,3493,1171
56565,46,36,3,23,10,0,20,11,5,0,10,6,2,0,2,6,4
56566,111,75,10,45,17,3,22,14,27,12,36,4,9,17,6,26,10
56567,1211,878,150,399,245,84,347,414,78,39,333,69,59,105,100,306,27
56568,73,45,6,21,16,2,13,24,4,4,28,3,6,11,8,28,0
56569,516,357,60,180,97,20,118,114,85,40,159,23,44,55,37,139,20
56570,493,381,40,165,136,40,113,222,18,28,112,22,35,30,25,99,13
56571,669,511,34,230,212,35,170,294,24,23,158,22,56,53,27,142,16
56572,2164,1583,249,753,427,154,595,799,119,70,581,84,151,169,177,503,78
56573,2250,1549,277,727,415,130,616,702,179,52,701,106,198,165,232,622,79
56574,137,100,20,44,34,2,56,39,2,3,37,2,22,7,6,33,4
56575,242,183,39,71,61,12,35,80,48,20,59,3,18,26,12,53,6
56576,398,286,24,108,135,19,76,193,12,5,112,20,33,36,23,103,9
56578,352,270,37,119,89,25,87,151,16,16,82,12,27,34,9,65,17
56579,451,335,46,162,95,32,139,156,23,17,116,32,26,18,40,100,16
56580,295,246,49,134,49,14,125,99,12,10,49,10,13,17,9,40,9
56581,147,92,17,43,21,11,29,45,16,2,55,10,13,17,15,55,0
56583,81,52,5,24,21,2,15,29,4,4,29,9,3,11,6,27,2
56584,667,442,53,196,130,63,154,225,41,22,225,21,43,84,77,212,13
56585,397,268,41,131,72,24,96,127,23,22,129,11,27,31,60,111,18
56586,714,535,68,218,182,67,154,314,43,24,179,21,49,53,56,157,22
56587,559,400,42,166,148,44,107,242,29,22,159,21,61,48,29,134,25
56588,199,149,18,54,61,16,40,96,8,5,50,4,12,20,14,50,0
56589,719,527,69,259,155,44,171,238,67,51,192,27,46,66,53,168,24
56590,160,121,17,56,34,14,42,63,6,10,39,8,10,14,7,32,7
56592,196,124,24,46,41,13,35,69,12,8,72,21,23,10,18,64,8
56594,192,149,31,60,42,16,56,70,4,19,43,3,13,11,16,38,5
56601,10714,7107,1627,3406,1639,435,2632,3000,967,508,3607,1224,992,708,683,2718,889
56621,1690,1183,215,565,316,87,392,538,162,91,507,71,113,143,180,453,54
56623,1439,947,132,460,270,85,340,497,83,27,492,77,146,135,134,438,54
56626,170,132,0,64,60,8,22,53,10,47,38,2,10,16,10,24,14
56627,174,117,15,42,49,11,26,70,15,6,57,6,25,19,7,50,7
56628,759,501,59,187,208,47,123,325,34,19,258,21,75,91,71,237,21
56629,16,10,2,3,5,0,2,8,0,0,6,0,0,0,6,6,0
56630,879,625,117,267,181,60,198,295,82,50,254,25,60,95,74,224,30
56633,1428,1057,241,471,302,43,270,313,327,147,371,46,143,110,72,312,59
56634,654,432,70,184,136,42,141,238,37,16,222,38,37,58,89,208,14
56636,1741,1296,232,597,368,99,457,594,140,105,445,44,91,201,109,388,57
56637,104,83,18,35,26,4,29,41,6,7,21,5,5,8,3,16,5
56639,173,132,23,40,58,11,28,90,7,7,41,4,13,14,10,33,8
56641,131,81,8,42,23,8,13,30,28,10,50,2,20,18,10,45,5
56644,331,209,27,94,70,18,80,110,9,10,122,22,33,28,39,111,11
56646,160,97,11,40,36,10,30,63,2,2,63,10,20,10,23,60,3
56647,266,201,32,79,80,10,68,106,15,12,65,11,16,24,14,54,11
56649,4584,2976,514,1427,818,217,960,1468,408,140,1608,231,505,489,383,1410,198
56650,331,211,39,108,48,16,79,93,28,11,120,12,11,43,54,118,2
56651,234,146,19,63,53,11,47,65,14,20,88,12,23,28,25,80,8
56652,217,157,24,65,54,14,57,76,5,19,60,4,14,26,16,56,4
56653,540,387,50,205,106,26,130,193,37,27,153,19,38,53,43,136,17
56654,53,41,2,22,13,4,11,22,6,2,12,2,0,3,7,11,1
56655,648,457,37,135,235,50,115,305,11,26,191,14,56,60,61,169,22
56657,145,85,12,28,41,4,16,57,4,8,60,1,13,22,24,52,8
56659,63,52,11,21,16,4,18,23,5,6,11,0,2,2,7,8,3
56660,122,96,12,44,31,9,22,55,10,9,26,2,7,13,4,25,1
56661,391,276,36,118,83,39,107,138,12,19,115,8,19,46,42,108,7
56662,232,152,7,62,78,5,30,113,7,2,80,10,27,25,18,70,10
56663,86,41,0,20,21,0,6,35,0,0,45,0,25,20,0,40,5
56666,230,212,100,88,24,0,38,20,104,50,18,0,3,15,0,15,3
56667,259,199,25,102,58,14,65,96,23,15,60,6,25,19,10,51,9
56669,178,108,0,56,52,0,6,93,9,0,70,0,27,25,18,70,0
56670,538,447,134,209,93,11,98,64,198,87,91,0,56,29,6,83,8
56671,557,444,111,235,82,16,89,66,166,123,113,18,61,21,13,99,14
56672,909,587,81,213,243,50,116,379,71,21,322,17,60,178,67,281,41
56673,326,217,42,116,48,11,82,79,30,26,109,12,16,49,32,101,8
56676,686,472,87,204,135,46,184,237,28,23,214,22,76,70,46,165,49
56678,287,210,42,113,47,8,94,78,22,16,77,8,25,37,7,69,8
56680,41,22,4,4,10,4,11,11,0,0,19,0,8,9,2,17,2
56681,126,70,10,28,32,0,16,35,11,8,56,2,8,29,17,50,6
56683,205,158,26,83,38,11,64,82,6,6,47,5,15,14,13,43,4
56684,158,119,12,59,36,12,43,64,5,7,39,2,18,9,10,34,5
56685,70,43,2,12,22,7,8,33,0,2,27,0,4,13,10,27,0
56686,417,277,30,117,108,22,90,146,9,32,140,12,40,56,32,101,39
56687,53,37,9,19,4,5,12,11,10,4,16,3,7,6,0,16,0
56688,51,40,4,18,12,6,10,26,4,0,11,0,6,4,1,11,0
56701,5015,3244,731,1400,782,331,1131,1509,383,221,1771,494,495,385,397,1487,284
56710,183,131,26,66,35,4,60,61,9,1,52,7,16,12,17,45,7
56711,44,33,0,24,9,0,9,24,0,0,11,0,11,0,0,11,0
56712,103,83,8,54,11,10,49,31,0,3,20,2,4,6,8,13,7
56713,404,294,41,134,79,40,114,151,19,10,110,16,25,33,36,101,9
56714,581,419,91,201,100,27,163,186,48,22,162,31,51,31,49,141,21
56715,163,110,14,54,36,6,40,54,7,9,53,11,16,13,13,46,7
56716,3643,2335,490,1183,491,171,952,967,278,138,1308,274,319,351,364,1153,155
56720,33,23,4,13,2,4,11,6,4,2,10,3,0,7,0,10,0
56721,3455,2369,497,1202,550,120,950,927,336,156,1086,290,292,249,255,918,168
56722,147,123,13,58,41,11,39,75,5,4,24,3,8,1,12,19,5
56723,440,346,66,166,92,22,143,149,18,36,94,17,32,26,19,75,19
56724,91,68,7,17,32,12,9,54,3,2,23,0,7,12,4,23,0
56725,375,260,30,124,81,25,108,118,14,20,115,24,36,25,30,109,6
56726,696,494,110,202,142,40,199,240,32,23,202,26,48,53,75,192,10
56727,324,214,35,86,50,43,73,103,28,10,110,15,29,40,26,98,12
56728,643,423,55,207,107,54,177,199,22,25,220,18,56,66,80,206,14
56729,88,63,14,29,18,2,17,35,8,3,25,5,10,8,2,25,0
56731,37,27,2,12,9,4,16,11,0,0,10,0,6,2,2,8,2
56732,499,334,72,111,96,55,97,164,41,32,165,23,30,53,59,147,18
56733,250,185,16,85,57,27,65,103,5,12,65,17,20,18,10,65,0
56734,252,156,26,56,50,24,44,80,15,17,96,9,42,29,16,82,14
56735,346,240,27,120,74,19,91,121,18,10,106,11,19,40,36,101,5
56736,368,263,35,115,82,31,76,155,18,14,105,10,26,35,34,99,6
56737,383,250,43,109,81,17,84,137,19,10,133,17,44,40,32,123,10
56738,545,375,53,182,112,28,137,192,25,21,170,39,45,43,43,158,12
56741,12,12,0,12,0,0,0,12,0,0,0,0,0,0,0,0,0
56742,333,212,41,102,47,22,85,98,22,7,121,14,25,45,37,113,8
56744,229,149,34,51,34,30,56,80,9,4,80,2,26,25,27,75,5
56748,266,173,27,78,52,16,67,90,10,6,93,9,16,32,36,88,5
56750,1013,683,123,335,169,56,269,304,68,42,330,65,83,94,88,287,43
56751,2273,1603,326,780,339,158,649,707,158,89,670,134,196,169,171,607,63
56754,204,132,19,76,37,0,54,59,13,6,72,20,27,17,8,58,14
56755,76,44,10,24,9,1,22,18,2,2,32,6,9,11,6,30,2
56756,305,231,73,120,36,2,119,69,28,15,74,15,39,16,4,52,22
56757,442,303,23,157,94,29,130,137,18,18,139,15,23,36,65,135,4
56758,155,104,9,58,29,8,39,56,7,2,51,13,8,23,7,41,10
56759,115,73,8,43,20,2,29,37,2,5,42,5,7,4,26,42,0
56760,161,120,25,55,26,14,42,63,12,3,41,7,12,12,10,41,0
56761,212,163,26,73,51,13,62,82,10,9,49,2,16,24,7,44,5
56762,980,654,110,293,174,77,221,349,51,33,326,37,86,85,118,313,13
56763,1868,1371,327,719,261,64,641,508,176,46,497,124,194,101,78,418,79
57001,827,613,65,319,167,62,254,306,38,15,214,36,53,44,81,198,16
57002,337,252,54,127,65,6,112,123,13,4,85,39,26,12,8,67,18
57003,582,450,134,212,79,25,204,177,49,20,132,33,43,34,22,104,28
57004,1338,928,180,420,220,108,354,458,66,50,410,117,79,78,136,353,57
57005,2393,2026,488,1139,323,76,998,714,244,70,367,68,160,94,45,338,29
57006,7952,4214,1099,1953,854,308,1645,1838,505,226,3738,2288,587,429,434,2563,1175
57010,173,117,19,67,25,6,56,61,0,0,56,18,16,22,0,45,11
57012,418,293,43,147,74,29,117,142,23,11,125,13,29,46,37,114,11
57013,1661,1170,250,494,269,157,522,511,90,47,491,91,151,115,134,455,36
57014,673,465,71,224,124,46,158,253,31,23,208,35,32,49,92,192,16
57015,287,218,36,114,44,24,101,98,8,11,69,18,16,21,14,66,3
57016,273,208,40,95,50,23,85,117,6,0,65,10,36,15,4,45,20
57017,487,372,74,188,82,28,182,161,19,10,115,30,34,24,27,98,17
57018,529,379,60,199,83,37,173,164,23,19,150,24,46,44,36,123,27
57020,366,309,80,193,21,15,164,103,29,13,57,13,24,9,11,45,12
57021,126,87,20,39,20,8,40,44,3,0,39,12,6,5,16,30,9
57022,1534,1141,227,510,291,113,482,537,86,36,393,92,73,81,147,352,41
57024,163,112,23,56,26,7,48,48,12,4,51,14,17,8,12,48,3
57025,1044,745,153,334,193,65,283,380,57,25,299,55,96,77,71,269,30
57026,501,365,50,176,100,39,146,183,23,13,136,34,22,36,44,123,13
57027,10,8,0,2,6,0,2,6,0,0,2,0,2,0,0,2,0
57028,1404,921,160,440,230,91,255,420,198,48,483,92,163,89,139,424,59
57029,965,638,80,281,171,106,242,333,19,44,327,35,66,101,125,314,13
57030,909,697,132,370,152,43,327,270,68,32,212,34,81,40,57,186,26
57031,257,173,30,92,36,15,57,84,28,4,84,15,22,22,25,71,13
57032,810,709,164,408,99,38,330,289,53,37,101,28,36,26,11,67,34
57033,1350,1136,213,644,199,80,542,428,111,55,214,59,71,60,24,164,50
57034,329,222,32,116,51,23,102,87,20,13,107,17,27,38,25,95,12
57035,389,306,80,134,80,12,118,139,35,14,83,13,18,19,33,77,6
57036,348,250,41,125,58,26,85,131,17,17,98,17,23,25,33,91,7
57037,389,275,52,124,70,29,114,135,16,10,114,18,29,42,25,103,11
57038,438,327,84,165,65,13,152,131,26,18,111,32,27,28,24,98,13
57039,1240,893,191,453,185,64,393,396,80,24,347,74,75,93,105,296,51
57040,175,148,17,77,50,4,72,59,7,10,27,2,6,7,12,23,4
57041,37,32,4,23,5,0,17,15,0,0,5,0,0,0,5,5,0
57042,3293,2066,395,925,547,199,709,1060,242,55,1227,398,291,287,251,1023,204
57043,585,426,51,197,139,39,172,216,20,18,159,11,52,42,54,144,15
57044,97,67,10,41,7,9,13,27,23,4,30,9,11,6,4,27,3
57045,477,341,45,116,116,64,104,206,22,9,136,15,28,33,60,128,8
57046,275,207,39,100,46,22,69,114,20,4,68,10,32,23,3,65,3
57047,111,83,5,41,28,9,25,49,5,4,28,2,8,8,10,24,4
57048,360,258,55,118,48,37,91,122,21,24,102,23,17,29,33,92,10
57049,1749,1269,309,654,254,52,510,570,155,34,480,145,179,99,57,385,95
57050,86,54,7,25,18,4,25,26,3,0,32,2,7,6,17,31,1
57051,181,114,14,40,31,29,24,64,19,7,67,6,10,27,24,67,0
57052,154,115,12,59,40,4,45,65,3,2,39,7,7,14,11,37,2
57053,758,555,89,263,141,62,206,283,41,25,203,51,46,57,49,167,36
57054,193,130,12,65,34,19,55,63,7,5,63,6,18,19,20,59,4
57055,397,335,66,205,58,6,149,140,44,2,62,0,54,6,2,50,12
57057,56,37,5,24,6,2,18,14,3,2,19,11,3,2,3,18,1
57058,789,538,97,239,133,69,223,245,44,26,251,27,42,83,99,236,15
57059,643,428,63,182,116,67,160,228,24,16,215,21,43,61,90,205,10
57061,60,49,17,18,5,9,22,23,0,4,11,0,2,2,7,10,1
57062,542,376,41,174,119,42,121,213,36,6,166,32,46,41,47,154,12
57063,357,267,35,126,77,29,95,153,4,15,90,7,16,20,47,87,3
57064,867,736,271,358,95,12,386,238,87,25,131,40,55,21,15,104,27
57065,174,121,24,50,34,13,55,60,4,2,53,13,27,6,7,41,12
57066,733,485,66,213,142,64,167,255,29,34,248,32,57,91,68,228,20
57067,187,131,18,79,32,2,72,46,10,3,56,20,21,12,3,42,14
57068,545,468,98,250,87,33,204,210,36,18,77,15,23,25,14,62,15
57069,4053,2101,676,868,414,143,754,922,330,95,1952,1133,383,242,194,1315,637
57070,584,381,43,180,114,44,143,189,28,21,203,39,34,37,93,194,9
57071,934,698,172,308,173,45,299,299,60,40,236,46,75,54,61,214,22
57072,233,173,42,76,45,10,74,69,18,12,60,9,24,19,8,53,7
57073,276,197,30,100,45,22,85,84,20,8,79,22,12,23,22,78,1
57074,35,23,2,14,2,5,6,14,3,0,12,2,2,4,4,10,2
57075,297,223,30,121,60,12,96,110,8,9,74,15,38,11,10,51,23
57076,177,143,12,56,61,14,64,72,3,4,34,2,3,18,11,29,5
57077,384,298,57,157,57,27,118,140,30,10,86,19,26,22,19,70,16
57078,6851,4409,986,2057,961,405,1712,1946,525,226,2442,629,710,574,529,2106,336
57103,12659,8785,2062,4504,1809,410,3496,3488,1237,564,3874,1254,1342,783,495,3088,786
57104,11381,5295,1773,2262,1001,259,1803,1876,1036,580,6086,2258,1814,1120,894,4965,1121
57105,9809,6273,1193,2614,1816,650,1997,3185,600,491,3536,955,1075,753,753,2966,570
57106,11202,7184,2354,3411,1172,247,3010,2938,891,345,4018,1762,1061,614,581,2917,1101
57107,1930,1431,419,632,340,40,509,607,167,148,499,188,174,129,8,356,143
57108,2394,1788,363,986,339,100,785,837,127,39,606,213,229,76,88,485,121
57110,2838,2352,542,1399,396,15,1159,878,243,72,486,146,171,129,40,361,125
57201,9526,6303,1432,3013,1398,460,2483,2717,602,501,3223,963,731,705,824,2696,527
57212,801,583,64,248,189,82,189,356,22,16,218,34,40,65,79,197,21
57213,204,151,16,72,50,13,50,82,11,8,53,8,14,13,18,51,2
57214,64,45,8,12,17,8,10,24,8,3,19,0,2,10,7,19,0
57216,483,327,34,155,92,46,142,168,4,13,156,23,42,47,44,145,11
57217,146,100,12,21,32,35,12,70,13,5,46,12,10,5,19,44,2
57218,139,96,13,46,33,4,37,52,7,0,43,10,12,4,17,36,7
57219,278,171,23,79,47,22,71,83,9,8,107,11,27,33,36,98,9
57220,345,268,42,136,56,34,111,135,12,10,77,25,16,19,17,74,3
57221,271,179,24,98,37,20,94,71,11,3,92,9,21,16,46,86,6
57223,512,395,68,205,86,36,190,163,32,10,117,20,29,43,25,108,9
57224,103,79,13,37,22,7,26,41,7,5,24,3,6,8,7,24,0
57225,734,481,51,217,146,67,184,247,29,21,253,38,57,66,92,227,26
57226,819,548,99,260,127,62,229,268,31,20,271,67,53,58,93,240,31
57227,110,82,9,30,33,10,25,45,0,12,28,0,9,16,3,25,3
57231,797,538,68,234,165,71,179,298,39,22,259,38,38,73,110,251,8
57232,162,115,15,35,50,15,35,50,15,15,47,5,18,9,15,42,5
57233,64,53,2,24,23,4,17,36,0,0,11,0,0,5,6,11,0
57234,507,344,50,142,115,37,125,192,16,11,163,29,33,28,73,154,9
57235,280,215,38,108,58,11,77,101,27,10,65,18,20,12,15,61,4
57236,109,92,9,57,21,5,44,43,0,5,17,0,5,4,8,17,0
57237,294,199,16,78,84,21,56,128,7,8,95,10,25,26,34,91,4
57238,196,143,17,76,40,10,65,52,5,21,53,11,6,19,17,48,5
57239,119,67,7,35,17,8,24,38,5,0,52,0,17,12,23,52,0
57241,291,222,64,108,40,10,108,75,29,10,69,15,11,14,29,67,2
57242,150,110,11,39,42,18,40,68,1,1,40,7,11,8,14,38,2
57243,214,171,22,93,48,8,79,77,4,11,43,13,8,11,11,38,5
57244,49,37,6,29,2,0,13,20,2,2,12,5,3,2,2,12,0
57245,30,22,11,6,3,2,12,4,4,2,8,4,2,2,0,6,2
57246,72,55,5,34,9,7,30,21,3,1,17,0,4,5,8,17,0
57247,116,86,2,43,33,8,32,48,2,4,30,1,14,11,4,29,1
57248,298,192,43,80,50,19,77,94,10,11,106,17,33,33,23,98,8
57249,484,302,44,147,77,34,101,161,31,9,182,23,42,53,64,167,15
57251,57,41,0,21,14,6,15,19,3,4,16,2,4,2,8,16,0
57252,2028,1371,220,652,355,144,582,642,104,43,657,124,171,159,203,611,46
57255,219,163,40,49,55,19,59,71,16,17,56,10,9,16,21,54,2
57256,27,27,6,10,5,6,14,13,0,0,0,0,0,0,0,0,0
57257,236,197,24,108,52,13,52,65,55,25,39,0,18,11,10,30,9
57258,85,63,9,29,12,13,26,24,6,7,22,6,7,5,4,21,1
57259,227,170,21,89,55,5,65,93,6,6,57,15,7,20,15,53,4
57260,355,257,34,105,84,34,93,145,10,9,98,7,36,26,29,88,10
57261,173,125,14,65,36,10,48,62,13,2,48,11,5,7,25,42,6
57262,1695,1186,236,557,305,88,366,436,244,140,509,62,130,184,133,479,30
57263,206,150,23,76,36,15,53,81,9,7,56,3,29,15,9,50,6
57264,90,65,22,18,24,1,23,34,7,1,25,6,6,4,9,25,0
57265,97,70,14,24,27,5,25,39,3,3,27,0,6,6,15,27,0
57266,253,184,27,86,55,16,71,76,25,12,69,14,14,20,21,61,8
57268,183,122,14,55,34,19,38,64,8,12,61,9,19,14,19,57,4
57269,143,120,23,49,34,14,51,62,2,5,23,0,5,10,8,23,0
57270,258,178,47,50,53,28,44,83,41,10,80,10,21,7,42,77,3
57271,135,108,9,54,24,21,43,59,5,1,27,2,6,11,8,27,0
57272,88,54,8,22,16,8,15,34,3,2,34,2,15,6,11,33,1
57273,492,335,49,148,101,37,98,140,63,34,157,4,49,58,46,142,15
57274,1282,846,139,351,237,119,280,441,64,61,436,68,87,118,163,406,30
57276,441,336,59,181,76,20,145,138,21,32,105,26,28,23,28,94,11
57278,277,197,33,78,69,17,84,100,9,4,80,7,13,32,28,79,1
57279,513,337,47,158,97,35,123,152,41,21,176,22,47,39,68,167,9
57301,7047,4401,1029,1952,1024,396,1628,1982,560,231,2646,718,660,553,715,2226,420
57311,511,398,71,198,105,24,197,183,7,11,113,18,30,27,38,107,6
57312,228,173,23,81,48,21,60,96,15,2,55,12,11,10,22,53,2
57313,511,334,38,145,111,40,114,188,21,11,177,24,50,39,64,170,7
57314,253,190,22,83,62,23,73,103,10,4,63,18,17,15,13,49,14
57315,437,310,34,131,102,43,121,165,12,12,127,31,14,25,57,125,2
57317,277,217,34,93,56,34,75,109,20,13,60,2,18,18,22,57,3
57319,466,328,71,123,105,29,141,162,10,15,138,13,40,40,45,130,8
57321,210,147,18,75,29,25,60,74,8,5,63,22,9,16,16,59,4
57322,115,99,13,33,38,15,33,45,2,19,16,0,6,4,6,16,0
57323,158,99,15,43,23,18,33,57,3,6,59,7,19,20,13,57,2
57324,166,115,5,72,38,0,30,75,6,4,51,14,17,14,6,41,10
57325,1194,726,113,381,174,58,249,336,88,53,468,101,130,128,109,419,49
57328,470,357,42,155,116,44,143,175,20,19,113,24,13,9,67,111,2
57329,94,78,12,32,30,4,28,37,8,5,16,3,7,0,6,13,3
57330,266,196,16,116,42,22,108,80,4,4,70,15,12,21,22,64,6
57331,176,147,22,65,48,12,52,87,6,2,29,9,3,3,14,29,0
57332,342,254,41,95,90,28,100,130,10,14,88,5,16,25,42,86,2
57334,319,251,58,110,59,24,114,119,13,5,68,15,15,24,14,59,9
57335,129,78,11,36,27,4,30,45,2,1,51,1,9,22,19,49,2
57337,85,54,2,25,17,10,23,27,4,0,31,0,10,12,9,28,3
57339,358,299,80,142,69,8,75,45,125,54,59,7,24,21,7,51,8
57340,119,94,20,40,26,8,32,55,5,2,25,5,11,5,4,21,4
57341,71,45,1,20,17,7,14,30,0,1,26,7,3,8,8,24,2
57342,291,174,21,77,58,18,70,84,5,15,117,17,20,34,46,111,6
57344,72,63,15,15,27,6,29,34,0,0,9,0,4,3,2,9,0
57345,570,362,37,178,106,41,131,186,32,13,208,25,37,73,73,195,13
57346,41,37,14,11,12,0,10,12,11,4,4,0,0,4,0,4,0
57348,231,158,21,66,62,9,51,89,9,9,73,10,22,16,25,70,3
57349,758,485,68,209,124,84,181,240,32,32,273,54,65,57,97,253,20
57350,6056,3740,669,1766,911,394,1347,1742,460,191,2316,436,631,655,594,2085,231
57353,306,232,38,106,72,16,95,108,15,14,74,13,19,27,15,72,2
57355,538,378,51,169,109,49,137,199,24,18,160,37,32,39,52,147,13
57356,638,455,109,172,150,24,148,152,98,57,183,15,49,72,47,165,18
57358,30,12,1,6,5,0,0,8,2,2,18,7,5,6,0,16,2
57359,314,223,33,109,53,28,97,93,20,13,91,22,30,19,20,73,18
57361,66,53,16,22,8,7,3,3,32,15,13,0,5,6,2,13,0
57362,980,576,83,212,219,62,190,296,36,54,404,55,69,119,161,376,28
57363,406,319,55,157,86,21,143,137,23,16,87,15,26,27,19,70,17
57364,32,18,0,5,10,3,5,13,0,0,14,5,0,0,9,14,0
57365,185,117,16,76,21,4,44,55,16,2,68,24,14,22,8,54,14
57366,990,690,106,304,200,80,268,342,38,42,300,43,33,77,147,286,14
57367,80,52,10,20,18,4,20,29,3,0,28,0,14,10,4,22,6
57368,442,319,63,130,95,31,104,184,14,17,123,14,40,40,29,114,9
57369,990,710,102,310,214,84,308,356,26,20,280,36,57,71,116,275,5
57370,263,214,31,115,44,24,84,83,32,15,49,13,15,7,14,40,9
57371,113,105,5,41,52,7,21,77,2,5,8,5,1,2,0,8,0
57373,187,144,13,81,29,21,64,64,12,4,43,3,10,17,13,38,5
57374,153,118,17,50,49,2,55,58,2,3,35,6,13,9,7,33,2
57375,318,236,41,98,66,31,93,121,10,12,82,15,14,26,27,80,2
57376,497,324,59,108,109,48,110,170,25,19,173,20,42,57,54,162,11
57379,40,28,7,10,7,4,11,17,0,0,12,0,6,2,4,10,2
57380,1179,814,160,361,216,77,261,297,169,87,365,57,67,135,106,330,35
57381,290,191,22,90,64,15,58,115,6,12,99,14,11,33,41,96,3
57382,733,474,46,201,127,100,156,272,25,21,259,22,54,81,102,245,14
57383,307,201,28,84,67,22,64,104,15,18,106,5,24,38,39,101,5
57384,364,277,26,132,92,27,84,168,17,8,87,14,27,19,27,78,9
57385,598,409,54,201,110,44,126,217,43,23,189,14,57,64,54,170,19
57386,74,66,10,35,17,4,36,27,3,0,8,0,1,7,0,8,0
57401,12158,7525,1615,3569,1681,660,2667,3457,961,440,4633,1537,1113,1005,978,3924,709
57420,47,39,13,6,16,4,11,24,2,2,8,0,4,4,0,8,0
57421,47,39,8,17,8,6,20,17,0,2,8,2,2,4,0,8,0
57422,136,86,12,34,28,12,31,43,4,8,50,8,10,15,17,47,3
57424,140,111,16,54,28,13,38,58,10,5,29,0,18,5,6,26,3
57426,28,21,4,13,4,0,9,7,3,2,7,3,2,0,2,7,0
57427,208,156,43,51,48,14,70,85,1,0,52,3,29,17,3,48,4
57428,336,237,30,86,81,40,80,138,12,7,99,15,13,35,36,95,4
57430,959,641,108,271,185,77,247,292,52,50,318,42,74,86,116,295,23
57432,186,136,16,54,52,14,37,77,14,8,50,12,5,27,6,47,3
57433,181,138,12,63,54,9,31,91,4,12,43,0,14,12,17,43,0
57434,247,175,21,74,63,17,62,97,7,9,72,15,23,8,26,65,7
57435,130,99,7,43,38,11,27,60,4,8,31,9,7,7,8,29,2
57436,256,197,35,102,45,15,74,95,20,8,59,4,12,19,24,50,9
57437,783,519,37,207,173,102,163,322,6,28,264,22,35,88,119,251,13
57438,623,419,63,178,119,59,170,204,26,19,204,20,52,65,67,195,9
57440,230,176,23,81,64,8,68,92,4,12,54,10,11,17,16,52,2
57441,274,213,38,93,50,32,87,96,10,20,61,18,15,20,8,45,16
57442,715,461,45,211,141,64,152,239,44,26,254,14,72,74,94,246,8
57445,749,545,109,249,141,46,217,266,49,13,204,51,26,63,64,187,17
57446,243,174,16,87,47,24,74,82,8,10,69,18,16,12,23,60,9
57448,176,115,18,41,45,11,26,69,12,8,61,7,3,22,29,54,7
57449,91,56,5,29,16,6,19,35,2,0,35,10,8,5,12,33,2
57450,362,271,29,131,86,25,108,135,11,17,91,15,17,31,28,83,8
57451,554,397,58,179,116,44,189,172,21,15,157,21,31,55,50,152,5
57452,150,95,18,31,31,15,33,58,2,2,55,5,12,21,17,55,0
57454,255,168,20,83,46,19,62,91,4,11,87,11,18,23,35,84,3
57455,72,49,1,20,22,6,14,31,2,2,23,0,7,12,4,21,2
57456,410,287,46,104,107,30,94,175,14,4,123,23,20,33,47,119,4
57457,57,37,7,12,16,2,11,22,0,4,20,0,2,8,10,20,0
57460,129,98,6,56,28,8,41,45,3,9,31,8,12,9,2,21,10
57461,173,120,27,56,28,9,63,44,9,4,53,7,15,19,12,45,8
57462,290,230,12,137,66,15,64,144,10,12,60,9,20,28,3,50,10
57465,128,105,11,44,39,11,41,61,2,1,23,1,11,11,0,20,3
57466,75,53,5,27,15,6,28,23,0,2,22,0,4,6,12,22,0
57467,116,98,17,47,29,5,42,52,2,2,18,0,2,14,2,18,0
57468,117,67,6,33,18,10,26,34,0,7,50,0,8,16,26,47,3
57469,1474,943,143,410,279,111,323,468,105,47,531,82,98,143,208,483,48
57470,66,54,7,24,11,12,15,32,7,0,12,1,3,7,1,12,0
57471,281,181,29,84,44,24,78,94,2,7,100,15,16,39,30,90,10
57472,431,308,33,130,112,33,110,164,22,12,123,5,24,43,51,117,6
57473,78,55,4,16,16,19,10,43,2,0,23,0,7,6,10,23,0
57474,114,85,25,30,30,0,43,36,2,4,29,6,15,0,8,29,0
57475,71,61,6,13,33,9,10,43,0,8,10,2,0,2,6,10,0
57476,191,127,20,52,43,12,48,63,10,6,64,16,16,12,20,58,6
57477,78,44,6,24,8,6,18,24,0,2,34,4,2,14,14,32,2
57479,209,171,30,103,27,11,83,72,12,4,38,12,13,7,6,37,1
57481,226,195,26,80,77,12,80,95,7,13,31,4,22,1,4,26,5
57501,6219,4122,818,2036,1065,203,1641,1869,453,159,2097,407,816,462,412,1855,242
57520,74,42,0,15,20,7,13,27,0,2,32,2,9,11,10,29,3
57521,68,47,3,22,19,3,18,24,3,2,21,0,6,10,5,21,0
57522,202,156,21,69,54,12,50,82,12,12,46,9,9,12,16,43,3
57523,485,286,33,139,76,38,114,151,9,12,199,27,27,54,91,188,11
57526,55,52,26,10,11,5,27,16,8,1,3,0,0,3,0,3,0
57528,349,264,54,101,88,21,117,123,13,11,85,13,8,36,28,77,8
57529,241,166,23,88,40,15,85,62,9,10,75,4,38,21,12,62,13
57531,108,74,9,38,23,4,30,33,5,6,34,8,17,3,6,31,3
57532,1081,767,169,376,181,41,280,346,96,45,314,45,116,104,49,267,47
57533,845,536,66,224,160,86,171,281,52,32,309,27,67,80,135,294,15
57534,61,50,10,40,0,0,24,16,4,6,11,0,0,5,6,11,0
57536,217,150,23,63,53,11,40,75,21,14,67,4,20,23,20,65,2
57537,54,40,10,13,17,0,13,22,5,0,14,0,2,7,5,7,7
57538,116,74,9,24,33,8,24,44,2,4,42,6,6,18,12,42,0
57540,57,49,3,21,19,6,14,33,0,2,8,1,6,0,1,5,3
57541,50,42,13,14,5,10,16,19,7,0,8,0,0,0,8,8,0
57542,52,35,0,11,20,4,11,24,0,0,17,0,12,0,5,17,0
57543,371,249,40,113,73,23,83,107,41,18,122,18,26,47,31,113,9
57544,171,122,24,50,37,11,46,59,7,10,49,7,12,22,8,43,6
57547,54,45,10,9,12,14,10,24,9,2,9,4,0,0,5,9,0
57548,308,239,80,109,36,14,50,28,114,47,69,13,25,21,10,55,14
57551,834,567,102,290,133,42,203,196,113,55,267,32,68,93,74,233,34
57552,234,170,19,83,54,14,62,93,10,5,64,14,22,10,18,62,2
57553,57,53,7,28,7,11,16,27,5,5,4,0,0,0,4,4,0
57555,1087,817,242,387,169,19,189,212,326,90,270,54,82,95,39,234,36
57559,367,226,32,106,69,19,70,107,37,12,141,26,35,34,46,132,9
57560,138,97,22,46,22,7,33,28,29,7,41,14,16,7,4,38,3
57562,21,16,6,6,4,0,10,4,2,0,5,0,3,0,2,5,0
57563,78,36,5,19,12,0,9,5,18,4,42,12,17,13,0,38,4
57564,433,319,53,142,93,31,133,154,18,14,114,23,33,24,34,97,17
57566,272,232,56,106,19,51,74,23,67,68,40,15,18,1,6,35,5
57567,625,428,55,245,97,31,173,207,26,22,197,43,37,43,74,183,14
57568,319,231,19,107,80,25,78,107,24,22,88,26,14,12,36,84,4
57569,227,164,19,69,45,31,47,90,9,18,63,13,16,23,11,63,0
57570,523,410,117,219,61,13,108,36,158,108,113,27,56,27,3,86,27
57571,30,14,0,5,7,2,0,12,2,0,16,7,5,0,4,12,4
57572,465,385,96,175,100,14,62,51,167,105,80,15,19,26,20,67,13
57574,55,55,11,30,14,0,19,33,3,0,0,0,0,0,0,0,0
57576,113,79,0,48,19,12,35,33,3,8,34,5,9,20,0,34,0
57577,242,191,29,115,45,2,59,12,84,36,51,0,22,7,22,40,11
57578,22,18,2,10,3,3,2,13,3,0,4,0,1,1,2,4,0
57579,441,311,57,141,84,29,98,110,65,38,130,29,23,41,37,113,17
57580,1885,1217,197,554,329,137,418,591,126,82,668,63,170,203,232,603,65
57584,64,39,3,12,17,7,14,23,0,2,25,9,2,5,9,25,0
57585,88,67,13,28,16,10,13,26,16,12,21,0,9,8,4,18,3
57601,1779,1135,219,464,326,126,252,547,229,107,644,66,175,241,162,580,64
57620,257,153,17,77,40,19,62,65,14,12,104,16,18,42,28,102,2
57621,87,75,27,23,25,0,26,13,20,16,12,0,12,0,0,12,0
57622,89,75,12,51,9,3,15,3,36,21,14,2,9,3,0,10,4
57623,283,229,42,106,56,25,68,77,52,32,54,16,17,10,11,46,8
57625,1216,918,246,454,204,14,279,153,313,173,298,53,102,114,29,259,39
57626,400,284,32,131,90,31,110,122,27,25,116,18,30,38,30,110,6
57628,32,25,7,12,4,2,10,15,0,0,7,0,0,7,0,7,0
57631,153,112,21,57,24,10,34,64,6,8,41,3,15,13,10,37,4
57632,262,181,17,69,70,25,70,99,3,9,81,10,18,25,28,79,2
57633,215,160,25,67,45,23,66,72,11,11,55,7,8,21,19,52,3
57634,43,38,0,15,21,2,13,25,0,0,5,0,2,0,3,5,0
57636,62,28,11,11,6,0,9,14,5,0,34,6,13,15,0,34,0
57638,888,568,82,256,152,78,205,282,59,22,320,57,64,85,114,300,20
57640,111,73,0,31,27,15,11,51,5,6,38,11,11,8,8,34,4
57641,145,87,18,32,31,6,33,45,5,4,58,16,16,14,12,54,4
57642,638,482,79,238,133,32,141,111,116,114,156,29,45,54,28,129,27
57644,115,88,9,41,30,8,30,51,5,2,27,4,2,5,16,27,0
57645,73,54,2,29,13,10,23,17,6,8,19,8,2,3,6,14,5
57646,106,88,7,22,49,10,23,54,0,11,18,0,6,0,12,16,2
57648,206,124,13,62,27,22,61,61,2,0,82,3,9,26,44,82,0
57649,81,70,8,25,23,14,25,40,0,5,11,1,4,2,4,11,0
57650,29,20,0,10,7,3,4,16,0,0,9,0,5,2,2,9,0
57651,50,37,3,24,10,0,24,11,2,0,13,0,2,3,8,13,0
57652,122,101,9,42,48,2,15,14,33,39,21,0,8,8,5,21,0
57653,77,54,3,31,10,10,21,31,2,0,23,0,5,9,9,23,0
57656,322,252,54,109,75,14,78,103,45,26,70,12,25,17,16,62,8
57657,55,40,2,18,18,2,10,28,0,2,15,7,0,4,4,15,0
57658,119,93,29,31,27,6,22,14,27,30,26,2,16,8,0,24,2
57660,18,16,0,11,5,0,9,7,0,0,2,0,0,2,0,2,0
57661,55,48,15,18,9,6,17,3,14,14,7,3,2,2,0,7,0
57701,15629,9670,2778,4423,1889,580,3115,3574,2040,941,5959,1784,1943,1365,867,4813,1146
57702,11804,8501,1291,4405,2167,638,3079,4235,779,408,3303,722,1130,911,540,2700,603
57703,3877,2893,757,1466,561,109,1181,1112,438,162,984,296,378,251,59,758,226
57706,1200,1167,800,360,7,0,833,243,85,6,33,23,10,0,0,18,15
57714,184,171,60,60,44,7,70,29,38,34,13,0,8,5,0,4,9
57716,161,84,10,53,21,0,23,24,31,6,77,19,41,17,0,68,9
57717,2645,1800,340,942,434,84,720,758,210,112,845,147,164,331,203,725,120
57718,1739,1403,248,820,291,44,574,572,187,70,336,49,157,72,58,252,84
57719,1490,1138,412,536,180,10,418,400,268,52,352,183,86,59,24,237,115
57720,285,170,21,99,41,9,76,72,16,6,115,20,27,26,42,107,8
57722,168,124,16,63,23,22,43,46,11,24,44,2,11,19,12,37,7
57724,83,56,6,33,15,2,25,29,2,0,27,5,9,10,3,24,3
57725,59,34,0,4,28,2,2,25,0,7,25,0,10,6,9,18,7
57729,43,26,5,12,4,5,11,13,0,2,17,7,3,2,5,17,0
57730,2065,1401,209,602,490,100,417,821,143,20,664,102,191,202,169,581,83
57732,991,613,109,292,164,48,173,303,85,52,378,49,153,114,62,327,51
57735,589,396,35,190,125,46,118,240,25,13,193,20,50,68,55,163,30
57736,29,29,0,14,15,0,20,9,0,0,0,0,0,0,0,0,0
57737,26,20,7,6,7,0,7,13,0,0,6,0,0,0,6,6,0
57738,81,40,4,16,14,6,11,23,0,6,41,2,12,7,20,41,0
57742,53,49,3,32,9,5,21,23,3,2,4,0,2,2,0,2,2
57744,589,462,64,229,149,20,183,217,28,34,127,10,64,46,7,97,30
57745,714,521,56,290,150,25,174,246,60,41,193,25,79,68,21,152,41
57747,2382,1490,202,680,440,168,374,848,183,85,892,79,275,350,188,810,82
57748,108,76,20,31,23,2,23,25,23,5,32,0,19,10,3,30,2
57750,105,71,9,38,21,3,28,29,2,12,34,13,4,15,2,26,8
57751,279,161,29,73,43,16,55,72,26,8,118,8,47,42,21,98,20
57752,569,428,121,191,85,31,142,68,112,106,141,24,64,43,10,135,6
57754,1579,1018,178,504,295,41,348,447,143,80,561,157,197,107,100,461,100
57755,48,38,12,9,17,0,14,24,0,0,10,3,0,5,2,10,0
57756,153,137,41,71,25,0,21,25,41,50,16,0,8,8,0,8,8
57758,51,38,13,5,7,13,15,23,0,0,13,8,0,0,5,13,0
57759,121,103,10,61,14,18,30,63,10,0,18,0,6,12,0,7,11
57760,509,386,48,173,118,47,104,203,51,28,123,18,38,34,33,108,15
57761,405,319,72,134,72,41,105,154,43,17,86,3,27,32,24,67,19
57762,200,153,23,86,31,13,71,52,27,3,47,6,11,22,8,44,3
57763,142,104,8,28,53,15,11,76,8,9,38,7,6,14,11,34,4
57764,324,270,64,112,87,7,48,46,110,66,54,0,31,0,23,50,4
57765,30,26,4,20,2,0,20,6,0,0,4,0,0,4,0,4,0
57766,120,72,16,41,13,2,24,38,6,4,48,5,14,16,13,34,14
57767,40,31,2,25,2,2,10,19,2,0,9,4,5,0,0,9,0
57769,1186,938,205,502,203,28,411,384,128,15,248,74,74,76,24,205,43
57770,1120,1020,202,546,211,61,270,178,350,222,100,12,21,58,9,78,22
57772,334,280,80,142,38,20,79,21,129,51,54,24,26,4,0,44,10
57773,102,86,7,31,28,20,24,58,3,1,16,3,7,4,2,11,5
57774,34,26,0,18,5,3,14,8,2,2,8,0,2,1,5,8,0
57775,90,73,15,34,22,2,38,32,0,3,17,2,0,6,9,17,0
57777,69,53,5,24,24,0,11,24,11,7,16,11,0,5,0,16,0
57778,32,22,0,13,6,3,10,12,0,0,10,0,6,2,2,10,0
57779,58,38,0,31,7,0,5,16,10,7,20,5,15,0,0,10,10
57780,67,45,10,20,10,5,17,23,5,0,22,2,9,11,0,18,4
57783,5304,3172,645,1460,787,280,1054,1587,365,166,2132,695,470,472,495,1673,459
57785,3742,2523,436,1238,645,204,873,1197,308,145,1219,140,372,388,319,1040,179
57787,102,84,19,34,31,0,34,43,0,7,18,0,13,5,0,18,0
57788,226,174,26,88,56,4,65,94,10,5,52,2,35,10,5,30,22
57790,440,280,41,131,78,30,108,147,21,4,160,26,33,63,38,142,18
57791,51,21,8,5,8,0,8,8,5,0,30,3,6,16,5,25,5
57792,38,27,4,12,5,6,11,16,0,0,11,6,0,5,0,11,0
57793,589,440,88,222,102,28,188,168,60,24,149,17,78,27,27,133,16
57794,103,103,22,57,24,0,49,10,33,11,0,0,0,0,0,0,0
57799,13,13,7,6,0,0,7,6,0,0,0,0,0,0,0,0,0
58001,116,69,10,42,11,6,32,25,12,0,47,18,13,16,0,39,8
58004,111,82,4,44,31,3,31,44,1,6,29,0,22,5,2,17,12
58005,174,133,13,76,36,8,52,73,5,3,41,1,27,8,5,38,3
58006,173,131,34,55,36,6,67,50,12,2,42,2,16,12,12,42,0
58007,67,44,3,21,13,7,22,22,0,0,23,8,2,8,5,16,7
58008,91,63,7,33,17,6,30,25,6,2,28,4,6,8,10,24,4
58009,35,20,1,7,12,0,4,12,0,4,15,0,4,11,0,15,0
58011,167,130,9,62,45,14,51,75,2,2,37,4,6,8,19,35,2
58012,784,560,151,268,102,39,270,220,47,23,224,48,52,62,62,196,28
58013,70,48,2,17,24,5,9,34,2,3,22,3,4,7,8,22,0
58015,116,100,13,66,18,3,44,52,0,4,16,4,3,8,1,14,2
58016,78,60,12,27,9,12,12,39,9,0,18,5,1,2,10,14,4
58017,177,139,24,67,28,20,62,64,5,8,38,8,2,9,19,36,2
58018,108,76,8,47,12,9,40,36,0,0,32,2,5,10,15,32,0
58021,170,151,30,79,29,13,51,79,6,15,19,11,6,2,0,13,6
58027,597,422,57,198,130,37,151,220,36,15,175,28,48,46,53,158,17
58029,52,41,0,23,14,4,16,20,5,0,11,0,1,1,9,11,0
58030,299,223,29,124,43,27,98,97,12,16,76,11,18,17,30,69,7
58031,199,152,10,97,27,18,63,78,5,6,47,15,11,10,11,44,3
58032,302,199,38,93,52,16,90,94,9,6,103,12,31,33,27,101,2
58033,165,129,12,46,56,15,37,78,11,3,36,14,1,14,7,36,0
58035,144,89,29,21,15,24,35,47,5,2,55,8,19,10,18,55,0
58036,128,86,9,37,26,14,32,41,6,7,42,4,21,7,10,29,13
58038,143,106,17,41,33,15,29,59,4,14,37,6,12,13,6,32,5
58039,34,28,11,12,3,2,19,7,2,0,6,0,2,4,0,6,0
58040,342,232,42,107,62,21,91,113,15,13,110,39,36,16,19,90,20
58041,700,449,49,231,120,49,180,209,27,33,251,32,48,85,86,233,18
58042,426,381,70,225,67,19,211,132,21,17,45,9,11,18,7,34,11
58043,100,76,7,27,32,10,22,49,0,5,24,0,9,7,8,20,4
58045,941,616,99,299,146,72,246,257,70,43,325,35,100,101,89,305,20
58046,228,152,29,65,45,13,62,74,14,2,76,12,22,16,26,72,4
58047,716,596,141,352,89,14,311,227,45,13,120,21,50,36,13,79,41
58048,212,146,23,60,50,13,47,86,5,8,66,12,8,21,25,66,0
58049,133,92,7,46,28,11,38,44,3,7,41,4,16,11,10,34,7
58051,502,403,69,221,87,26,209,154,32,8,99,14,31,20,34,94,5
58052,244,166,26,77,43,20,55,93,16,2,78,12,27,18,21,63,15
58053,585,383,37,172,130,44,103,191,49,40,202,25,36,46,95,183,19
58054,1354,872,142,462,176,92,370,422,59,21,482,92,111,123,156,440,42
58056,69,56,10,17,27,2,21,35,0,0,13,2,4,2,5,13,0
58057,67,53,9,14,19,11,11,34,4,4,14,5,2,4,3,14,0
58058,61,39,3,21,11,4,12,24,3,0,22,2,2,6,12,22,0
58059,346,271,59,158,43,11,130,109,12,20,75,12,32,12,19,63,12
58060,570,404,56,204,108,36,171,186,27,20,166,35,28,44,59,147,19
58061,191,101,17,50,26,8,47,49,3,2,90,31,31,16,12,82,8
58062,89,71,13,25,17,16,27,40,2,2,18,0,6,4,8,16,2
58063,141,112,25,56,29,2,55,36,5,16,29,4,9,7,9,28,1
58064,225,150,8,60,57,25,54,91,0,5,75,12,32,22,9,64,11
58067,138,88,7,46,28,7,31,47,5,5,50,9,8,13,20,47,3
58068,147,94,16,38,23,17,38,47,3,6,53,13,4,23,13,53,0
58069,108,72,13,33,16,10,25,44,2,1,36,4,13,15,4,33,3
58071,177,133,27,70,27,9,49,69,12,3,44,2,14,15,13,32,12
58072,3516,2131,360,897,600,274,605,1098,256,172,1385,343,306,271,465,1225,160
58075,3843,2302,548,1101,495,158,942,964,247,149,1541,651,346,280,264,1198,343
58077,229,189,27,110,42,10,86,86,6,11,40,10,4,11,15,32,8
58078,5735,4133,1206,2104,680,143,1804,1572,547,210,1602,493,575,323,211,1326,276
58079,182,151,11,83,46,11,54,88,6,3,31,12,0,4,15,31,0
58081,352,261,42,137,61,21,121,102,27,11,91,16,27,27,21,78,13
58102,13284,6881,1585,3388,1491,417,2592,3030,791,468,6403,3086,1614,934,769,4919,1484
58103,21667,11158,3660,4893,2078,527,3912,4637,1631,978,10509,5120,2794,1584,1011,7610,2899
58104,5677,4115,1100,2378,501,136,2122,1499,345,149,1562,728,389,242,203,1166,396
58201,13746,8022,1817,4003,1749,453,2974,3422,1015,611,5724,2432,1363,1036,893,4183,1541
58202,0,0,0,0,0,0,0,0,0,0,0,0,0,0,0,0,0
58203,6569,3685,1369,1553,569,194,1371,1418,608,288,2884,1481,849,308,246,2079,805
58204,1283,1241,813,428,0,0,897,246,90,8,42,20,22,0,0,29,13
58210,183,130,13,45,50,22,39,72,9,10,53,3,16,18,16,46,7
58212,226,137,11,68,41,17,55,66,8,8,89,14,19,21,35,84,5
58213,114,89,24,40,21,4,33,42,10,4,25,0,8,10,7,22,3
58214,184,134,24,61,39,10,40,67,27,0,50,11,26,13,0,50,0
58216,76,59,5,29,21,4,25,27,3,4,17,4,4,5,4,15,2
58218,285,218,54,99,49,16,99,105,9,5,67,16,14,22,15,61,6
58219,21,21,0,11,10,0,8,10,3,0,0,0,0,0,0,0,0
58220,1094,710,101,345,186,78,252,383,40,35,384,63,67,106,148,363,21
58222,148,108,10,54,23,21,42,50,6,10,40,2,8,19,11,35,5
58223,91,73,3,36,34,0,29,36,2,6,18,2,4,10,2,18,0
58224,22,17,0,9,8,0,0,17,0,0,5,0,0,0,5,5,0
58225,507,321,47,151,88,35,118,151,32,20,186,28,53,45,60,175,11
58227,272,191,27,90,60,14,66,106,14,5,81,4,26,31,20,79,2
58228,434,274,72,131,63,8,91,116,55,12,160,64,74,16,6,126,34
58229,70,42,1,21,16,4,12,23,7,0,28,4,4,9,11,28,0
58230,334,230,34,76,84,36,82,131,10,7,104,13,24,41,26,96,8
58231,225,164,22,66,66,10,60,79,15,10,61,5,14,29,13,61,0
58233,125,85,11,41,16,17,34,29,10,12,40,7,18,12,3,38,2
58235,205,143,19,93,27,4,79,44,9,11,62,21,14,12,15,57,5
58236,15,12,0,4,8,0,4,8,0,0,3,0,0,3,0,3,0
58237,2301,1514,242,742,384,146,613,642,162,97,787,162,200,220,205,716,71
58238,85,55,4,21,25,5,20,27,2,6,30,3,15,5,7,27,3
58239,43,27,1,18,8,0,10,10,7,0,16,0,6,10,0,16,0
58240,522,372,49,182,87,54,128,187,33,24,150,21,37,55,37,138,12
58241,84,57,17,24,10,6,18,29,8,2,27,10,10,4,3,25,2
58243,272,184,22,85,63,14,64,86,14,20,88,8,21,43,16,83,5
58244,122,81,12,43,18,8,16,35,13,17,41,9,3,22,7,34,7
58249,1271,838,59,397,301,81,272,467,53,46,433,56,90,144,143,421,12
58250,123,89,9,42,20,18,27,51,9,2,34,2,13,9,10,34,0
58251,821,590,75,312,141,62,227,289,43,31,231,48,60,64,59,203,28
58254,286,161,24,70,41,26,54,69,23,15,125,15,30,25,55,123,2
58255,6,6,0,6,0,0,6,0,0,0,0,0,0,0,0,0,0
58256,340,261,55,153,37,16,134,100,16,11,79,14,36,10,19,57,22
58257,862,523,81,230,143,69,180,263,46,34,339,91,69,79,100,256,83
58258,101,67,13,40,10,4,40,24,0,3,34,8,8,18,0,34,0
58259,271,179,23,60,73,23,44,111,6,18,92,5,23,24,40,90,2
58260,93,69,3,44,13,9,34,33,1,1,24,3,4,8,9,22,2
58261,457,286,48,120,86,32,99,143,22,22,171,31,54,31,55,155,16
58262,67,45,6,17,16,6,5,25,9,6,22,2,5,3,12,19,3
58265,237,166,17,89,45,15,68,82,7,9,71,14,13,24,20,69,2
58266,84,75,4,27,20,24,22,42,6,5,9,3,6,0,0,7,2
58267,629,418,60,203,119,36,157,235,14,12,211,31,35,68,77,196,15
58269,94,66,3,31,22,10,22,38,3,3,28,1,9,5,13,28,0
58270,870,543,80,249,148,66,193,262,59,29,327,41,70,116,100,300,27
58271,307,229,48,107,60,14,99,104,14,12,78,12,25,22,19,73,5
58272,135,100,8,39,39,14,29,49,9,13,35,10,4,13,8,35,0
58273,98,62,5,23,23,11,15,34,1,12,36,7,6,14,9,31,5
58274,457,313,24,180,77,32,149,142,17,5,144,25,23,46,50,120,24
58275,277,220,44,110,52,14,101,106,6,7,57,9,20,13,15,53,4
58276,275,200,26,102,57,15,79,102,10,9,75,12,18,29,16,67,8
58277,125,80,2,36,37,5,26,48,0,6,45,9,6,20,10,43,2
58278,667,548,86,350,98,14,293,207,35,13,119,23,30,45,21,108,11
58281,55,34,10,15,4,5,15,19,0,0,21,7,8,6,0,17,4
58282,637,414,60,182,124,48,137,210,35,32,223,22,57,82,62,192,31
58301,4099,2622,482,1210,685,245,840,1213,387,182,1477,329,359,354,435,1292,185
58310,99,75,8,39,20,8,34,35,2,4,24,2,7,9,6,22,2
58311,62,51,4,32,8,7,22,21,5,3,11,0,1,7,3,10,1
58313,35,17,0,9,0,8,1,8,4,4,18,4,4,4,6,18,0
58316,1966,1517,457,715,312,33,481,317,511,208,449,67,129,154,99,360,89
58317,132,82,10,33,21,18,21,47,8,6,50,6,16,8,20,46,4
58318,1613,1039,78,515,339,107,372,554,61,52,574,122,129,136,187,529,45
58321,93,66,3,16,25,22,16,48,0,2,27,2,8,12,5,25,2
58323,24,18,0,10,8,0,5,13,0,0,6,0,3,3,0,6,0
58324,710,432,44,198,132,58,132,248,38,14,278,26,78,71,103,263,15
58325,68,55,3,22,28,2,18,33,0,4,13,2,0,4,7,13,0
58327,149,120,21,67,26,6,58,42,10,10,29,3,2,15,9,24,5
58329,984,758,206,349,132,71,229,209,227,93,226,29,92,64,41,191,35
58330,207,121,6,58,40,17,53,59,5,4,86,8,12,19,47,81,5
58331,69,52,3,28,17,4,15,26,7,4,17,0,2,8,7,17,0
58332,186,128,22,30,63,13,34,87,1,6,58,0,20,22,16,55,3
58335,382,345,127,140,70,8,77,34,160,74,37,6,8,20,3,36,1
58338,63,36,5,13,18,0,13,22,0,1,27,7,9,8,3,27,0
58341,1316,839,80,363,295,101,247,509,51,32,477,43,67,141,226,455,22
58343,45,33,2,13,18,0,2,20,4,7,12,0,0,8,4,12,0
58344,465,289,38,129,94,28,112,147,18,12,176,7,39,51,79,169,7
58345,77,51,0,21,26,4,8,38,0,5,26,4,6,10,6,22,4
58346,316,216,36,106,59,15,87,89,24,16,100,5,20,43,32,96,4
58348,454,286,30,111,86,59,96,155,15,20,168,14,43,35,76,164,4
58351,252,157,14,77,50,16,47,93,16,1,95,14,36,19,26,85,10
58352,219,142,12,56,59,15,55,79,4,4,77,6,16,24,31,76,1
58353,14,8,2,4,2,0,2,6,0,0,6,0,2,2,2,6,0
58355,47,39,4,12,22,1,13,26,0,0,8,0,2,0,6,8,0
58356,836,514,57,258,138,61,179,291,26,18,322,54,66,89,113,305,17
58357,101,75,9,32,24,10,26,36,6,7,26,1,11,12,2,26,0
58359,8,8,0,0,8,0,8,0,0,0,0,0,0,0,0,0,0
58361,96,77,11,23,37,6,24,38,2,13,19,2,0,13,4,17,2
58362,64,39,4,27,8,0,31,8,0,0,25,0,19,0,6,12,13
58363,35,32,4,14,14,0,14,18,0,0,3,0,0,3,0,3,0
58365,185,115,17,50,29,19,42,60,7,6,70,7,27,15,21,65,5
58366,417,278,42,136,76,24,104,113,42,19,139,18,49,44,28,130,9
58367,765,485,93,212,140,40,166,200,83,36,280,42,38,101,99,253,27
58368,1698,1108,189,478,323,118,394,546,117,51,590,86,123,179,202,547,43
58369,346,269,59,143,53,14,104,98,37,30,77,7,32,23,15,74,3
58370,325,269,65,147,53,4,63,71,104,31,56,10,30,12,4,41,15
58372,65,43,2,26,15,0,19,24,0,0,22,5,3,8,6,21,1
58374,281,192,28,81,50,33,65,95,12,20,89,0,22,28,39,85,4
58377,144,104,11,54,32,7,52,45,7,0,40,9,17,10,4,40,0
58379,73,58,23,25,8,2,23,3,20,12,15,1,4,4,6,9,6
58380,225,114,21,52,33,8,45,47,13,9,111,4,36,35,36,104,7
58381,111,91,14,43,27,7,36,40,8,7,20,1,10,4,5,19,1
58382,88,64,7,30,19,8,16,36,8,4,24,3,10,6,5,24,0
58384,292,197,38,88,52,19,70,92,28,7,95,8,28,28,31,84,11
58385,75,57,7,29,18,3,15,37,5,0,18,2,4,8,4,16,2
58386,60,37,0,24,10,3,15,19,3,0,23,3,4,8,8,21,2
58401,7460,4560,755,2260,1144,401,1555,2220,537,248,2900,586,755,796,763,2568,332
58413,575,369,19,123,141,86,79,260,18,12,206,20,30,74,82,197,9
58415,76,58,8,21,21,8,26,32,0,0,18,3,13,0,2,18,0
58416,221,167,19,61,58,29,47,101,8,11,54,4,15,15,20,52,2
58418,196,137,24,54,42,17,40,87,7,3,59,10,4,27,18,54,5
58420,115,81,14,52,11,4,47,24,5,5,34,5,11,11,7,34,0
58421,1296,862,116,411,253,82,353,388,80,41,434,101,102,119,112,404,30
58422,88,76,0,39,28,9,35,39,0,2,12,0,4,6,2,12,0
58423,42,27,0,9,15,3,7,19,0,1,15,0,3,8,4,15,0
58424,143,107,12,50,37,8,40,49,11,7,36,7,5,16,8,34,2
58425,666,414,50,191,115,58,164,212,18,20,252,33,48,69,102,235,17
58426,109,77,10,50,17,0,23,48,6,0,32,9,4,13,6,30,2
58428,119,85,6,47,24,8,21,53,9,2,34,3,2,12,17,34,0
58429,139,91,20,35,30,6,32,41,12,6,48,4,15,18,11,40,8
58430,42,31,5,11,9,6,13,11,1,6,11,0,4,5,2,11,0
58431,69,49,6,17,22,4,9,33,6,1,20,10,0,6,4,20,0
58433,499,319,33,152,102,32,124,171,13,11,180,22,34,56,68,170,10
58436,891,574,110,231,161,72,190,310,42,32,317,29,63,104,121,310,7
58438,347,221,30,99,70,22,88,110,17,6,126,13,40,35,38,115,11
58439,27,23,2,10,11,0,10,11,2,0,4,0,4,0,0,0,4
58440,96,63,4,39,18,2,33,28,0,2,33,0,10,17,6,33,0
58441,166,131,40,50,25,16,65,56,4,6,35,0,2,14,19,35,0
58442,262,168,8,58,64,38,45,115,2,6,94,11,22,17,44,92,2
58443,132,93,10,48,21,14,29,56,6,2,39,4,8,11,16,39,0
58444,150,115,7,39,48,21,32,68,7,8,35,2,6,15,12,32,3
58445,65,45,9,18,13,5,11,23,7,4,20,6,3,4,7,17,3
58448,182,116,10,44,36,26,38,72,0,6,66,11,19,17,19,57,9
58451,83,57,6,28,9,14,24,20,5,8,26,0,2,14,10,26,0
58454,160,103,8,38,32,25,23,66,9,5,57,6,19,14,18,52,5
58455,116,74,3,30,21,20,19,53,0,2,42,2,10,24,6,38,4
58456,303,193,18,72,67,36,49,120,18,6,110,12,15,37,46,110,0
58458,561,383,51,182,97,53,161,192,19,11,178,31,47,52,48,168,10
58460,151,99,8,29,44,18,19,69,5,6,52,9,9,14,20,48,4
58461,202,143,4,59,62,18,45,89,5,4,59,10,17,14,18,56,3
58463,363,230,20,93,79,38,58,149,13,10,133,3,27,36,67,127,6
58464,121,103,10,31,45,17,27,70,0,6,18,0,3,9,6,15,3
58466,188,131,5,62,44,20,39,81,6,5,57,2,14,21,20,55,2
58467,300,222,16,96,71,39,80,113,15,14,78,7,9,28,34,72,6
58472,160,120,9,47,51,13,30,74,3,13,40,6,6,17,11,39,1
58474,1140,748,143,336,198,71,278,364,56,50,392,69,92,116,115,354,38
58475,87,63,4,23,27,9,16,41,1,5,24,3,4,7,10,20,4
58476,114,79,13,40,19,7,25,37,7,10,35,3,3,22,7,31,4
58477,71,45,11,18,12,4,19,21,3,2,26,7,8,7,4,22,4
58478,93,64,5,21,24,14,13,43,2,6,29,4,7,8,10,29,0
58479,112,97,11,40,41,5,43,47,2,5,15,2,8,3,2,15,0
58480,147,99,19,48,23,9,45,47,5,2,48,8,6,23,11,35,13
58481,127,99,23,50,22,4,39,43,14,3,28,0,9,5,14,20,8
58482,446,283,39,132,80,32,108,135,27,13,163,15,27,53,68,158,5
58483,171,108,8,44,33,23,43,54,9,2,63,3,18,20,22,56,7
58484,31,24,2,13,9,0,10,14,0,0,7,0,2,3,2,7,0
58486,144,96,10,49,30,7,39,46,6,5,48,5,13,12,18,44,4
58487,189,146,18,67,47,14,66,69,3,8,43,4,18,17,4,37,6
58488,158,97,3,44,36,14,26,61,3,7,61,2,17,23,19,59,2
58489,69,57,0,34,19,4,18,36,1,2,12,2,0,8,2,12,0
58490,133,111,32,40,33,6,50,45,8,8,22,4,9,5,4,20,2
58492,212,160,21,88,38,13,59,93,6,2,52,7,17,5,23,52,0
58494,173,115,18,45,41,11,39,60,2,14,58,2,7,24,25,54,4
58495,625,440,59,156,160,65,155,257,12,16,185,9,48,47,81,176,9
58496,120,99,13,43,31,12,37,56,2,4,21,3,5,5,8,18,3
58497,151,131,22,90,11,8,73,49,6,3,20,5,11,2,2,19,1
58501,18138,11727,2382,5614,2898,833,4530,5356,1132,709,6411,2192,1838,1290,1091,5315,1096
58504,8420,5673,1205,3145,1134,189,2392,2237,651,393,2747,834,858,676,379,2216,531
58505,0,0,0,0,0,0,0,0,0,0,0,0,0,0,0,0,0
58520,120,78,13,32,22,11,36,34,4,4,42,4,15,8,15,38,4
58521,207,171,24,71,73,3,47,108,4,12,36,9,6,16,5,30,6
58523,1488,1087,121,618,267,81,449,476,102,60,401,38,149,118,96,381,20
58524,55,43,0,11,20,12,2,39,0,2,12,0,1,10,1,10,2
58528,206,179,46,92,36,5,43,22,89,25,27,3,17,7,0,24,3
58529,347,232,36,88,71,37,70,131,16,15,115,12,32,24,47,107,8
58530,544,394,35,240,91,28,165,196,16,17,150,13,35,52,50,136,14
58531,133,103,7,30,49,17,37,58,4,4,30,1,4,12,13,29,1
58532,115,100,15,40,35,10,34,53,7,6,15,2,6,4,3,9,6
58533,422,277,22,117,102,36,88,165,13,11,145,20,27,42,56,142,3
58535,249,165,22,57,72,14,49,94,16,6,84,4,23,22,35,82,2
58538,619,496,135,252,100,9,133,59,181,123,123,26,47,40,10,104,19
58540,933,643,70,277,238,58,218,320,64,41,290,16,54,92,128,269,21
58541,187,130,7,68,47,8,45,67,5,13,57,11,14,14,18,53,4
58542,162,120,13,52,29,26,41,70,0,9,42,2,7,16,17,42,0
58544,238,147,15,79,41,12,64,63,9,11,91,6,12,37,36,91,0
58545,1374,1029,105,606,219,99,457,510,52,10,345,56,108,95,86,315,30
58549,87,74,11,25,36,2,27,39,0,8,13,1,4,4,4,13,0
58552,911,643,93,267,209,74,210,333,72,28,268,28,52,88,100,243,25
58553,57,44,0,23,16,5,14,30,0,0,13,0,1,6,6,12,1
58554,7870,5576,1143,2943,1168,322,2179,2398,707,292,2294,513,795,552,434,1933,361
58558,240,205,40,106,54,5,98,92,8,7,35,2,15,10,8,30,5
58559,123,74,4,32,27,11,17,53,2,2,49,6,6,25,12,49,0
58560,67,47,3,28,13,3,19,23,2,3,20,2,7,8,3,15,5
58561,488,337,34,128,133,42,127,186,7,17,151,25,30,49,47,129,22
58562,251,177,13,75,56,33,54,112,6,5,74,9,11,18,36,74,0
58563,815,590,88,269,156,77,241,300,30,19,225,38,33,67,87,219,6
58564,83,67,5,25,37,0,20,40,2,5,16,2,7,7,0,16,0
58565,118,90,1,40,44,5,27,61,0,2,28,4,12,10,2,26,2
58566,68,50,16,23,9,2,36,12,0,2,18,3,13,0,2,16,2
58568,219,164,31,62,57,14,59,68,21,16,55,19,18,10,8,45,10
58569,43,24,2,16,5,1,11,13,0,0,19,2,4,13,0,13,6
58570,111,87,16,47,20,4,39,23,16,9,24,2,12,6,4,18,6
58571,230,166,15,101,34,16,60,96,8,2,64,6,30,19,9,57,7
58572,86,58,9,29,15,5,20,30,3,5,28,1,12,7,8,28,0
58573,328,225,22,81,102,20,66,135,12,12,103,5,27,30,41,98,5
58575,448,302,26,135,85,56,77,193,22,10,146,16,37,38,55,139,7
58576,410,293,39,147,69,38,103,164,18,8,117,12,32,37,36,111,6
58577,727,555,65,311,142,37,209,282,47,17,172,20,55,44,53,163,9
58579,487,357,60,178,87,32,144,155,37,21,130,18,29,37,46,110,20
58580,121,82,13,46,22,1,36,41,5,0,39,6,13,14,6,36,3
58581,136,86,8,44,31,3,30,49,3,4,50,6,2,18,24,50,0
58601,7629,4982,985,2448,1124,425,2105,2161,433,283,2647,820,685,567,575,2275,372
58620,68,54,0,28,26,0,22,26,4,2,14,3,2,6,3,12,2
58621,575,379,51,149,117,62,132,209,29,9,196,26,55,61,54,186,10
58622,597,423,79,178,127,39,171,185,40,27,174,47,39,39,49,164,10
58623,959,624,84,320,165,55,264,302,35,23,335,52,71,111,101,322,13
58625,100,71,11,30,22,8,24,27,8,12,29,4,9,11,5,23,6
58626,125,77,3,43,19,12,26,42,2,7,48,8,6,15,19,43,5
58627,66,49,4,23,16,6,21,24,0,4,17,4,8,5,0,9,8
58630,222,155,17,96,40,2,50,98,6,1,67,8,31,21,7,48,19
58631,509,342,29,154,117,42,129,188,8,17,167,12,41,66,48,163,4
58632,93,66,13,33,18,2,25,41,0,0,27,6,8,11,2,27,0
58634,162,110,7,49,31,23,31,68,0,11,52,6,24,22,0,44,8
58636,299,198,26,93,60,19,62,93,35,8,101,15,20,44,22,89,12
58638,472,326,26,146,108,46,109,193,16,8,146,7,26,57,56,139,7
58639,851,539,73,243,166,57,165,291,65,18,312,43,70,102,97,294,18
58640,481,331,48,158,85,40,122,145,41,23,150,18,39,39,54,135,15
58641,44,38,14,7,15,2,9,21,8,0,6,0,0,2,4,6,0
58642,119,104,4,53,28,19,44,58,0,2,15,2,5,6,2,15,0
58643,111,66,7,30,24,5,11,40,11,4,45,5,12,18,10,45,0
58645,144,83,3,57,19,4,26,38,9,10,61,18,30,9,4,58,3
58646,561,373,33,149,130,61,128,216,15,14,188,15,44,61,68,186,2
58647,439,278,24,122,106,26,97,164,12,5,161,26,37,57,41,150,11
58649,172,111,8,42,48,13,31,78,0,2,61,5,16,17,23,51,10
58650,189,150,14,65,57,14,52,85,6,7,39,2,3,17,17,39,0
58651,210,146,21,87,25,13,75,57,13,1,64,11,15,19,19,55,9
58652,429,318,29,160,88,41,110,188,9,11,111,10,33,32,36,101,10
58653,282,211,27,87,72,25,72,121,12,6,71,13,17,8,33,62,9
58654,114,80,5,50,12,13,31,38,7,4,34,6,11,13,4,34,0
58655,159,131,13,84,27,7,62,53,14,2,28,4,12,12,0,25,3
58656,159,121,12,60,38,11,47,63,2,9,38,5,7,18,8,33,5
58701,10782,6524,1336,2984,1671,533,2198,3123,809,394,4258,1357,1073,890,938,3543,715
58703,7160,4719,1075,2300,1039,305,1709,2109,580,321,2441,1008,639,447,347,1900,541
58704,2114,1940,1263,658,19,0,1336,433,154,17,174,138,36,0,0,118,56
58710,250,179,15,68,74,22,55,104,8,12,71,8,8,22,33,63,8
58711,96,71,10,30,25,6,23,41,7,0,25,2,9,8,6,20,5
58712,68,54,8,27,12,7,23,24,0,7,14,2,2,8,2,14,0
58713,19,13,0,9,2,2,3,4,0,6,6,2,0,4,0,6,0
58716,53,33,2,15,11,5,11,17,0,5,20,6,8,2,4,16,4
58718,377,288,48,133,75,32,113,151,13,11,89,11,28,34,16,80,9
58721,259,195,7,80,78,30,62,99,10,24,64,2,24,15,23,62,2
58722,504,406,98,201,76,31,191,170,34,11,98,23,42,25,8,72,26
58723,88,54,15,18,9,12,16,31,4,3,34,4,8,12,10,34,0
58725,127,89,14,26,28,21,31,47,0,11,38,6,9,14,9,36,2
58727,176,114,9,41,42,22,17,88,2,7,62,0,12,32,18,58,4
58730,608,370,28,168,118,56,101,220,33,16,238,26,37,54,121,229,9
58731,110,78,14,40,18,6,40,30,6,2,32,3,1,20,8,21,11
58733,168,138,35,72,26,5,67,61,2,8,30,2,11,13,4,28,2
58734,128,83,13,43,20,7,45,34,2,2,45,1,18,11,15,45,0
58735,142,108,5,66,30,7,50,55,0,3,34,1,14,8,11,34,0
58736,241,162,8,83,47,24,55,82,15,10,79,4,26,25,24,73,6
58737,80,37,7,15,14,1,5,23,8,1,43,2,12,22,7,35,8
58740,245,189,27,113,40,9,73,92,20,4,56,10,13,21,12,54,2
58741,240,187,42,89,41,15,92,77,9,9,53,9,6,18,20,51,2
58744,88,56,11,24,15,6,10,39,5,2,32,0,12,14,6,30,2
58746,685,464,69,195,156,44,160,246,30,28,221,32,62,40,87,211,10
58747,55,43,2,19,20,2,14,24,2,3,12,0,1,9,2,12,0
58748,107,72,0,31,28,13,22,45,3,2,35,4,10,13,8,26,9
58750,237,180,36,86,44,14,89,78,4,9,57,11,15,12,19,55,2
58752,121,80,11,41,19,9,22,42,9,7,41,5,10,11,15,40,1
58755,75,44,3,23,12,6,17,20,3,4,31,7,2,14,8,31,0
58756,121,76,4,36,31,5,22,46,3,5,45,4,19,12,10,43,2
58757,197,157,42,68,37,10,57,25,45,30,40,5,15,12,8,31,9
58758,108,79,8,30,32,9,26,45,4,4,29,0,6,11,12,27,2
58759,289,223,42,95,61,25,71,128,18,6,66,15,11,16,24,65,1
58760,140,73,5,38,22,8,21,47,0,5,67,2,17,25,23,63,4
58761,502,337,51,148,86,52,115,186,24,12,165,19,29,44,73,155,10
58762,108,68,8,33,22,5,20,39,3,6,40,8,5,4,23,37,3
58763,953,697,153,357,163,24,238,206,145,108,256,41,75,93,47,210,46
58765,139,85,5,38,33,9,26,54,2,3,54,5,19,15,15,46,8
58768,92,72,14,31,23,4,22,44,3,3,20,5,2,7,6,20,0
58769,110,93,5,41,41,6,29,52,5,7,17,0,5,4,8,17,0
58770,448,325,59,165,67,34,104,115,71,35,123,10,49,40,24,114,9
58771,215,149,14,78,42,15,63,81,3,2,66,14,7,13,32,66,0
58772,75,44,2,23,19,0,10,32,2,0,31,2,7,10,12,28,3
58773,313,221,29,107,57,28,87,112,13,9,92,4,15,26,47,91,1
58775,91,76,15,41,20,0,33,19,12,12,15,0,5,10,0,14,1
58776,78,57,3,29,17,8,25,29,3,0,21,6,9,4,2,17,4
58778,82,60,0,14,37,9,10,41,0,9,22,0,4,11,7,17,5
58779,216,156,15,71,47,23,58,86,8,4,60,8,21,17,14,56,4
58781,288,211,41,106,54,10,87,103,21,0,77,11,25,28,13,69,8
58782,207,132,5,61,53,13,48,73,8,3,75,9,21,19,26,72,3
58783,152,94,14,34,35,11,40,45,4,5,58,4,23,15,16,54,4
58784,782,485,63,203,145,74,162,259,31,33,297,37,56,82,122,279,18
58785,355,303,67,173,57,6,149,100,43,11,52,10,9,27,6,43,9
58787,79,40,3,14,17,6,12,28,0,0,39,4,14,10,11,31,8
58788,590,379,51,158,120,50,119,207,17,36,211,28,42,92,49,182,29
58789,168,106,22,46,29,9,48,40,6,12,62,9,15,17,21,62,0
58790,614,421,67,185,124,45,172,187,37,25,193,24,43,49,77,178,15
58792,111,77,1,36,31,9,17,49,9,2,34,2,11,9,12,32,2
58793,309,207,13,117,57,20,67,111,16,13,102,11,17,27,47,99,3
58794,57,39,3,20,12,4,15,21,1,2,18,2,2,6,8,16,2
58795,121,82,3,35,23,21,23,45,8,6,39,2,8,19,10,39,0
58801,6518,4181,742,2178,936,325,1526,1854,592,209,2337,472,781,636,448,2030,307
58830,109,76,3,36,23,14,18,43,8,7,33,0,4,17,12,30,3
58831,207,147,13,74,41,19,62,72,9,4,60,7,21,15,17,57,3
58833,36,28,0,16,10,2,9,19,0,0,8,0,0,3,5,8,0
58835,110,76,2,21,40,13,18,50,5,3,34,0,8,0,26,32,2
58838,88,63,10,28,20,5,26,34,2,1,25,4,15,2,4,25,0
58843,150,112,8,58,36,10,22,81,7,2,38,7,14,15,2,37,1
58844,74,53,6,22,13,12,17,30,0,6,21,3,6,10,2,21,0
58845,171,113,12,34,44,23,26,81,4,2,58,2,13,10,33,56,2
58847,105,77,0,39,31,7,21,41,11,4,28,0,0,16,12,28,0
58849,348,236,15,102,87,32,71,138,18,9,112,13,31,33,35,105,7
58852,679,465,46,209,164,46,136,269,39,21,214,19,42,76,77,204,10
58853,37,28,2,14,9,3,12,11,4,1,9,3,0,4,2,9,0
58854,972,659,88,334,173,64,223,323,74,39,313,40,70,81,122,293,20
58856,59,42,5,10,19,8,6,31,1,4,17,5,5,2,5,17,0
59001,653,467,89,222,126,30,198,203,49,17,186,21,44,60,61,168,18
59002,21,19,2,8,7,2,5,12,2,0,2,0,2,0,0,0,2
59003,371,257,73,129,52,3,94,71,71,21,114,28,36,31,19,102,12
59006,334,247,23,109,79,36,90,124,12,21,87,5,28,31,23,75,12
59007,47,33,9,16,5,3,7,14,9,3,14,0,8,6,0,14,0
59008,143,96,8,47,28,13,45,36,7,8,47,5,12,15,15,44,3
59010,54,40,3,30,7,0,17,20,2,1,14,7,3,2,2,10,4
59011,1270,840,132,374,242,92,317,427,52,44,430,70,96,158,106,374,56
59012,59,45,11,13,18,3,9,20,7,9,14,4,3,7,0,14,0
59013,72,58,4,39,10,5,20,30,6,2,14,0,2,7,5,14,0
59014,605,428,61,201,146,20,121,246,34,27,177,24,40,67,46,155,22
59015,192,134,26,60,38,10,51,65,11,7,58,3,18,25,12,50,8
59016,314,244,88,96,46,14,81,70,53,40,70,34,9,21,6,59,11
59018,149,111,12,60,32,7,42,61,6,2,38,5,6,14,13,34,4
59019,1301,922,139,465,264,54,346,473,74,29,379,89,109,105,76,324,55
59020,53,21,0,12,9,0,4,13,2,2,32,12,12,6,2,22,10
59022,583,495,78,284,109,24,218,126,71,80,88,7,46,33,2,67,21
59024,156,103,12,48,43,0,41,54,5,3,53,5,17,13,18,47,6
59025,49,44,4,35,4,1,22,15,5,2,5,0,2,2,1,4,1
59026,83,57,9,18,22,8,14,34,2,7,26,2,10,5,9,22,4
59027,123,82,10,44,26,2,29,39,9,5,41,7,19,15,0,36,5
59028,251,170,17,62,70,21,51,109,7,3,81,10,47,13,11,69,12
59029,308,228,32,123,49,24,87,95,26,20,80,9,15,30,26,74,6
59030,844,472,75,268,103,26,182,233,44,13,372,75,194,82,21,311,61
59031,71,71,13,29,25,4,29,30,3,9,0,0,0,0,0,0,0
59032,148,116,12,53,39,12,40,61,3,12,32,8,8,9,7,29,3
59033,38,26,2,19,5,0,16,4,4,2,12,0,4,4,4,12,0
59034,1743,1246,274,592,288,92,455,494,166,131,497,57,146,183,111,465,32
59035,86,39,22,17,0,0,22,5,12,0,47,0,13,34,0,39,8
59036,648,384,57,163,118,46,103,207,32,42,264,39,50,80,95,249,15
59037,556,433,74,227,118,14,150,211,45,27,123,9,45,50,19,76,47
59038,321,218,32,97,69,20,78,112,18,10,103,11,20,43,29,98,5
59039,40,29,0,14,12,3,4,19,1,5,11,2,2,5,2,9,2
59041,735,538,65,288,135,50,191,292,32,23,197,13,68,56,60,185,12
59043,693,563,132,277,137,17,178,112,153,120,130,23,60,29,18,117,13
59044,3813,2797,517,1394,720,166,960,1330,342,165,1016,142,306,236,332,897,119
59046,172,118,15,52,42,9,36,74,7,1,54,8,19,19,8,49,5
59047,5292,3279,581,1670,775,253,1141,1586,375,177,2013,374,710,492,437,1716,297
59050,470,391,83,199,85,24,142,105,81,63,79,3,26,37,13,70,9
59052,77,61,12,20,26,3,30,31,0,0,16,0,11,2,3,11,5
59053,124,71,9,33,21,8,26,41,4,0,53,1,16,28,8,44,9
59054,109,87,12,48,18,9,34,37,9,7,22,2,6,10,4,19,3
59055,46,32,7,13,8,4,14,15,0,3,14,6,0,4,4,14,0
59057,153,127,8,71,39,9,48,70,2,7,26,5,13,6,2,23,3
59058,20,18,2,16,0,0,11,2,5,0,2,0,0,0,2,2,0
59059,58,46,2,22,15,7,13,29,4,0,12,2,2,5,3,12,0
59061,88,63,0,29,22,12,14,47,0,2,25,0,10,12,3,20,5
59062,40,25,0,16,9,0,6,17,0,2,15,2,3,7,3,15,0
59063,638,507,67,290,129,21,202,254,31,20,131,23,33,46,29,123,8
59064,109,83,15,54,9,5,37,41,0,5,26,0,1,20,5,25,1
59065,37,29,0,21,8,0,8,18,3,0,8,2,4,0,2,6,2
59066,192,162,23,91,46,2,59,48,25,30,30,0,15,11,4,26,4
59067,87,56,4,29,21,2,23,31,2,0,31,5,8,4,14,31,0
59068,1599,940,119,498,232,91,292,524,99,25,659,128,262,115,154,542,117
59069,174,130,22,78,22,8,58,57,8,7,44,3,19,11,11,40,4
59070,318,211,22,120,42,27,79,86,27,19,107,13,31,48,15,96,11
59071,43,32,0,12,20,0,4,28,0,0,11,0,4,7,0,11,0
59072,1687,1074,165,499,305,105,344,574,105,51,613,50,200,209,154,532,81
59074,179,127,14,51,43,19,26,89,10,2,52,3,17,23,9,44,8
59075,95,95,24,38,15,18,43,29,15,8,0,0,0,0,0,0,0
59076,18,8,0,5,3,0,4,4,0,0,10,2,2,4,2,8,2
59077,30,18,5,4,9,0,5,13,0,0,12,4,6,2,0,8,4
59078,49,39,6,6,21,6,12,25,0,2,10,3,0,2,5,7,3
59079,1043,863,189,501,153,20,385,354,87,37,180,33,71,60,16,137,43
59081,19,6,2,2,2,0,0,4,2,0,13,0,8,2,3,9,4
59085,27,15,6,5,4,0,8,7,0,0,12,2,4,3,3,12,0
59086,287,206,35,94,62,15,84,99,11,12,81,3,36,30,12,68,13
59087,209,138,28,60,46,4,54,64,17,3,71,10,21,24,16,63,8
59088,463,331,53,176,84,18,104,155,52,20,132,23,18,43,48,132,0
59089,136,116,11,61,33,11,41,39,23,13,20,10,3,5,2,14,6
59101,15325,8768,2492,4177,1614,485,2754,3274,1927,813,6557,1835,2434,1367,921,5288,1269
59102,18848,12030,2498,5087,3251,1194,3786,6057,1331,856,6818,1362,1749,1843,1864,5815,1003
59105,8524,6374,1355,3504,1240,275,2500,2679,855,340,2150,525,717,651,257,1665,485
59106,2780,2355,235,1436,601,83,1058,1124,104,69,425,83,154,119,69,343,82
59201,1786,1310,248,690,284,88,442,454,284,130,476,57,139,166,114,421,55
59211,68,60,8,25,15,12,22,23,9,6,8,0,1,0,7,7,1
59212,129,92,2,45,24,21,31,52,3,6,37,7,4,17,9,37,0
59213,263,214,33,106,63,12,70,59,48,37,49,2,28,11,8,40,9
59214,61,45,0,13,25,7,10,30,0,5,16,6,2,4,4,14,2
59215,518,358,41,176,106,35,132,185,22,19,160,24,30,48,58,150,10
59217,31,23,6,0,17,0,6,17,0,0,8,8,0,0,0,8,0
59218,377,254,37,130,56,31,116,113,20,5,123,11,31,46,35,114,9
59219,147,117,4,68,23,22,40,70,6,1,30,2,11,2,15,27,3
59221,673,442,60,209,145,28,147,245,35,15,231,38,63,69,61,212,19
59222,111,80,4,32,37,7,18,59,3,0,31,2,7,12,10,25,6
59223,105,90,5,51,29,5,30,43,14,3,15,0,2,7,6,11,4
59225,206,178,43,82,35,18,75,44,33,26,28,3,9,12,4,25,3
59226,190,115,9,55,43,8,43,60,6,6,75,5,17,21,32,74,1
59230,1961,1249,92,705,324,128,464,613,103,69,712,91,201,228,192,651,61
59231,74,61,0,10,51,0,7,43,0,11,13,0,0,8,5,13,0
59241,191,138,15,63,40,20,51,71,8,8,53,9,7,22,15,53,0
59242,21,17,0,10,7,0,6,9,2,0,4,0,0,0,4,4,0
59243,142,114,26,57,25,6,55,51,5,3,28,2,7,9,10,28,0
59244,48,39,3,17,16,3,10,23,0,6,9,4,2,0,3,9,0
59247,159,89,7,45,28,9,30,47,5,7,70,10,26,21,13,68,2
59248,325,227,25,87,102,13,57,144,16,10,98,7,29,32,30,93,5
59250,114,72,13,20,29,10,16,49,7,0,42,5,13,11,13,39,3
59252,86,63,6,24,29,4,23,39,1,0,23,1,6,9,7,21,2
59253,73,47,10,30,5,2,28,18,1,0,26,3,7,8,8,26,0
59254,1035,642,41,334,187,80,264,305,28,45,393,42,98,109,144,368,25
59255,1108,849,200,407,206,36,192,204,320,133,259,51,109,63,36,216,43
59257,35,27,5,16,4,2,7,19,0,1,8,3,3,0,2,8,0
59258,61,47,0,22,22,3,16,29,1,1,14,0,4,8,2,14,0
59259,162,120,16,41,45,18,39,63,4,14,42,6,15,9,12,42,0
59260,74,55,7,24,19,5,20,33,0,2,19,3,7,7,2,19,0
59261,234,144,9,75,43,17,50,65,18,11,90,17,21,28,24,81,9
59262,272,190,17,115,44,14,86,76,16,12,82,9,21,20,32,78,4
59263,663,400,46,178,114,62,122,220,43,15,263,28,62,96,77,233,30
59270,2851,1929,282,1048,454,145,738,877,219,95,922,135,329,232,226,818,104
59274,95,87,9,30,28,20,25,58,2,2,8,0,2,6,0,5,3
59275,171,112,12,31,57,12,22,66,2,22,59,8,11,19,21,53,6
59276,28,15,0,4,8,3,2,13,0,0,13,2,4,4,3,13,0
59301,4635,3006,508,1391,808,299,954,1381,427,244,1629,322,518,434,355,1407,222
59311,78,55,7,29,14,5,23,23,4,5,23,12,4,4,3,20,3
59313,948,666,103,344,187,32,268,304,57,37,282,45,54,84,99,255,27
59314,66,40,5,24,8,3,21,19,0,0,26,7,9,3,7,24,2
59315,60,58,5,39,10,4,30,28,0,0,2,0,2,0,0,2,0
59317,491,353,34,177,107,35,120,187,28,18,138,21,46,40,31,121,17
59318,64,55,8,16,26,5,15,40,0,0,9,0,0,5,4,9,0
59322,59,52,5,28,12,7,31,21,0,0,7,2,3,0,2,4,3
59323,851,703,124,465,106,8,307,260,109,27,148,23,87,38,0,138,10
59324,401,280,37,134,90,19,97,151,21,11,121,18,18,34,51,113,8
59326,121,84,2,43,20,19,24,51,7,2,37,2,16,4,15,32,5
59327,1255,829,99,409,263,58,283,430,77,39,426,37,106,165,118,387,39
59330,3343,2275,392,1041,669,173,750,1112,272,141,1068,227,319,266,256,963,105
59332,68,55,5,26,20,4,22,28,0,5,13,0,3,4,6,13,0
59333,12,8,0,8,0,0,5,3,0,0,4,1,1,2,0,4,0
59336,49,39,9,12,12,6,17,20,0,2,10,0,3,7,0,10,0
59337,360,229,29,110,53,37,73,125,19,12,131,35,15,35,46,124,7
59338,63,52,7,26,19,0,21,21,2,8,11,2,0,7,2,9,2
59339,60,41,3,19,15,4,15,22,2,2,19,2,5,12,0,17,2
59343,42,40,4,23,9,4,24,13,3,0,2,0,0,0,2,2,0
59344,158,116,7,54,37,18,36,65,3,12,42,3,18,16,5,42,0
59347,134,100,16,47,27,10,35,55,5,5,34,5,12,11,6,29,5
59348,6,6,0,1,5,0,0,6,0,0,0,0,0,0,0,0,0
59349,416,270,46,109,84,31,83,170,12,5,146,7,40,55,44,135,11
59351,31,23,2,18,0,3,10,7,6,0,8,3,3,2,0,5,3
59353,425,292,46,134,83,29,104,147,22,19,133,16,39,29,49,123,10
59354,20,14,4,6,2,2,6,8,0,0,6,0,1,5,0,6,0
59401,6398,3443,829,1736,657,221,1083,1279,678,403,2955,763,862,697,633,2559,396
59404,9591,7189,1110,3638,1930,511,2517,3418,873,381,2402,371,785,888,358,1994,408
59405,12969,8437,2566,3513,1806,552,3207,3538,1254,438,4532,1112,1208,1270,942,3860,672
59410,308,200,24,92,65,19,65,114,12,9,108,9,46,31,22,102,6
59411,143,132,34,59,35,4,65,47,7,13,11,3,4,4,0,8,3
59412,648,448,57,226,136,29,151,241,35,21,200,24,58,52,66,184,16
59414,429,216,33,116,52,15,72,82,28,34,213,52,87,58,16,187,26
59416,203,140,11,78,37,14,38,91,4,7,63,6,33,15,9,58,5
59417,1929,1544,359,784,342,59,563,305,394,282,385,71,130,150,34,348,37
59419,33,25,1,10,6,8,4,20,0,1,8,2,4,2,0,6,2
59420,73,56,6,29,17,4,18,36,0,2,17,2,5,3,7,17,0
59421,762,541,45,255,192,49,170,312,36,23,221,27,45,81,68,203,18
59422,1190,796,114,358,242,82,292,384,74,46,394,44,102,88,160,360,34
59424,9,7,3,2,2,0,2,5,0,0,2,2,0,0,0,2,0
59425,1492,1047,165,505,271,106,409,490,111,37,445,80,95,150,120,414,31
59427,1955,1391,211,747,321,112,582,565,152,92,564,77,168,205,114,513,51
59430,210,140,4,66,43,27,47,89,4,0,70,12,15,21,22,67,3
59432,75,54,3,16,28,7,15,28,4,7,21,0,8,8,5,17,4
59433,267,186,16,102,58,10,74,86,17,9,81,7,18,32,24,75,6
59434,188,123,21,63,33,6,44,54,18,7,65,7,32,23,3,54,11
59436,733,518,86,251,138,43,207,248,42,21,215,46,65,60,44,188,27
59440,75,61,13,34,10,4,18,30,9,4,14,4,3,7,0,14,0
59441,45,39,4,18,13,4,15,20,2,2,6,0,0,6,0,6,0
59442,790,534,77,254,153,50,188,260,60,26,256,37,85,65,69,237,19
59443,255,201,24,115,49,13,68,101,15,17,54,5,13,20,16,52,2
59444,78,55,15,23,13,4,27,25,0,3,23,4,9,6,4,20,3
59446,269,202,28,103,44,27,85,95,12,10,67,19,12,24,12,61,6
59447,117,87,5,36,36,10,35,49,2,1,30,7,4,12,7,25,5
59448,279,245,46,123,66,10,114,55,47,29,34,2,17,15,0,34,0
59450,195,150,14,91,35,10,73,65,10,2,45,9,13,9,14,35,10
59451,394,288,18,160,86,24,111,156,19,2,106,17,36,35,18,97,9
59452,261,193,27,85,68,13,62,111,11,9,68,9,19,23,17,62,6
59453,115,80,10,27,31,12,15,51,12,2,35,5,9,12,9,33,2
59454,103,65,2,45,12,6,17,34,10,4,38,6,12,2,18,33,5
59456,44,25,0,2,14,9,2,23,0,0,19,0,4,4,11,19,0
59457,3765,2408,384,1110,691,223,820,1169,248,171,1357,189,350,429,389,1202,155
59460,91,64,15,21,21,7,19,39,4,2,27,5,12,2,8,27,0
59462,90,65,3,40,20,2,28,31,3,3,25,0,13,8,4,24,1
59463,84,58,3,25,24,6,11,47,0,0,26,4,9,9,4,22,4
59464,160,119,25,41,48,5,38,65,7,9,41,6,18,12,5,34,7
59465,48,34,0,9,24,1,6,23,2,3,14,0,2,7,5,12,2
59466,58,40,4,18,11,7,12,21,3,4,18,2,6,4,6,16,2
59467,35,23,3,9,11,0,10,13,0,0,12,4,0,6,2,8,4
59468,253,188,21,100,47,20,53,127,8,0,65,15,14,21,15,56,9
59469,66,54,5,33,13,3,25,22,5,2,12,0,4,6,2,10,2
59471,145,104,10,57,28,9,52,44,4,4,41,6,9,18,8,35,6
59472,200,131,12,85,28,6,47,66,7,11,69,15,24,12,18,58,11
59474,1404,903,157,454,228,64,359,415,81,48,501,102,124,136,139,460,41
59477,126,80,6,33,34,7,29,45,3,3,46,6,15,17,8,42,4
59479,401,246,14,131,67,34,97,126,9,14,155,17,48,50,40,141,14
59480,216,175,27,81,38,29,77,79,12,7,41,13,9,6,13,37,4
59482,277,235,36,128,57,14,110,100,18,7,42,6,10,16,10,35,7
59483,196,150,23,70,37,20,44,82,16,8,46,7,13,20,6,42,4
59484,71,43,8,19,12,4,18,20,3,2,28,2,5,15,6,21,7
59485,199,160,19,80,54,7,64,74,15,7,39,3,13,21,2,30,9
59486,499,373,49,172,122,30,153,184,21,15,126,20,36,38,32,116,10
59487,494,388,75,171,119,23,149,175,40,24,106,9,41,38,18,89,17
59501,5373,3421,741,1727,725,228,1231,1538,520,132,1952,507,593,450,402,1630,322
59520,506,353,28,185,99,41,107,172,43,31,153,19,41,38,55,139,14
59521,722,636,165,335,122,14,289,119,131,97,86,18,25,35,8,70,16
59522,605,424,30,226,130,38,153,227,31,13,181,27,39,45,70,173,8
59523,1090,690,113,323,192,62,256,332,66,36,400,33,129,128,110,363,37
59524,238,196,27,97,62,10,71,81,30,14,42,2,12,15,13,40,2
59525,125,84,15,37,22,10,34,46,2,2,41,10,11,10,10,41,0
59526,862,663,148,319,149,47,234,207,127,95,199,16,67,76,40,187,12
59527,309,248,42,134,58,14,83,46,64,55,61,3,16,35,7,53,8
59528,118,85,7,53,21,4,47,38,0,0,33,2,9,20,2,26,7
59529,33,25,5,8,7,5,5,18,2,0,8,6,0,2,0,8,0
59530,76,56,4,32,14,6,24,26,2,4,20,7,0,5,8,20,0
59531,153,117,17,54,37,9,46,60,5,6,36,1,12,7,16,35,1
59532,92,59,9,26,20,4,26,29,4,0,33,4,13,11,5,29,4
59535,46,33,9,15,9,0,11,22,0,0,13,4,3,6,0,13,0
59537,50,45,6,26,9,4,17,28,0,0,5,0,4,0,1,2,3
59538,1294,860,132,401,234,93,309,406,94,51,434,50,131,123,130,389,45
59540,166,106,14,48,30,14,36,53,8,9,60,4,19,15,22,51,9
59542,101,73,7,40,18,8,29,31,9,4,28,18,3,7,0,22,6
59544,63,50,16,17,12,5,26,19,0,5,13,4,6,3,0,13,0
59545,18,10,4,2,2,2,4,6,0,0,8,4,2,2,0,6,2
59546,51,24,0,15,9,0,12,8,4,0,27,0,12,10,5,27,0
59547,19,16,2,7,5,2,7,9,0,0,3,1,2,0,0,3,0
59601,12718,7265,1411,3652,1649,553,2428,3215,1076,546,5453,1261,1909,1395,888,4620,833
59602,6887,5315,910,2903,1242,260,2073,2373,580,289,1572,190,682,518,182,1310,262
59631,113,71,14,31,21,5,20,39,10,2,42,5,27,9,1,39,3
59632,675,432,73,247,97,15,165,167,68,32,243,40,95,60,48,216,27
59633,86,64,9,36,10,9,24,38,0,2,22,6,1,13,2,22,0
59634,1457,1251,125,805,300,21,566,617,51,17,206,25,100,66,15,159,47
59635,2019,1558,325,943,265,25,785,519,167,87,461,73,217,119,52,345,116
59636,9,6,0,6,0,0,6,0,0,0,3,2,1,0,0,3,0
59638,148,114,17,73,16,8,37,58,5,14,34,3,17,6,8,32,2
59639,570,363,41,166,131,25,110,195,41,17,207,21,84,77,25,176,31
59640,40,17,0,6,9,2,4,11,2,0,23,4,19,0,0,13,10
59642,24,16,2,8,6,0,7,9,0,0,8,0,3,5,0,8,0
59643,255,188,19,96,64,9,39,132,0,17,67,6,30,23,8,60,7
59644,1378,997,140,461,327,69,323,512,98,64,381,36,123,136,86,348,33
59645,662,446,60,219,141,26,153,225,54,14,216,22,55,70,69,198,18
59648,330,246,23,112,105,6,50,167,15,14,84,15,25,30,14,70,14
59701,14087,8656,1748,4033,2247,628,2868,3953,1145,690,5431,946,1647,1501,1337,4673,758
59710,146,99,9,59,26,5,36,57,1,5,47,6,17,12,12,34,13
59711,3966,2507,431,1121,723,232,802,1243,244,218,1459,160,343,555,401,1326,133
59713,80,56,8,29,19,0,18,32,4,2,24,0,14,4,6,22,2
59714,3919,2911,904,1447,520,40,1264,1218,317,112,1008,302,408,207,91,706,302
59715,11649,6243,1521,3081,1316,325,2223,2887,684,449,5406,2930,1279,626,571,3228,2178
59716,284,143,37,67,36,3,37,82,12,12,141,56,50,27,8,106,35
59718,6573,4269,994,2311,799,165,1706,1909,398,256,2304,1069,727,329,179,1383,921
59720,102,68,6,30,30,2,18,41,9,0,34,3,22,9,0,31,3
59721,155,107,23,42,38,4,46,55,2,4,48,5,17,9,17,42,6
59722,1849,1201,196,537,336,132,346,624,166,65,648,63,211,201,173,563,85
59725,3152,2036,317,1028,524,167,796,951,178,111,1116,357,248,294,217,906,210
59727,72,55,4,26,9,16,15,38,0,2,17,0,10,5,2,17,0
59728,156,113,24,46,35,8,43,57,8,5,43,0,9,18,16,40,3
59729,901,531,58,252,170,51,147,307,47,30,370,126,118,83,43,296,74
59730,645,450,68,244,111,27,154,252,23,21,195,85,70,35,5,125,70
59731,89,68,10,27,23,8,16,42,5,5,21,0,9,8,4,14,7
59733,43,35,7,12,13,3,11,22,2,0,8,0,4,3,1,7,1
59735,123,84,10,46,23,5,39,39,4,2,39,4,7,18,10,33,6
59736,54,35,6,17,12,0,17,16,0,2,19,2,4,10,3,19,0
59739,171,117,20,60,27,10,49,58,8,2,54,8,18,16,12,52,2
59740,173,131,21,52,40,18,31,93,0,7,42,9,20,9,4,22,20
59741,1453,1115,180,591,251,93,432,552,84,47,338,65,113,92,68,290,48
59743,73,58,2,31,17,8,21,29,5,3,15,3,2,3,7,13,2
59745,41,25,0,20,3,2,16,7,2,0,16,4,2,8,2,13,3
59746,51,28,4,16,8,0,14,14,0,0,23,0,11,5,7,20,3
59747,80,58,11,16,27,4,18,35,3,2,22,0,7,8,7,21,1
59748,116,96,4,63,21,8,48,33,9,6,20,0,6,11,3,17,3
59749,654,413,45,178,151,39,128,242,30,13,241,17,65,81,78,217,24
59750,144,127,17,68,30,12,45,61,10,11,17,1,8,8,0,13,4
59751,68,48,2,17,19,10,6,35,6,1,20,0,8,8,4,14,6
59752,1175,830,173,421,202,34,369,366,70,25,345,59,112,84,90,285,60
59754,378,248,34,129,75,10,89,135,12,12,130,15,44,39,32,118,12
59755,85,44,0,37,7,0,19,21,2,2,41,2,20,11,8,36,5
59756,85,37,0,27,10,0,10,27,0,0,48,23,15,10,0,41,7
59758,710,425,78,243,98,6,123,231,62,9,285,74,151,53,7,219,66
59759,1296,962,125,473,307,57,342,502,66,52,334,35,99,116,84,282,52
59761,146,81,22,35,19,5,31,45,2,3,65,14,12,32,7,57,8
59762,145,89,11,33,43,2,25,60,4,0,56,3,25,26,2,41,15
59801,12069,5933,1691,2594,1086,562,1649,2591,1021,672,6136,3053,1654,718,711,4067,2069
59802,8067,3984,884,2013,894,193,1228,1695,690,371,4083,1820,1224,557,482,2903,1180
59803,5171,3833,710,2112,885,126,1560,1642,403,228,1338,388,524,307,119,930,408
59804,2890,1991,296,977,558,160,797,965,162,67,899,240,275,191,193,715,184
59808,4139,2833,569,1584,558,122,1191,1124,377,141,1306,356,380,422,148,1023,283
59820,479,350,67,174,96,13,120,170,41,19,129,33,46,36,14,98,31
59821,946,672,134,360,145,33,216,261,125,70,274,44,114,87,29,234,40
59823,384,280,36,164,70,10,111,140,17,12,104,17,50,17,20,84,20
59824,595,424,71,200,134,19,175,173,52,24,171,41,55,43,32,144,27
59825,884,669,148,320,177,24,234,329,78,28,215,58,76,62,19,152,63
59826,256,179,10,89,70,10,51,116,2,10,77,6,25,33,13,66,11
59827,110,43,6,21,16,0,13,30,0,0,67,0,11,48,8,55,12
59828,1578,1227,128,643,352,104,428,642,108,49,351,77,104,112,58,281,70
59829,1040,777,105,344,263,65,207,420,92,58,263,48,140,44,31,214,49
59831,207,125,24,68,27,6,37,55,30,3,82,7,36,34,5,70,12
59832,318,220,32,106,66,16,81,104,29,6,98,21,29,28,20,78,20
59833,1699,1404,255,741,350,58,597,703,70,34,295,39,150,73,33,223,72
59834,588,470,46,313,96,15,217,206,17,30,118,9,67,30,12,81,37
59836,107,83,16,43,17,7,39,35,4,5,24,6,6,7,5,19,5
59837,82,52,2,20,23,7,14,29,2,7,30,0,11,13,6,27,3
59840,5343,3430,447,1580,1066,337,1047,1780,404,199,1913,256,494,581,582,1690,223
59841,84,78,17,34,27,0,41,14,17,6,6,0,2,4,0,6,0
59842,29,14,0,4,10,0,0,14,0,0,15,0,6,9,0,13,2
59843,107,81,6,39,28,8,31,46,2,2,26,0,5,13,8,24,2
59844,222,164,13,79,64,8,57,96,11,0,58,0,29,20,9,54,4
59845,507,287,42,109,95,41,66,163,38,20,220,12,69,71,68,194,26
59846,571,440,76,214,132,18,142,253,19,26,131,28,57,21,25,115,16
59847,1782,1385,352,748,191,94,595,527,163,100,397,78,159,112,48,298,99
59848,54,37,2,17,14,4,13,20,2,2,17,0,7,3,7,17,0
59851,66,45,0,21,11,13,0,45,0,0,21,0,13,8,0,21,0
59853,261,183,7,87,79,10,40,113,24,6,78,9,21,35,13,66,12
59854,109,81,4,40,30,7,19,48,6,8,28,0,6,13,9,26,2
59855,229,182,94,58,21,9,66,13,67,36,47,14,12,6,15,33,14
59858,626,408,46,204,127,31,136,189,46,37,218,25,70,77,46,201,17
59859,1412,972,129,463,299,81,294,529,94,55,440,42,151,167,80,383,57
59860,3738,2586,426,1096,840,224,774,1267,345,200,1152,224,413,318,197,999,153
59864,2163,1601,403,759,352,87,569,605,315,112,562,93,197,183,89,485,77
59865,1088,789,133,391,217,48,247,327,131,84,299,30,98,117,54,259,40
59866,331,234,33,118,63,20,69,132,28,5,97,13,46,27,11,78,19
59867,93,67,8,28,25,6,22,41,1,3,26,2,17,7,0,22,4
59868,788,542,61,257,200,24,185,284,44,29,246,46,90,80,30,196,50
59870,3258,2420,379,1182,735,124,853,1301,167,99,838,155,271,238,174,664,174
59871,94,68,20,21,27,0,30,38,0,0,26,0,11,15,0,26,0
59872,895,595,97,255,205,38,168,344,60,23,300,32,117,111,40,244,56
59873,1110,794,98,383,263,50,222,464,79,29,316,47,73,109,87,263,53
59874,529,387,40,158,182,7,90,247,30,20,142,15,43,43,41,130,12
59875,1411,1054,193,484,305,72,313,576,107,58,357,17,132,168,40,295,62
59901,15684,10693,2165,5372,2410,746,3764,4861,1432,636,4991,844,1695,1479,973,4152,839
59910,160,104,0,53,51,0,20,58,15,11,56,4,21,25,6,30,26
59911,2907,2085,188,960,760,177,604,1224,163,94,822,102,283,293,144,677,145
59912,4494,3403,642,1743,887,131,1223,1550,418,212,1091,201,354,341,195,872,219
59913,278,177,40,77,53,7,60,94,23,0,101,11,66,17,7,86,15
59914,137,98,8,27,51,12,8,70,7,13,39,1,21,12,5,39,0
59915,73,47,12,31,2,2,20,8,10,9,26,6,9,3,8,20,6
59916,55,40,3,16,21,0,7,25,3,5,15,4,7,3,1,13,2
59917,1544,1052,146,560,289,57,344,530,139,39,492,53,160,173,106,414,78
59918,163,115,11,54,32,18,28,72,13,2,48,4,29,6,9,43,5
59919,309,242,56,125,46,15,79,88,64,11,67,0,33,25,9,52,15
59920,266,214,33,140,36,5,95,97,15,7,52,0,24,22,6,46,6
59921,1,0,0,0,0,0,0,0,0,0,1,0,1,0,0,1,0
59922,818,586,65,264,182,75,184,332,39,31,232,28,99,72,33,207,25
59923,4239,2944,416,1372,993,163,889,1555,341,159,1295,176,388,489,242,1125,170
59925,323,240,25,128,81,6,95,124,18,3,83,14,39,22,8,78,5
59926,201,118,0,94,19,5,52,52,14,0,83,19,34,19,11,68,15
59927,57,36,5,15,16,0,10,24,2,0,21,0,6,12,3,19,2
59928,33,11,0,7,0,4,0,7,0,4,22,0,22,0,0,22,0
59929,79,60,12,7,35,6,8,44,8,0,19,0,9,7,3,15,4
59930,294,228,43,87,91,7,79,125,18,6,66,16,26,19,5,55,11
59931,111,78,8,26,26,18,14,64,0,0,33,0,9,15,9,33,0
59932,444,292,19,109,126,38,69,200,7,16,152,25,61,32,34,110,42
59933,11,2,0,0,2,0,0,2,0,0,9,1,8,0,0,8,1
59934,173,121,19,60,21,21,50,58,8,5,52,9,21,22,0,40,12
59935,1364,949,112,419,332,86,284,519,97,49,415,35,162,158,60,374,41
59936,157,96,9,54,29,4,25,63,2,6,61,18,17,13,13,47,14
59937,4804,3180,495,1807,698,180,1195,1468,420,97,1624,457,575,415,177,1255,369
60002,7419,5360,796,2958,1373,233,2040,2379,618,323,2059,528,713,514,304,1689,370
60004,20450,14664,2293,7238,4047,1086,6107,6872,695,990,5786,1402,1770,1515,1099,5021,765
60005,12569,7367,1229,3476,2003,659,2758,3578,385,646,5202,1400,1389,1240,1173,4568,634
60007,13460,9517,1435,5173,2562,347,3995,4161,599,762,3943,823,1341,1033,746,3378,565
60008,8590,6026,1255,2972,1524,275,2451,2523,437,615,2564,676,868,696,324,2096,468
60010,14102,11661,950,6595,3520,596,5193,5498,537,433,2441,232,812,1023,374,2139,302
60012,3318,2693,208,1714,693,78,1383,1174,44,92,625,41,157,164,263,493,132
60013,7810,6583,944,4325,1092,222,3640,2226,419,298,1227,187,509,336,195,1063,164
60014,14971,11850,2243,6834,2347,426,5993,4257,927,673,3121,664,1009,862,586,2545,576
60015,9514,7509,885,4309,2012,303,3546,3227,338,398,2005,323,606,680,396,1759,246
60016,22822,15014,2851,7294,3736,1133,5585,6559,1118,1752,7808,1541,2543,2147,1577,6647,1161
60018,10699,7510,1398,3717,1883,512,2971,3067,596,876,3189,354,1014,1075,746,2798,391
60020,2802,1614,353,749,355,157,534,719,188,173,1188,217,366,297,308,1010,178
60021,2035,1563,259,972,288,44,764,630,66,103,472,75,239,111,47,383,89
60022,2955,2492,115,1405,731,241,1275,1041,138,38,463,21,127,118,197,387,76
60025,18607,14038,1663,7309,3852,1214,5584,6593,928,933,4569,545,1300,1732,992,4067,502
60029,125,100,7,42,41,10,44,46,5,5,25,6,3,12,4,18,7
60030,11554,8967,2068,5000,1513,386,4652,3294,642,379,2587,593,1113,517,364,2103,484
60031,13883,10013,2217,6007,1474,315,5166,3408,882,557,3870,1141,1326,1034,369,3183,687
60033,4456,3429,793,1600,872,164,1420,1400,346,263,1027,248,300,246,233,920,107
60034,689,531,90,294,117,30,182,237,78,34,158,22,63,35,38,133,25
60035,11186,8676,841,4438,2627,770,3661,4308,396,311,2510,235,695,931,649,2253,257
60037,256,249,105,144,0,0,212,24,13,0,7,0,7,0,0,7,0
60040,1832,1197,414,514,141,128,476,370,200,151,635,138,199,191,107,529,106
60041,3418,2537,400,1381,676,80,1037,1103,196,201,881,253,288,205,135,656,225
60042,3042,2299,658,1381,240,20,1292,674,198,135,743,147,386,126,84,607,136
60043,820,732,36,409,249,38,379,299,36,18,88,4,5,36,43,84,4
60044,4072,2743,382,1548,680,133,1233,1159,226,125,1329,455,445,344,85,1117,212
60045,7411,5921,311,3429,1772,409,2795,2719,263,144,1490,134,337,532,487,1298,192
60046,10390,8334,1735,4892,1454,253,3883,3524,580,347,2056,477,837,433,309,1665,391
60047,11816,10382,980,7244,1984,174,6048,3510,515,309,1434,242,692,366,134,1133,301
60048,9783,7705,759,4618,2096,232,3772,3157,479,297,2078,510,654,430,484,1760,318
60050,17330,12921,2484,7021,2818,598,5684,5214,1081,942,4409,1024,1570,1213,602,3606,803
60053,7911,6196,416,2948,2056,776,2272,3107,185,632,1715,106,324,766,519,1585,130
60056,21644,15487,2917,7089,4348,1133,5841,7356,757,1533,6157,1597,1731,1657,1172,5219,938
60060,11828,9386,1967,5633,1531,255,4819,3228,708,631,2442,600,1018,538,286,1931,511
60061,7664,5512,1143,3477,767,125,2975,1642,481,414,2152,670,857,352,273,1857,295
60062,15016,11710,785,5669,3952,1304,4642,5959,536,573,3306,302,735,1235,1034,3005,301
60064,4871,3447,1100,1496,685,166,1054,872,936,585,1424,330,437,431,226,1158,266
60067,19825,13856,2084,7361,3733,678,5719,6495,707,935,5969,1512,2082,1506,869,4967,1002
60068,14242,10484,873,5059,3389,1163,4121,4945,555,863,3758,413,1080,1096,1169,3465,293
60069,2518,2088,118,1136,690,144,855,1099,50,84,430,16,124,241,49,373,57
60070,6125,4237,1215,1790,971,261,1642,1862,286,447,1888,490,670,452,276,1556,332
60071,1037,774,114,437,195,28,311,374,34,55,263,34,66,102,61,228,35
60072,130,106,6,46,46,8,26,65,7,8,24,3,8,11,2,21,3
60073,11750,9379,2948,4953,1326,152,4727,2695,1250,707,2371,589,932,586,264,1826,545
60074,8904,5335,2185,2333,693,124,2272,1731,672,660,3569,1599,1292,468,210,2575,994
60076,11858,9175,817,4713,2612,1033,3572,4085,565,953,2683,238,638,859,948,2381,302
60077,10064,6792,748,3214,1914,916,2341,3055,487,909,3272,337,769,896,1270,2974,298
60081,2917,2281,321,1365,534,61,1122,862,148,149,636,170,284,141,41,467,169
60083,1878,1584,134,930,485,35,650,808,47,79,294,66,106,103,19,249,45
60084,4859,3449,695,1794,808,152,1443,1442,259,305,1410,224,563,446,177,1159,251
60085,23069,15764,5820,7031,2247,666,6540,4172,3014,2038,7305,2070,2509,1650,1076,6010,1295
60087,8094,6059,1416,2930,1395,318,2409,2392,683,575,2035,361,773,604,297,1684,351
60088,2035,1914,1227,681,6,0,1398,313,187,16,121,71,38,12,0,76,45
60089,15080,11448,1501,7218,2390,339,5852,4401,624,571,3632,678,1414,1012,528,3178,454
60090,14250,9002,2137,4613,1833,419,3730,3699,742,831,5248,1641,1723,1192,692,4464,784
60091,9810,7640,493,4272,2144,731,3768,3065,384,423,2170,111,553,900,606,1992,178
60093,7030,5488,286,2958,1730,514,2602,2333,282,271,1542,200,401,558,383,1441,101
60096,2455,1980,280,1154,492,54,818,904,166,92,475,110,140,130,95,393,82
60097,3690,2870,645,1537,589,99,1221,1213,231,205,820,192,362,169,97,649,171
60098,9820,7028,1502,3728,1450,348,3011,2895,732,390,2792,647,951,708,486,2271,521
60099,10043,7536,2143,3879,1184,330,2876,2379,1567,714,2507,557,923,662,365,2124,383
60101,12364,9702,2039,4669,2629,365,3919,4014,835,934,2662,674,922,645,421,2023,639
60102,16204,13157,3531,7525,1801,300,7461,4438,726,532,3047,1070,1224,503,250,2358,689
60103,23635,19438,4572,11560,2951,355,10116,6258,1724,1340,4197,1062,1935,855,345,3292,905
60104,6432,5125,775,2916,1221,213,1516,1562,1049,998,1307,175,576,381,175,1131,176
60106,7477,5125,1281,2439,1159,246,2036,2125,430,534,2352,502,816,618,416,1836,516
60107,11779,9184,2242,5105,1593,244,3929,3586,897,772,2595,768,1145,552,130,2124,471
60108,8351,5889,999,3000,1694,196,2112,2902,386,489,2462,757,872,461,372,2009,453
60109,70,43,9,30,4,0,12,21,5,5,27,8,14,4,1,17,10
60110,9128,7567,2552,3580,1255,180,3422,2289,1123,733,1561,382,639,403,137,1224,337
60111,106,71,9,46,13,3,48,23,0,0,35,2,13,3,17,30,5
60112,467,339,106,176,51,6,170,101,47,21,128,54,50,14,10,102,26
60113,114,80,17,33,19,11,31,33,8,8,34,6,8,16,4,29,5
60115,14483,7511,2501,3137,1370,503,2754,3031,1119,607,6972,4436,1162,737,637,4252,2720
60118,5396,4122,651,2354,932,185,1763,1840,301,218,1274,232,508,348,186,1018,256
60119,2603,2123,301,1261,497,64,976,926,139,82,480,66,167,128,119,415,65
60120,15418,11387,3304,5941,1660,482,5367,3538,1369,1113,4031,962,1614,881,574,3287,744
60123,19123,13723,3151,7054,2765,753,5635,5402,1610,1076,5400,1104,1898,1483,915,4369,1031
60126,16635,12067,1593,6343,3105,1026,5198,5391,622,856,4568,734,1273,1255,1306,4065,503
60129,100,75,16,43,12,4,35,38,2,0,25,3,15,3,4,25,0
60130,7625,3529,1073,1634,562,260,1179,1179,604,567,4096,1288,1584,796,428,3445,651
60131,6478,4804,969,2332,1121,382,1932,1847,346,679,1674,271,444,517,442,1470,204
60134,7249,5703,918,3457,1089,239,3063,2017,390,233,1546,288,605,393,260,1331,215
60135,2183,1683,362,859,365,97,699,753,120,111,500,110,180,87,123,468,32
60136,485,425,60,308,55,2,204,188,23,10,60,12,22,11,15,51,9
60137,14084,10435,1583,5695,2631,526,4787,4428,564,656,3649,830,1236,941,642,3136,513
60139,11067,7844,2054,4230,1381,179,3566,2737,746,795,3223,1433,1136,505,149,2514,709
60140,2512,2076,253,1194,495,134,930,874,120,152,436,84,132,112,108,386,50
60141,0,0,0,0,0,0,0,0,0,0,0,0,0,0,0,0,0
60142,3024,2465,560,910,870,125,887,1330,131,117,559,155,152,184,68,459,100
60143,3776,2760,434,1348,877,101,1032,1329,183,216,1016,254,429,217,116,828,188
60145,883,721,129,405,146,41,336,273,60,52,162,21,83,40,18,123,39
60146,804,624,112,326,146,40,260,258,70,36,180,37,65,45,33,153,27
60148,19265,12853,2484,6429,3086,854,5045,5716,883,1209,6412,1798,2062,1392,1160,5294,1118
60150,635,474,110,211,116,37,201,209,43,21,161,35,47,32,47,132,29
60151,1253,961,140,555,238,28,464,383,68,46,292,17,153,49,73,250,42
60152,3947,3042,471,1598,813,160,1200,1370,273,199,905,150,319,280,156,779,126
60153,7942,6170,1046,2968,1867,289,1527,1738,1375,1530,1772,188,612,673,299,1534,238
60154,6863,4852,563,2052,1507,730,1417,2619,245,571,2011,190,508,627,686,1831,180
60155,3215,2111,413,964,583,151,615,696,318,482,1104,128,514,289,173,925,179
60157,764,648,63,253,257,75,207,394,11,36,116,0,9,69,38,116,0
60160,7571,5480,1549,2415,1060,456,2225,1720,672,863,2091,414,622,587,468,1771,320
60162,3184,2175,553,931,505,186,633,887,345,310,1009,185,398,230,196,850,159
60163,1867,1393,239,681,350,123,531,546,128,188,474,65,125,138,146,399,75
60164,6997,5145,789,2709,1256,391,2157,1849,356,783,1852,246,631,508,467,1596,256
60165,1256,1029,341,482,154,52,558,205,92,174,227,40,97,70,20,152,75
60171,4312,2740,614,1313,510,303,917,1050,373,400,1572,176,486,456,454,1343,229
60172,9159,6932,1184,4105,1360,283,3117,2706,506,603,2227,637,859,467,264,1836,391
60173,5870,2844,972,1458,372,42,1044,1252,293,255,3026,1550,1104,261,111,2431,595
60174,11640,8309,1203,4745,1873,488,3524,3551,607,627,3331,824,1197,726,584,2772,559
60175,5533,5135,393,3551,1116,75,2776,2060,179,120,398,32,212,108,46,314,84
60176,4088,2996,800,1330,664,202,1183,1147,267,399,1092,315,381,253,143,883,209
60177,5903,4617,1691,2219,649,58,2165,1674,458,320,1286,401,574,216,95,1018,268
60178,6258,4394,858,2321,978,237,1930,1753,493,218,1864,436,559,512,357,1570,294
60180,557,446,71,250,105,20,243,167,15,21,111,8,48,36,19,75,36
60181,11162,7831,1810,3769,1682,570,3012,3190,788,841,3331,707,1208,833,583,2865,466
60184,266,232,16,137,69,10,88,109,7,28,34,0,17,8,9,21,13
60185,9625,8074,1936,4282,1641,215,3807,3021,583,663,1551,352,627,376,196,1182,369
60187,21570,15764,2534,8907,3522,801,7304,6552,936,972,5806,1348,2089,1424,945,4979,827
60188,14756,11039,2694,6852,1230,263,5916,3315,1036,772,3717,1177,1381,570,589,2969,748
60190,3855,3178,313,1975,813,77,1495,1442,168,73,677,73,317,191,96,591,86
60191,5517,3947,439,1946,1315,247,1267,1963,351,366,1570,244,519,480,327,1284,286
60192,520,487,78,376,33,0,333,145,9,0,33,0,16,17,0,22,11
60193,16416,10988,1883,5672,2951,482,4239,4879,811,1059,5428,1429,1773,1452,774,4602,826
60194,15530,10563,2441,5825,1933,364,4457,3845,1159,1102,4967,1331,1850,873,913,4155,812
60195,10806,7643,1543,4575,1397,128,3494,2987,671,491,3163,1551,1038,450,124,2355,808
60201,15950,8320,1756,3983,1908,673,2982,3728,798,812,7630,3255,1602,1508,1265,6077,1553
60202,13718,7744,1766,4065,1562,351,2558,2978,1313,895,5974,2078,2243,1134,519,4660,1314
60203,1704,1272,126,653,399,94,555,562,40,115,432,32,103,133,164,375,57
60301,1383,507,214,157,106,30,83,262,76,86,876,211,351,196,118,764,112
60302,14812,7876,1547,4540,1429,360,3101,2827,1099,849,6936,2580,2177,1191,988,5913,1023
60304,6912,4660,959,2689,839,173,2026,1525,606,503,2252,754,832,474,192,1853,399
60305,4107,2948,309,1652,731,256,1332,1110,215,291,1159,139,300,391,329,1050,109
60401,2198,1635,141,786,540,168,511,930,98,96,563,57,172,196,138,495,68
60402,22237,14679,3732,6431,3068,1448,5667,5134,1597,2281,7558,1440,2229,1999,1890,6504,1054
60406,9065,5940,1735,2722,1103,380,2120,1663,1297,860,3125,647,1167,744,567,2655,470
60407,558,446,136,207,85,18,179,168,66,33,112,33,31,41,7,94,18
60408,1841,1437,301,775,324,37,572,624,151,90,404,92,160,111,41,331,73
60409,15153,10140,2708,4604,2021,807,2980,3103,2417,1640,5013,711,1835,1430,1037,4578,435
60410,2391,2125,290,1303,480,52,1112,772,108,133,266,84,127,29,26,207,59
60411,20277,15130,3763,6763,3591,1013,4756,4972,3081,2321,5147,873,1799,1523,952,4429,718
60415,5515,3365,1123,1321,763,158,1199,1294,418,454,2150,688,690,444,328,1744,406
60416,2800,2025,443,1057,396,129,751,847,278,149,775,197,135,253,190,662,113
60417,5777,4641,502,2387,1505,247,1617,2425,242,357,1136,91,388,400,257,1025,111
60419,8462,6593,1194,3807,1354,238,2037,1838,1566,1152,1869,181,775,512,401,1696,173
60420,1916,1314,289,636,304,85,485,555,194,80,602,111,172,136,183,529,73
60421,1277,996,207,474,264,51,362,510,67,57,281,47,98,90,46,228,53
60422,3260,2643,157,1432,905,149,1132,1153,171,187,617,46,174,263,134,577,40
60423,7360,6241,697,4008,1340,196,3118,2433,412,278,1119,137,460,367,155,952,167
60424,907,653,144,330,131,48,232,278,95,48,254,47,78,74,55,214,40
60425,3408,2453,314,1161,810,168,755,1008,332,358,955,109,301,305,240,856,99
60426,14513,11235,2549,4968,2947,771,2802,3105,2787,2541,3278,387,1117,1122,652,2851,427
60429,5400,4007,694,2117,1015,181,1236,1308,813,650,1393,158,478,339,418,1183,210
60430,8133,5697,669,3178,1325,525,2320,2217,634,526,2436,311,811,611,703,2196,240
60431,7667,6336,1124,3808,1246,158,3116,2384,448,388,1331,304,522,377,128,1057,274
60432,5796,4524,1562,1958,812,192,1802,1076,957,689,1272,217,489,340,226,1021,251
60433,5770,4183,944,1994,981,264,1416,1484,745,538,1587,282,571,405,329,1362,225
60435,21138,13383,3674,5750,2915,1044,4649,5419,1833,1482,7755,1859,2367,1839,1690,6464,1291
60436,6303,3945,1058,1691,808,388,1326,1389,592,638,2358,424,460,733,741,2054,304
60437,88,59,11,23,21,4,24,33,2,0,29,0,8,4,17,29,0
60438,11572,7917,1313,3789,2106,709,2659,3603,862,793,3655,790,1013,983,869,3186,469
60439,6618,5345,502,3161,1406,276,2486,2276,228,355,1273,171,368,330,404,1082,191
60440,14511,11809,2699,7024,1927,159,5247,4005,1550,1007,2702,690,1099,609,304,2256,446
60441,15281,12501,2212,6896,2759,634,5722,5053,755,971,2780,512,1083,750,435,2259,521
60442,2050,1634,252,988,314,80,823,646,90,75,416,92,131,98,95,363,53
60443,5537,4166,507,2220,1131,308,1299,1780,563,524,1371,200,421,420,330,1209,162
60444,562,436,71,213,118,34,178,199,29,30,126,35,29,31,31,95,31
60445,10049,6697,1313,3341,1614,429,2396,2594,706,1001,3352,775,1177,892,508,2914,438
60446,6752,5389,1739,2530,982,138,2596,1953,413,427,1363,573,422,294,74,1036,327
60447,2424,1956,337,1115,457,47,1005,698,92,161,468,113,173,122,60,374,94
60448,6340,5468,815,3319,1192,142,2802,2149,289,228,872,261,327,153,131,776,96
60449,2141,1656,303,820,457,76,613,913,77,53,485,87,143,161,94,359,126
60450,7432,5193,988,2671,1212,322,1943,2469,556,225,2239,455,743,551,490,1878,361
60451,8833,7480,1287,4460,1475,258,3743,2889,458,390,1353,265,455,383,250,1108,245
60452,9629,7250,1264,3780,1840,366,3137,2919,485,709,2379,702,817,543,317,1996,383
60453,22089,14587,1995,6136,4552,1904,4937,6775,843,2032,7502,959,1898,2245,2400,6830,672
60455,5913,3960,798,1971,898,293,1578,1559,342,481,1953,315,555,562,521,1699,254
60456,1867,1160,187,540,332,101,388,466,104,202,707,49,155,232,271,665,42
60457,5228,3879,611,1856,1136,276,1463,1620,331,465,1349,316,346,411,276,1141,208
60458,5265,3584,1023,1877,587,97,1234,1212,758,380,1681,528,608,353,192,1279,402
60459,9327,7293,1109,3476,2124,584,2636,2817,685,1155,2034,271,499,625,639,1787,247
60460,602,450,70,210,131,39,146,217,54,33,152,32,32,52,36,140,12
60461,1665,1352,56,608,558,130,373,844,89,46,313,18,66,159,70,258,55
60462,14264,10845,1111,5362,3491,881,3864,5364,640,977,3419,498,887,1198,836,3102,317
60463,4911,3793,235,1647,1543,368,1190,2160,152,291,1118,23,247,496,352,1049,69
60464,3512,2538,75,1257,903,303,977,1255,64,242,974,40,242,305,387,904,70
60465,7163,4604,712,1987,1485,420,1383,2277,312,632,2559,491,812,793,463,2209,350
60466,11330,7799,1714,3929,1744,412,2448,2662,1517,1172,3531,466,1395,1087,583,3117,414
60467,6905,5896,492,3432,1637,335,2723,2714,175,284,1009,106,363,388,152,856,153
60468,1896,1466,236,794,330,106,708,557,110,91,430,62,127,155,86,366,64
60469,1626,1144,227,571,255,91,391,451,135,167,482,105,171,98,108,402,80
60470,244,195,43,91,57,4,74,96,16,9,49,6,5,23,15,46,3
60471,4768,3318,800,1853,537,128,1204,971,717,426,1450,285,632,317,216,1263,187
60472,2035,1488,326,546,507,109,182,327,515,464,547,86,127,180,154,469,78
60473,7754,6157,623,2998,2008,528,2194,2804,497,662,1597,105,441,520,531,1470,127
60474,291,188,37,82,48,21,68,99,14,7,103,24,22,18,39,85,18
60475,3590,2376,562,1076,614,124,837,971,314,254,1214,371,438,229,176,1052,162
60476,1013,717,101,327,216,73,227,338,73,79,296,44,76,110,66,248,48
60477,20208,15085,2542,8574,3140,829,6734,5959,1122,1270,5123,1182,1515,1458,968,4400,723
60478,5390,4179,590,2385,1084,120,1325,1318,754,782,1211,197,548,338,128,1079,132
60479,264,215,32,105,55,23,95,98,11,11,49,2,10,30,7,49,0
60480,1848,1312,230,632,411,39,408,714,111,79,536,80,243,158,55,455,81
60481,4236,3017,489,1617,788,123,1162,1292,279,284,1219,187,419,401,212,1015,204
60482,4518,2895,549,1400,797,149,976,1121,344,454,1623,506,480,366,271,1358,265
60490,2772,2481,607,1539,304,31,1471,818,127,65,291,89,159,43,0,216,75
60501,3553,2579,683,1141,506,249,975,760,395,449,974,185,261,297,231,812,162
60504,16114,11955,4566,6397,868,124,6498,3946,1080,431,4159,2095,1616,363,85,3023,1136
60505,16217,12405,4548,5395,2011,451,5532,3244,2173,1456,3812,883,1405,888,636,3054,758
60506,17743,12726,3060,6381,2586,699,5021,4821,1721,1163,5017,911,1955,1135,1016,4219,798
60510,9262,7019,997,4497,1174,351,3434,2647,510,428,2243,472,653,544,574,1929,314
60511,644,582,76,311,167,28,188,356,20,18,62,8,22,15,17,47,15
60512,295,233,22,106,94,11,61,155,17,0,62,18,6,10,28,42,20
60513,7518,5043,922,2561,1193,367,1969,2091,398,585,2475,398,823,594,660,2082,393
60514,7591,4531,809,2184,1143,395,1800,2039,349,343,3060,707,1203,732,418,2713,347
60515,11152,7230,999,3942,1638,651,3040,3211,473,506,3922,661,1139,880,1242,3474,448
60516,11244,8519,1337,4635,2214,333,3540,3864,505,610,2725,513,1152,685,375,2298,427
60517,11653,8386,1954,4721,1525,186,3599,3034,1044,709,3267,1295,1260,525,187,2703,564
60518,1332,1023,217,476,238,92,436,443,90,54,309,42,104,64,99,274,35
60519,6,6,0,6,0,0,6,0,0,0,0,0,0,0,0,0,0
60520,1026,798,132,440,159,67,362,328,48,60,228,53,85,54,36,178,50
60521,13122,10135,861,5842,2879,553,4780,4272,586,497,2987,550,913,836,688,2618,369
60523,3733,2741,31,1036,1411,263,727,1876,27,111,992,11,94,388,499,940,52
60525,12716,8630,1060,4422,2403,745,3314,3765,544,1007,4086,615,1208,1408,855,3609,477
60526,5432,3539,523,1764,791,461,1363,1572,281,323,1893,227,437,432,797,1712,181
60530,216,164,32,74,46,12,68,68,15,13,52,10,23,6,13,45,7
60531,698,540,105,304,108,23,257,216,45,22,158,19,32,55,52,146,12
60532,11455,6342,1255,3665,1226,196,2791,2675,462,414,5113,2248,1649,716,500,4176,937
60534,3965,2560,607,1237,550,166,897,1065,292,306,1405,276,435,336,358,1150,255
60536,25,25,10,7,8,0,14,11,0,0,0,0,0,0,0,0,0
60537,109,99,36,38,23,2,45,34,17,3,10,3,5,0,2,7,3
60538,4913,3779,904,1863,771,241,1720,1494,263,302,1134,178,355,343,258,975,159
60539,0,0,0,0,0,0,0,0,0,0,0,0,0,0,0,0,0
60540,14739,11316,1766,6667,2448,435,5686,4508,576,546,3423,953,1141,608,721,2806,617
60541,883,710,95,413,163,39,334,311,33,32,173,27,33,42,71,162,11
60542,4176,2914,765,1493,523,133,1398,1149,175,192,1262,336,439,267,220,1055,207
60543,6393,5176,1156,2865,977,178,2493,2138,344,201,1217,317,377,375,148,1000,217
60544,14889,12155,3663,5921,2145,426,6356,4768,577,454,2734,652,957,728,397,2195,539
60545,2568,1998,476,1043,394,85,861,738,246,153,570,87,186,194,103,476,94
60546,6638,4271,498,2009,1248,516,1493,2035,321,422,2367,379,823,560,605,2055,312
60548,3983,2965,559,1567,676,163,1137,1263,326,239,1018,156,289,321,252,865,153
60549,206,163,19,78,61,5,44,101,18,0,43,0,26,12,5,36,7
60550,518,384,70,179,108,27,163,158,43,20,134,15,36,35,48,116,18
60551,1231,943,187,498,219,39,479,324,78,62,288,70,118,63,37,212,76
60552,1378,1070,235,554,253,28,476,459,99,36,308,27,64,125,92,269,39
60553,245,206,45,104,52,5,85,101,10,10,39,9,12,11,7,30,9
60554,1564,1324,176,784,306,58,596,568,103,57,240,72,65,85,18,181,59
60555,5082,3613,784,2138,543,148,1742,1319,296,256,1469,318,795,237,119,1223,246
60556,659,495,91,258,107,39,227,205,49,14,164,37,49,36,42,151,13
60557,48,48,27,12,0,9,31,9,8,0,0,0,0,0,0,0,0
60558,4380,3724,297,2006,1108,313,1709,1656,149,210,656,19,144,314,179,616,40
60559,10342,6517,1571,3181,1308,457,2437,2742,622,716,3825,1131,1218,794,682,3147,678
60560,4048,3214,522,1850,683,159,1477,1430,182,125,834,170,231,265,168,682,152
60561,8992,6823,872,3612,1973,366,2549,3413,390,471,2169,302,830,684,353,1931,238
60563,12958,8061,1888,4352,1512,309,3452,3419,716,474,4897,2127,1557,715,498,3917,980
60564,9469,8483,1423,6052,962,46,5639,2337,345,162,986,390,480,94,22,765,221
60565,12786,10946,1331,7759,1677,179,6637,3414,537,358,1840,351,810,498,181,1584,256
60601,3504,1318,183,558,505,72,127,1093,21,77,2186,594,853,531,208,1954,232
60602,23,23,0,23,0,0,0,0,23,0,0,0,0,0,0,0,0
60603,45,45,31,14,0,0,31,14,0,0,0,0,0,0,0,0,0
60604,42,42,42,0,0,0,0,42,0,0,0,0,0,0,0,0,0
60605,6836,2246,759,1032,383,72,555,1473,68,150,4590,1617,1675,857,441,3930,660
60606,889,350,195,130,25,0,45,275,12,18,539,324,166,49,0,432,107
60607,7234,3018,1060,1347,472,139,709,1257,451,601,4216,2271,1061,582,302,2948,1268
60608,24918,18095,6351,8267,2743,734,7168,3803,3971,3153,6823,1715,2183,1880,1045,5637,1186
60609,22803,17141,5861,7804,2852,624,5620,3004,5056,3461,5662,1125,1925,1696,916,4648,1014
60610,28714,8510,3019,3190,2006,295,1217,4343,1923,1027,20204,8733,6981,3310,1180,17893,2311
60611,17639,5584,1319,1760,2032,473,813,4164,163,444,12055,4539,4413,2191,912,11029,1026
60612,12236,7265,2318,2995,1464,488,1351,1529,2317,2068,4971,1249,1530,1411,781,3960,1011
60613,29233,8254,3127,3136,1476,515,2047,4164,717,1326,20979,10699,6565,2432,1283,15753,5226
60614,36431,10767,3849,4742,1853,323,3321,5871,604,971,25664,15562,6528,2644,930,19636,6028
60615,21300,9339,2672,4263,1831,573,1897,2771,2559,2112,11961,4419,3420,2826,1296,10087,1874
60616,19280,10227,2566,4767,2303,591,2769,3291,2177,1990,9053,2475,2624,2580,1374,7919,1134
60617,31572,23761,4763,10455,7023,1520,6575,7073,4589,5524,7811,940,2503,2789,1579,6943,868
60618,34897,22151,6664,10524,4022,941,8458,6634,3273,3786,12746,4303,4690,2374,1379,9350,3396
60619,29845,18947,3587,7509,5625,2226,2810,5104,5068,5965,10898,1604,3659,3696,1939,9775,1123
60620,28516,21226,3621,8251,7642,1712,3277,6440,5240,6269,7290,973,2560,2780,977,6406,884
60621,14973,10408,2784,4180,2506,938,1352,1821,4094,3141,4565,609,1467,1608,881,3999,566
60622,30833,15177,5275,6752,2340,810,4307,4948,3219,2703,15656,8018,4154,2301,1183,10668,4988
60623,27733,22851,7928,10199,3860,864,8742,4237,5575,4297,4882,920,1725,1483,754,3956,926
60624,13652,9904,2529,3967,2688,720,1438,1692,3709,3065,3748,435,1344,1412,557,3205,543
60625,30779,20028,6144,9766,3292,826,8229,6199,2370,3230,10751,3786,3622,2162,1181,8200,2551
60626,24214,11684,4334,5571,1422,357,3850,3087,2511,2236,12530,5010,4591,1984,945,9657,2873
60628,26932,20674,3391,8346,7662,1275,3319,6110,4982,6263,6258,726,2279,2468,785,5435,823
60629,32541,25455,6960,12633,4225,1637,10289,6278,4675,4213,7086,1223,1977,1919,1967,6145,941
60630,21800,13900,2663,6622,3358,1257,4898,5870,1040,2092,7900,1471,2515,1920,1994,6649,1251
60631,11934,7561,962,3394,2194,1011,2638,3562,238,1123,4373,777,1220,1005,1371,3881,492
60632,24446,19273,6065,8816,3145,1247,9269,4908,2368,2728,5173,755,1330,1609,1479,4460,713
60633,5037,3339,660,1529,886,264,1068,1275,454,542,1698,236,495,519,448,1554,144
60634,26197,18937,3293,9021,4546,2077,6585,7729,1490,3133,7260,953,1959,2270,2078,6063,1197
60636,14022,11093,2237,4463,3719,674,1514,2375,3411,3793,2929,394,988,1200,347,2490,439
60637,21655,12477,3652,5491,2465,869,1946,2554,4711,3266,9178,2133,2776,2701,1568,8156,1022
60638,20771,14541,2629,6445,3825,1642,4788,6069,1421,2263,6230,700,1652,2032,1846,5608,622
60639,25440,20543,5726,10338,3502,977,8457,4679,3851,3556,4897,908,1647,1567,775,3910,987
60640,35176,13607,4042,6359,2420,786,3845,5196,2302,2264,21569,7535,8377,3537,2120,17472,4097
60641,25376,17202,3946,8697,3529,1030,6546,5900,1949,2807,8174,1705,3253,2012,1204,6261,1913
60643,17515,13360,1381,6353,4621,1005,3540,4769,1671,3380,4155,589,1419,1532,615,3711,444
60644,17828,13044,3176,5656,3711,501,1780,2689,4706,3869,4784,869,1642,1650,623,4104,680
60645,16041,10334,2236,5043,2109,946,3915,3490,1295,1634,5707,1180,1935,1205,1387,4720,987
60646,11021,7430,936,3290,2248,956,2744,3348,263,1075,3591,413,916,1008,1254,3170,421
60647,33392,20618,7011,9644,3357,606,7832,5249,4143,3394,12774,5831,4179,2039,725,9016,3758
60649,23571,13001,3821,5735,2831,614,1780,2916,5115,3190,10570,2408,4014,3215,933,9372,1198
60651,21212,17510,4188,8837,4073,412,4523,3345,5212,4430,3702,818,1447,1205,232,3077,625
60652,12826,10118,1720,5432,2086,880,3999,3292,1444,1383,2708,257,837,901,713,2486,222
60653,12991,7685,2409,3561,1300,415,897,842,3640,2306,5306,641,1471,1778,1416,4865,441
60654,0,0,0,0,0,0,0,0,0,0,0,0,0,0,0,0,0
60655,10811,7445,1234,3860,1686,665,3141,2732,520,1052,3366,613,975,806,972,2914,452
60656,11891,7119,1521,2808,1819,971,2211,3363,333,1212,4772,1148,1447,1142,1035,4036,736
60657,39990,9978,4248,3753,1486,491,2630,5450,512,1386,30012,18331,7452,2386,1843,22052,7960
60659,12813,9456,2172,4785,1909,590,4188,3168,830,1270,3357,558,1342,902,555,2726,631
60660,22311,9243,2681,4260,1812,490,3021,3560,1171,1491,13068,4915,4621,2226,1306,10475,2593
60661,2670,674,418,201,55,0,98,476,28,72,1996,1156,698,142,0,1759,237
60706,9248,6307,696,2563,2162,886,1846,3265,300,896,2941,272,770,931,968,2667,274
60707,15760,10704,2120,5212,2472,900,3728,4093,1274,1609,5056,848,1510,1481,1217,4289,767
60712,4472,3436,241,1501,1235,459,1209,1805,141,281,1036,24,87,272,653,959,77
60714,12371,8182,862,3526,2688,1106,2494,4185,436,1067,4189,420,944,1215,1610,3827,362
60803,8920,5827,1297,2923,1187,420,2253,2003,829,742,3093,690,999,780,624,2663,430
60804,23124,18233,6341,8507,2495,890,9343,3962,2647,2281,4891,823,1309,1465,1294,4048,843
60805,7509,5353,825,2694,1181,653,2088,1979,564,722,2156,291,573,575,717,1979,177
60827,10772,8186,2417,4104,1327,338,1940,1621,3096,1529,2586,423,1076,712,375,2248,338
60901,13701,9229,2372,4074,2154,629,2884,3478,1814,1053,4472,761,1337,1215,1159,3844,628
60910,199,143,33,79,27,4,43,60,23,17,56,5,17,21,13,43,13
60911,545,415,69,219,101,26,164,199,37,15,130,35,15,36,44,121,9
60912,235,151,36,53,43,19,57,72,12,10,84,8,15,39,22,69,15
60913,525,456,80,257,88,31,187,230,16,23,69,4,31,23,11,59,10
60914,8237,5863,1323,2882,1312,346,2337,2430,694,402,2374,705,705,606,358,1965,409
60915,4050,2759,719,1216,584,240,977,1119,424,239,1291,275,412,313,291,1094,197
60917,199,166,32,62,56,16,61,94,7,4,33,6,6,4,17,31,2
60918,417,299,34,153,88,24,138,141,13,7,118,17,37,23,41,116,2
60919,178,128,13,66,41,8,28,71,26,3,50,4,26,11,9,35,15
60920,50,33,10,15,6,2,11,14,7,1,17,4,2,3,8,15,2
60921,653,424,67,213,104,40,148,188,50,38,229,22,55,73,79,211,18
60922,1004,758,189,349,178,42,311,324,92,31,246,53,74,75,44,203,43
60924,689,494,61,219,137,77,182,260,31,21,195,16,30,58,91,181,14
60926,34,24,5,10,5,4,8,11,0,5,10,3,2,3,2,5,5
60927,813,619,87,337,158,37,231,317,45,26,194,18,52,51,73,174,20
60928,296,208,56,62,59,31,91,99,10,8,88,18,17,18,35,80,8
60929,337,207,30,91,58,28,86,95,14,12,130,25,26,41,38,123,7
60930,322,225,42,107,49,27,86,94,21,24,97,14,18,38,27,89,8
60931,264,191,49,94,29,19,98,67,12,14,73,14,8,27,24,67,6
60932,72,46,0,41,5,0,6,23,6,11,26,0,10,16,0,17,9
60933,133,112,25,55,24,8,40,51,15,6,21,5,6,8,2,18,3
60934,120,87,22,43,18,4,47,25,11,4,33,7,5,9,12,32,1
60935,332,267,47,118,85,17,122,115,12,18,65,27,17,11,10,47,18
60936,1784,1180,228,512,326,114,373,608,147,52,604,75,111,163,255,562,42
60938,867,571,97,256,166,52,187,268,53,63,296,50,60,82,104,266,30
60940,1178,927,161,445,272,49,366,447,52,62,251,29,54,91,77,220,31
60941,688,557,98,256,144,59,221,246,53,37,131,12,31,49,39,127,4
60942,2613,1784,343,838,449,154,610,826,230,118,829,87,179,302,261,757,72
60945,75,53,4,26,20,3,11,35,4,3,22,3,14,5,0,22,0
60946,176,133,31,67,28,7,61,59,11,2,43,19,5,5,14,40,3
60948,584,433,59,174,176,24,131,283,9,10,151,5,49,45,52,131,20
60949,286,169,58,83,26,2,53,71,29,16,117,29,34,31,23,88,29
60950,3331,2395,502,1066,605,222,914,1126,164,191,936,191,242,343,160,795,141
60951,451,368,59,195,88,26,144,183,31,10,83,7,22,25,29,72,11
60952,283,207,45,86,64,12,83,97,21,6,76,12,23,22,19,76,0
60953,1106,781,104,344,236,97,220,456,50,55,325,36,74,116,99,299,26
60954,2450,1741,298,879,450,114,653,712,192,184,709,108,173,268,160,594,115
60955,681,523,82,259,130,52,236,207,49,31,158,21,29,60,48,145,13
60957,2198,1579,305,720,411,143,581,758,154,86,619,95,178,161,185,590,29
60959,390,288,57,113,97,21,95,149,21,23,102,5,16,45,36,100,2
60960,445,280,62,102,81,35,88,140,19,33,165,34,39,31,61,148,17
60961,284,231,38,109,68,16,71,108,34,18,53,12,11,15,15,39,14
60962,267,173,22,74,57,20,56,96,13,8,94,12,29,29,24,85,9
60963,699,458,72,218,122,46,155,227,45,31,241,37,39,94,71,213,28
60964,2561,1888,330,893,537,128,571,866,231,220,673,79,218,268,108,552,121
60966,645,477,91,218,133,35,145,220,64,48,168,20,53,46,49,150,18
60967,27,13,0,13,0,0,9,0,0,4,14,4,3,7,0,10,4
60968,164,127,14,72,28,13,54,67,6,0,37,4,13,12,8,33,4
60969,18,11,0,5,6,0,4,7,0,0,7,5,0,2,0,7,0
60970,3057,2049,404,817,587,241,608,1012,290,139,1008,187,240,302,279,856,152
60973,176,130,18,54,46,12,33,76,15,6,46,7,15,18,6,42,4
60974,141,109,17,45,42,5,32,47,24,6,32,4,7,10,11,30,2
61001,431,318,27,87,169,35,74,226,10,8,113,10,41,32,30,95,18
61006,669,510,110,237,120,43,209,196,64,41,159,29,45,47,38,121,38
61007,200,184,33,53,82,16,66,112,0,6,16,5,11,0,0,9,7
61008,10165,7659,1847,3676,1721,415,3004,3194,970,491,2506,404,747,768,587,2189,317
61010,2493,1967,323,1162,395,87,947,793,165,62,526,114,149,130,133,434,92
61011,721,667,67,444,126,30,271,339,28,29,54,11,10,20,13,48,6
61012,630,500,114,217,146,23,202,239,46,13,130,29,38,47,16,95,35
61013,182,141,38,64,34,5,65,66,7,3,41,11,11,12,7,30,11
61014,494,370,60,153,113,44,100,225,36,9,124,32,13,42,37,121,3
61015,334,277,54,146,59,18,95,148,24,10,57,10,13,14,20,54,3
61016,1386,1084,136,639,269,40,439,512,70,63,302,55,138,72,37,249,53
61018,400,312,64,141,82,25,126,144,23,19,88,21,15,20,32,81,7
61019,1404,1148,132,529,417,70,359,690,50,49,256,21,70,106,59,223,33
61020,511,417,108,170,130,9,164,170,36,47,94,23,20,16,35,56,38
61021,8574,5709,1109,2787,1490,323,1857,2784,739,329,2865,518,796,826,725,2411,454
61024,884,677,88,373,183,33,279,323,46,29,207,37,48,80,42,185,22
61025,1910,1364,223,649,410,82,494,703,111,56,546,89,242,127,88,465,81
61028,799,519,102,184,182,51,159,284,37,39,280,27,80,68,105,262,18
61030,879,645,141,245,197,62,228,323,42,52,234,20,59,66,89,209,25
61031,603,410,68,201,111,30,137,218,36,19,193,17,66,41,69,160,33
61032,13681,8860,1923,3856,2247,834,2718,4230,1267,645,4821,931,1370,1428,1092,4211,610
61036,2671,1751,230,754,636,131,535,963,141,112,920,152,270,263,235,777,143
61037,45,23,6,11,6,0,0,6,10,7,22,4,10,0,8,22,0
61038,490,427,103,213,100,11,178,173,47,29,63,18,17,21,7,56,7
61039,325,244,45,129,55,15,96,120,21,7,81,14,17,24,26,49,32
61041,583,353,31,135,139,48,91,198,28,36,230,29,61,80,60,213,17
61042,249,200,42,95,55,8,104,80,13,3,49,12,5,23,9,47,2
61044,58,55,8,30,12,5,16,35,0,4,3,0,0,3,0,3,0
61046,1223,924,109,450,301,64,321,499,57,47,299,35,70,100,94,258,41
61047,756,589,73,294,169,53,232,265,24,68,167,24,46,72,25,152,15
61048,1710,1254,215,614,338,87,497,615,99,43,456,59,98,111,188,409,47
61049,213,158,26,75,42,15,49,90,17,2,55,8,30,13,4,42,13
61050,188,149,28,71,34,16,42,94,8,5,39,7,10,10,12,30,9
61051,675,497,87,228,143,39,191,255,35,16,178,38,32,52,56,160,18
61052,464,354,47,221,76,10,166,120,49,19,110,35,34,33,8,83,27
61053,1278,886,168,354,269,95,279,475,75,57,392,45,119,144,84,354,38
61054,1598,1058,215,489,267,87,337,485,152,84,540,120,113,111,196,474,66
61057,27,14,0,14,0,0,0,14,0,0,13,8,0,5,0,13,0
61059,58,27,2,16,9,0,9,11,4,3,31,6,5,8,12,27,4
61060,573,420,86,200,124,10,182,199,33,6,153,22,47,38,46,138,15
61061,2944,2072,272,1052,584,164,697,1039,219,117,872,179,246,248,199,747,125
61062,685,559,74,321,143,21,231,275,39,14,126,7,34,31,54,116,10
61063,1528,1142,179,596,285,82,415,545,106,76,386,31,126,142,87,326,60
61064,1580,1114,198,558,283,75,445,478,124,67,466,78,144,108,136,427,39
61065,2274,1894,498,929,414,53,953,724,135,82,380,63,120,115,82,328,52
61067,369,266,52,113,91,10,86,155,19,6,103,12,53,13,25,84,19
61068,5440,3832,829,1849,899,255,1492,1602,509,229,1608,323,526,440,319,1338,270
61070,388,282,64,109,79,30,147,101,23,11,106,7,27,25,47,97,9
61071,5931,4140,951,1697,1239,253,1184,2016,626,314,1791,297,567,442,485,1485,306
61072,3121,2455,397,1413,552,93,1145,1024,150,136,666,79,228,252,107,574,92
61073,5464,4700,697,2850,996,157,2303,1967,271,159,764,183,295,192,94,594,170
61074,2114,1341,273,525,426,117,402,616,205,118,773,112,203,256,202,668,105
61075,391,255,30,141,66,18,116,94,30,15,136,33,32,30,41,123,13
61077,22,16,0,7,9,0,7,0,0,9,6,0,0,0,6,6,0
61078,530,358,44,166,113,35,141,181,16,20,172,29,54,53,36,152,20
61080,3565,2450,645,1119,543,143,872,1168,338,72,1115,307,315,305,188,946,169
61081,8952,6321,1286,2914,1624,497,2172,2902,739,508,2631,587,720,558,766,2309,322
61084,997,812,147,407,202,56,327,424,40,21,185,39,68,38,40,162,23
61085,1532,1086,166,454,365,101,320,605,90,71,446,85,114,132,115,376,70
61087,712,488,94,211,134,49,180,233,43,32,224,24,57,65,78,197,27
61088,1733,1422,213,758,364,87,578,650,132,62,311,83,88,56,84,276,35
61089,320,232,43,128,44,17,128,89,9,6,88,17,26,21,24,81,7
61091,4,4,4,0,0,0,0,0,4,0,0,0,0,0,0,0,0
61101,8245,5785,1452,2584,1379,370,1465,1881,1630,809,2460,375,923,652,510,2053,407
61102,6903,5109,1243,2360,1163,343,1629,1755,1080,645,1794,245,700,574,275,1465,329
61103,10157,5831,1494,2733,1197,407,1696,2239,1315,581,4326,1040,1401,1056,829,3647,679
61104,8424,4600,1765,1976,661,198,1516,1232,1268,584,3824,1040,1201,911,672,3211,613
61107,12329,8100,1523,3516,2292,769,2790,4061,732,517,4229,980,1325,1008,916,3515,714
61108,11469,7718,1643,3206,2024,845,2430,3806,870,612,3751,753,1096,1027,875,3279,472
61109,10509,7072,1794,3155,1767,356,2255,3223,953,641,3437,1286,1113,704,334,2771,666
61111,8397,5525,1311,2680,1261,273,2058,2345,754,368,2872,725,933,658,556,2293,579
61112,3,3,3,0,0,0,0,0,3,0,0,0,0,0,0,0,0
61114,5961,4383,517,2281,1221,364,1684,2307,256,136,1578,185,422,452,519,1449,129
61115,7583,5704,1236,2864,1395,209,2225,2455,596,428,1879,376,646,617,240,1508,371
61201,15989,9380,2106,4036,2355,883,2604,4115,1565,1096,6609,1352,1987,1756,1514,5637,972
61230,441,344,99,145,72,28,115,138,65,26,97,9,37,23,28,86,11
61231,2433,1771,274,831,509,157,610,838,178,145,662,64,162,172,264,613,49
61232,142,96,21,44,27,4,21,52,12,11,46,9,20,13,4,33,13
61233,183,152,26,83,34,9,65,76,6,5,31,4,9,10,8,22,9
61234,480,350,73,150,91,36,132,159,38,21,130,27,29,25,49,115,15
61235,603,393,61,179,137,16,134,200,34,25,210,25,61,60,64,174,36
61236,26,18,2,9,7,0,4,14,0,0,8,2,2,2,2,6,2
61238,1333,1002,167,515,239,81,346,504,93,59,331,72,64,92,103,276,55
61239,117,84,33,25,22,4,25,37,16,6,33,6,19,6,2,23,10
61240,2185,1755,254,910,535,56,601,920,123,111,430,68,170,105,87,358,72
61241,2613,2034,406,1009,550,69,705,1023,226,80,579,158,151,149,121,497,82
61242,456,337,40,190,92,15,106,184,26,21,119,5,24,70,20,113,6
61243,84,52,9,30,11,2,24,16,8,4,32,10,6,10,6,23,9
61244,9313,5921,1380,2581,1495,465,1767,2518,1011,625,3392,711,960,881,840,2965,427
61250,1113,881,118,443,269,51,326,411,70,74,232,46,61,73,52,215,17
61251,108,88,15,51,17,5,53,35,0,0,20,0,3,10,7,17,3
61252,2344,1714,254,774,533,153,580,849,167,118,630,151,193,136,150,561,69
61254,4370,3231,506,1556,893,276,1177,1671,243,140,1139,122,266,316,435,1049,90
61256,575,438,60,207,150,21,145,228,32,33,137,10,59,39,29,100,37
61257,494,362,55,188,95,24,150,152,40,20,132,30,29,49,24,105,27
61259,471,398,64,162,150,22,143,197,23,35,73,6,39,19,9,66,7
61260,315,232,49,83,74,26,72,136,20,4,83,18,26,18,21,67,16
61261,371,275,36,141,75,23,79,150,21,25,96,10,33,35,18,72,24
61262,307,257,15,155,60,27,100,140,6,11,50,7,8,28,7,40,10
61263,110,71,25,32,11,3,36,16,16,3,39,6,9,14,10,30,9
61264,4715,3336,695,1517,938,186,1013,1607,420,296,1379,227,467,361,324,1150,229
61265,19510,12486,2604,5755,3115,1012,3971,5759,1708,1048,7024,1551,2185,1840,1448,6100,924
61270,3001,2176,352,1073,588,163,732,1134,230,80,825,111,179,275,260,724,101
61272,578,397,66,166,136,29,143,211,18,25,181,11,76,54,40,161,20
61273,1237,946,160,449,278,59,367,470,68,41,291,48,73,92,78,255,36
61274,158,141,22,78,35,6,62,62,11,6,17,0,5,12,0,17,0
61275,1776,1377,172,738,388,79,506,697,95,79,399,68,117,115,99,351,48
61276,34,24,9,8,7,0,0,24,0,0,10,0,5,5,0,10,0
61277,1338,974,142,435,321,76,322,527,68,57,364,41,89,124,110,345,19
61279,391,292,41,120,108,23,84,154,37,17,99,14,33,25,27,71,28
61281,946,762,113,429,202,18,319,366,50,27,184,32,72,45,35,163,21
61282,3689,2431,642,980,629,180,772,1147,363,149,1258,169,427,361,301,1096,162
61283,565,429,85,201,108,35,155,218,42,14,136,28,40,19,49,118,18
61284,1251,1040,123,537,304,76,385,525,61,69,211,32,66,62,51,185,26
61285,638,463,82,213,135,33,172,234,34,23,175,24,55,54,42,154,21
61301,4442,2728,597,1199,626,306,803,1221,430,274,1714,366,430,439,479,1517,197
61310,1541,1122,217,539,298,68,431,486,147,58,419,51,121,138,109,373,46
61311,120,102,17,42,24,19,47,43,7,5,18,0,0,6,12,18,0
61312,291,209,36,105,48,20,79,98,20,12,82,16,28,13,25,78,4
61313,118,107,11,53,39,4,40,53,10,4,11,0,11,0,0,4,7
61314,405,310,65,131,93,21,109,145,29,27,95,14,22,22,37,86,9
61315,100,73,10,45,16,2,20,34,9,10,27,2,10,4,11,24,3
61316,116,71,17,25,24,5,18,32,12,9,45,12,6,12,15,36,9
61317,135,98,17,50,23,8,32,50,6,10,37,6,11,6,14,34,3
61318,296,200,33,79,75,13,57,120,21,2,96,10,25,44,17,84,12
61319,467,345,59,166,93,27,122,189,20,14,122,17,46,35,24,108,14
61320,279,210,37,92,60,21,65,120,18,7,69,15,17,19,18,60,9
61321,132,102,29,37,26,10,37,57,8,0,30,6,17,5,2,19,11
61322,589,428,97,183,108,40,164,152,54,58,161,23,20,53,65,144,17
61323,34,27,8,12,2,5,14,9,4,0,7,0,0,5,2,7,0
61324,55,49,0,7,20,22,0,49,0,0,6,0,6,0,0,6,0
61325,359,276,58,114,75,29,125,130,14,7,83,9,14,28,32,74,9
61326,967,698,133,326,189,50,255,344,69,30,269,31,70,72,96,247,22
61327,441,313,31,166,86,30,117,150,18,28,128,11,36,43,38,119,9
61328,26,26,0,19,7,0,19,7,0,0,0,0,0,0,0,0,0
61329,563,381,78,160,96,47,130,205,25,21,182,39,47,36,60,167,15
61330,577,432,83,203,113,33,173,198,26,35,145,33,36,39,37,130,15
61331,21,21,0,5,7,9,0,21,0,0,0,0,0,0,0,0,0
61332,17,11,2,2,7,0,2,9,0,0,6,0,0,4,2,6,0
61333,166,131,23,57,41,10,52,61,14,4,35,2,11,18,4,31,4
61334,287,210,38,94,59,19,86,102,9,13,77,14,17,18,28,65,12
61335,229,174,29,82,59,4,53,89,18,14,55,10,8,30,7,55,0
61336,246,196,31,97,58,10,71,82,17,26,50,10,7,26,7,38,12
61337,163,114,15,71,24,4,56,35,16,7,49,6,17,16,10,33,16
61338,141,87,12,47,25,3,36,38,8,5,54,9,9,16,20,53,1
61340,130,90,14,47,17,12,27,46,7,10,40,7,16,7,10,31,9
61341,2932,2157,376,1101,546,134,754,1080,178,145,775,115,215,253,192,664,111
61342,3459,2464,545,1092,639,188,909,1177,244,134,995,173,197,313,312,876,119
61344,178,124,14,55,47,8,31,70,12,11,54,23,3,13,15,50,4
61345,352,260,39,130,72,19,76,159,11,14,92,13,23,29,27,77,15
61346,37,32,8,12,9,3,10,17,2,3,5,1,2,2,0,5,0
61348,1880,1213,232,578,264,139,414,571,149,79,667,128,151,184,204,590,77
61349,419,311,61,124,110,16,106,160,24,21,108,27,14,27,40,92,16
61350,9691,6577,1139,3220,1649,569,2290,2908,833,546,3114,547,856,933,778,2773,341
61353,514,358,62,169,110,17,127,174,43,14,156,20,40,54,42,141,15
61354,4410,2883,455,1237,824,367,980,1501,213,189,1527,312,356,431,428,1359,168
61356,4674,3116,510,1460,864,282,1065,1592,292,167,1558,251,402,433,472,1424,134
61358,224,147,27,66,43,11,55,74,11,7,77,18,16,23,20,67,10
61359,131,80,14,39,23,4,22,44,10,4,51,1,6,6,38,48,3
61360,1078,823,118,450,188,67,382,329,72,40,255,31,93,88,43,236,19
61361,587,439,69,176,144,50,134,246,31,28,148,16,49,38,45,137,11
61362,2327,1587,284,766,397,140,521,755,156,155,740,100,172,183,285,661,79
61363,122,72,8,31,25,8,30,24,8,10,50,11,8,12,19,45,5
61364,8301,5524,960,2353,1685,526,1729,2523,679,593,2777,399,783,753,842,2481,296
61367,376,245,32,94,104,15,78,152,5,10,131,12,32,45,42,113,18
61368,570,444,71,193,136,44,156,219,32,37,126,21,38,33,34,113,13
61369,700,435,77,191,125,42,150,223,38,24,265,40,60,67,98,233,32
61370,567,380,54,181,98,47,136,190,30,24,187,22,49,49,67,163,24
61372,35,31,13,14,4,0,19,5,5,2,4,0,2,2,0,4,0
61373,757,547,66,306,142,33,232,264,34,17,210,38,66,57,49,177,33
61374,49,41,7,14,17,3,9,30,0,2,8,0,5,2,1,8,0
61375,484,393,63,135,172,23,124,233,25,11,91,8,43,23,17,85,6
61376,862,615,105,274,169,67,236,319,50,10,247,18,50,71,108,232,15
61377,552,366,42,175,94,55,121,187,38,20,186,21,58,55,52,174,12
61378,208,155,30,81,23,21,56,82,10,7,53,9,17,21,6,51,2
61379,550,391,89,177,100,25,137,190,54,10,159,33,47,37,42,137,22
61401,14374,8780,1804,3718,2463,795,2524,4192,1357,707,5594,866,1586,1538,1604,4804,790
61410,1649,1127,247,526,288,66,380,512,129,106,522,60,113,183,166,444,78
61411,177,130,12,58,50,10,41,67,7,15,47,4,3,22,18,43,4
61412,577,415,64,193,115,43,121,243,30,21,162,15,33,43,71,152,10
61413,456,338,61,141,97,39,115,165,31,27,118,15,34,34,35,99,19
61414,398,316,53,146,86,31,134,158,11,13,82,12,19,36,15,68,14
61415,776,587,106,250,181,50,183,316,42,46,189,16,57,69,47,169,20
61416,53,31,11,14,2,4,14,9,8,0,22,2,12,8,0,18,4
61417,141,114,13,62,29,10,20,81,13,0,27,0,19,1,7,21,6
61418,270,200,40,74,67,19,54,111,20,15,70,7,13,22,28,67,3
61419,23,18,2,5,11,0,4,13,1,0,5,0,0,3,2,5,0
61420,490,350,61,176,77,36,143,153,25,29,140,28,21,35,56,125,15
61421,603,427,82,162,127,56,158,214,19,36,176,22,40,47,67,160,16
61422,1501,1011,212,463,262,74,355,484,104,68,490,73,98,150,169,406,84
61423,291,255,40,103,102,10,95,140,16,4,36,8,12,7,9,33,3
61424,59,43,19,9,9,6,18,18,4,3,16,1,3,4,8,13,3
61425,305,226,14,131,70,11,72,119,18,17,79,11,24,29,15,68,11
61426,40,21,7,12,2,0,4,4,13,0,19,3,2,0,14,17,2
61427,942,693,101,317,189,86,209,366,53,65,249,44,66,74,65,226,23
61428,407,312,36,96,162,18,76,223,7,6,95,14,40,20,21,80,15
61430,302,231,43,114,60,14,66,130,23,12,71,12,27,22,10,58,13
61431,146,114,24,37,35,18,27,72,4,11,32,6,4,14,8,28,4
61432,278,187,35,74,44,34,56,96,19,16,91,14,28,26,23,75,16
61434,1467,963,146,472,276,69,353,478,71,61,504,87,111,142,164,443,61
61435,23,14,4,6,0,4,10,4,0,0,9,0,5,4,0,9,0
61436,392,335,45,178,95,17,113,194,17,11,57,0,18,18,21,57,0
61437,380,277,38,134,81,24,89,143,20,25,103,16,50,26,11,79,24
61438,297,232,27,110,68,27,91,120,16,5,65,19,15,16,15,60,5
61439,117,95,6,37,39,13,26,60,2,7,22,8,2,5,7,19,3
61440,333,250,25,113,75,37,83,140,10,17,83,19,33,4,27,74,9
61441,449,314,64,103,116,31,85,199,13,17,135,21,25,35,54,125,10
61442,381,235,48,109,72,6,79,110,29,17,146,32,32,53,29,122,24
61443,5913,3830,878,1562,961,429,1136,1808,552,334,2083,245,493,609,736,1846,237
61447,456,346,62,132,121,31,93,202,42,9,110,10,32,37,31,100,10
61448,1621,1227,220,548,337,122,442,645,87,53,394,73,90,119,112,366,28
61449,205,173,31,56,73,13,41,96,15,21,32,4,12,8,8,24,8
61450,714,495,83,212,165,35,204,224,37,30,219,26,60,54,79,200,19
61451,140,107,23,53,25,6,38,46,14,9,33,0,8,16,9,33,0
61452,130,100,24,46,27,3,33,48,10,9,30,10,5,11,4,28,2
61453,270,205,46,96,51,12,70,96,28,11,65,5,13,24,23,60,5
61454,321,230,55,110,45,20,71,117,23,19,91,8,18,42,23,79,12
61455,7901,3930,852,1596,1131,351,1244,1970,446,270,3971,1939,781,639,612,2814,1157
61458,373,276,60,102,89,25,85,162,22,7,97,21,24,19,33,86,11
61459,152,123,26,54,27,16,31,71,14,7,29,12,8,9,0,17,12
61460,135,109,10,47,42,10,41,62,4,2,26,3,11,3,9,19,7
61462,4625,3072,623,1434,776,239,1022,1341,410,299,1553,266,418,397,472,1363,190
61465,455,323,55,142,94,32,106,166,22,29,132,16,17,42,57,117,15
61466,134,101,22,34,40,5,44,49,0,8,33,4,12,2,15,30,3
61467,468,364,59,149,109,47,104,183,35,42,104,16,33,12,43,89,15
61468,38,31,13,10,8,0,14,8,9,0,7,2,1,2,2,2,5
61469,1038,707,132,302,222,51,216,379,80,32,331,33,79,142,77,286,45
61470,192,163,32,68,32,31,49,77,22,15,29,3,9,5,12,25,4
61471,59,48,7,18,20,3,21,25,2,0,11,2,2,2,5,11,0
61472,296,228,34,141,25,28,90,99,30,9,68,3,24,17,24,68,0
61473,702,496,99,193,152,52,173,235,52,36,206,27,40,65,74,184,22
61474,154,119,13,62,39,5,45,57,3,14,35,7,4,14,10,26,9
61475,74,62,15,34,13,0,37,18,4,3,12,0,2,6,4,10,2
61476,155,142,31,46,32,33,40,87,7,8,13,1,3,5,4,10,3
61477,323,247,35,123,62,27,86,133,4,24,76,10,9,34,23,73,3
61478,128,93,13,46,30,4,26,60,7,0,35,0,4,23,8,35,0
61479,66,47,6,23,18,0,17,30,0,0,19,0,0,14,5,19,0
61480,543,372,56,191,94,31,147,170,34,21,171,27,35,64,45,152,19
61482,230,175,33,81,49,12,59,96,14,6,55,7,8,20,20,48,7
61483,799,551,91,242,163,55,220,260,46,25,248,51,40,68,89,222,26
61484,385,281,46,127,81,27,97,148,26,10,104,18,38,25,23,92,12
61485,264,191,33,91,51,16,85,88,8,10,73,12,22,11,28,64,9
61486,584,446,66,180,162,38,143,237,35,31,138,22,40,50,26,119,19
61488,484,383,52,221,86,24,112,191,56,24,101,16,36,39,10,86,15
61489,408,280,63,100,99,18,90,148,21,21,128,22,39,23,44,109,19
61490,428,289,40,131,87,31,88,159,26,16,139,21,30,33,55,127,12
61491,882,597,111,244,186,56,187,327,36,47,285,38,87,75,85,262,23
61501,800,554,113,256,140,45,202,273,56,23,246,36,47,87,76,230,16
61516,273,200,33,96,52,19,76,112,8,4,73,11,20,18,24,62,11
61517,1144,943,106,520,242,75,331,499,69,44,201,51,47,75,28,147,54
61519,88,66,15,26,23,2,16,33,9,8,22,2,7,6,7,16,6
61520,7043,4727,941,2016,1344,426,1435,2373,588,331,2316,321,645,641,709,2058,258
61523,4304,3070,537,1521,812,200,1064,1537,266,203,1234,238,369,359,268,1068,166
61524,57,45,4,24,15,2,16,21,6,2,12,2,2,5,3,10,2
61525,1859,1581,232,871,412,66,724,730,78,49,278,78,97,58,45,244,34
61526,400,361,40,191,95,35,130,217,6,8,39,6,4,5,24,29,10
61528,583,489,48,214,194,33,189,230,26,44,94,0,26,34,34,81,13
61529,1020,764,137,359,204,64,294,376,55,39,256,40,63,66,87,244,12
61530,2121,1498,288,694,345,171,607,717,107,67,623,96,140,156,231,582,41
61531,1306,922,165,409,259,89,337,430,53,102,384,70,81,86,147,346,38
61532,284,227,44,106,63,14,67,136,16,8,57,4,12,13,28,32,25
61533,796,651,102,352,153,44,244,335,31,41,145,24,51,36,34,126,19
61534,714,576,99,321,133,23,255,257,35,29,138,17,40,45,36,119,19
61535,508,414,84,204,112,14,217,197,0,0,94,9,34,33,18,69,25
61536,1011,804,159,379,212,54,305,399,56,44,207,37,49,57,64,177,30
61537,1223,816,121,392,223,80,293,414,76,33,407,59,97,113,138,369,38
61539,80,58,11,30,11,6,21,22,7,8,22,2,8,2,10,22,0
61540,1183,871,142,365,278,86,265,465,80,61,312,38,84,77,113,290,22
61541,61,53,19,19,13,2,12,29,3,9,8,0,2,6,0,8,0
61542,1690,1147,203,451,326,167,358,647,75,67,543,63,115,209,156,513,30
61543,18,13,6,5,2,0,5,4,4,0,5,0,0,4,1,5,0
61544,261,200,22,83,73,22,70,117,13,0,61,5,14,38,4,49,12
61545,256,197,38,98,44,17,81,94,9,13,59,0,24,24,11,54,5
61546,1694,1305,192,660,369,84,478,696,75,56,389,69,146,90,84,325,64
61547,1256,1051,165,612,250,24,444,552,37,18,205,38,59,73,35,182,23
61548,3647,2991,489,1559,784,159,1281,1455,172,83,656,67,169,223,197,597,59
61550,6681,4777,778,2237,1385,377,1751,2435,356,235,1904,396,566,498,444,1710,194
61552,60,44,14,24,6,0,26,18,0,0,16,0,0,16,0,16,0
61554,17020,11672,2618,5292,2891,871,3977,5434,1443,818,5348,1041,1517,1668,1122,4564,784
61559,1165,876,142,408,264,62,325,408,86,57,289,44,62,97,86,251,38
61560,315,242,32,104,86,20,50,173,6,13,73,15,6,23,29,62,11
61561,1045,804,142,378,214,70,340,387,37,40,241,29,58,61,93,218,23
61563,225,155,36,63,33,23,40,92,18,5,70,14,12,16,28,53,17
61564,358,277,83,134,52,8,120,97,32,28,81,18,22,33,8,68,13
61565,641,538,90,282,146,20,219,270,29,20,103,22,32,25,24,85,18
61567,324,231,30,142,50,9,79,116,36,0,93,24,35,18,16,76,17
61568,1460,1189,237,541,337,74,485,595,69,40,271,57,73,87,54,253,18
61569,483,392,36,155,148,53,107,270,15,0,91,19,27,13,32,91,0
61570,652,486,85,245,102,54,192,237,29,28,166,30,42,29,65,142,24
61571,7976,5947,1161,2880,1594,312,2233,2843,504,367,2029,430,558,491,550,1816,213
61572,448,326,60,151,90,25,108,180,21,17,122,13,14,60,35,117,5
61602,352,52,11,19,12,10,5,28,7,12,300,97,90,91,22,284,16
61603,7327,4447,1354,2090,780,223,1233,1471,1184,559,2880,674,1103,596,507,2364,516
61604,13663,8508,2274,3496,2065,673,2263,3629,1790,826,5155,1082,1637,1329,1107,4348,807
61605,6916,4504,1574,1721,888,321,722,1092,1920,770,2412,322,699,818,573,2148,264
61606,2887,1266,332,598,281,55,359,531,261,115,1621,936,455,172,58,980,641
61607,4210,3081,446,1456,968,211,1007,1604,272,198,1129,190,365,354,220,968,161
61610,2010,1383,342,637,360,44,433,606,176,168,627,114,234,205,74,522,105
61611,9872,6831,1207,3075,2000,549,2062,3560,689,520,3041,632,935,711,763,2617,424
61614,15438,9178,1736,3861,2667,914,2924,4757,875,622,6260,1697,1761,1394,1408,5486,774
61615,7734,5119,927,2697,1284,211,1929,2376,492,322,2615,884,733,596,402,2241,374
61701,16237,8472,2508,3785,1582,597,2517,3582,1567,806,7765,2630,2465,1588,1082,6384,1381
61704,13270,9610,2145,5649,1592,224,4557,3858,777,418,3660,1452,1119,813,276,2824,836
61720,139,107,15,64,18,10,38,57,12,0,32,0,21,3,8,29,3
61721,226,188,42,81,55,10,75,84,9,20,38,10,12,5,11,33,5
61722,204,169,45,84,37,3,79,71,6,13,35,4,10,13,8,30,5
61723,886,629,96,330,143,60,194,354,59,22,257,53,41,92,71,234,23
61724,244,179,26,92,36,25,56,99,13,11,65,4,20,26,15,65,0
61725,476,402,46,220,102,34,127,220,30,25,74,20,20,20,14,57,17
61726,1061,775,166,315,222,72,274,417,41,43,286,47,70,65,104,238,48
61727,4170,2832,556,1309,779,188,970,1376,326,160,1338,242,384,341,371,1189,149
61728,542,390,46,201,99,44,165,182,21,22,152,24,49,43,36,135,17
61729,397,333,74,163,80,16,130,168,20,15,64,21,26,9,8,51,13
61730,167,116,23,59,33,1,20,85,5,6,51,2,18,11,20,49,2
61731,83,64,12,32,20,0,30,22,12,0,19,0,10,0,9,19,0
61732,738,582,120,313,124,25,288,229,50,15,156,23,66,37,30,126,30
61733,366,297,59,120,94,24,118,142,19,18,69,16,34,11,8,55,14
61734,1109,844,127,415,250,52,322,431,53,38,265,41,52,81,91,239,26
61735,157,132,17,60,43,12,47,69,5,11,25,5,8,8,4,24,1
61736,475,414,92,213,96,13,183,176,28,27,61,17,20,22,2,42,19
61737,195,157,36,87,25,9,65,75,17,0,38,12,15,3,8,35,3
61738,1648,1236,229,641,319,47,493,577,82,84,412,70,110,101,131,349,63
61739,1816,1303,272,632,277,122,532,650,105,16,513,103,106,130,174,457,56
61740,651,458,69,229,109,51,188,231,29,10,193,20,57,56,60,180,13
61741,695,519,92,255,131,41,238,210,43,28,176,43,41,41,51,148,28
61742,302,258,47,140,54,17,126,121,6,5,44,7,12,12,13,34,10
61743,94,71,16,42,11,2,32,26,11,2,23,4,8,11,0,17,6
61744,738,554,105,274,125,50,219,247,47,41,184,28,48,37,71,170,14
61745,1579,1225,254,657,260,54,527,569,98,31,354,83,97,102,72,279,75
61747,548,426,90,197,109,30,168,212,34,12,122,38,18,21,45,106,16
61748,923,750,122,391,221,16,325,342,29,54,173,39,42,41,51,147,26
61749,289,215,36,76,62,41,65,109,10,31,74,7,31,18,18,62,12
61750,54,24,0,17,7,0,7,17,0,0,30,0,0,30,0,24,6
61752,1617,1194,285,532,303,74,467,560,95,72,423,81,118,134,90,387,36
61753,1141,821,144,417,214,46,342,345,59,75,320,67,80,78,95,288,32
61754,477,395,73,219,86,17,170,179,28,18,82,16,19,13,34,80,2
61755,1475,1156,256,597,252,51,493,526,91,46,319,51,95,109,64,278,41
61756,839,596,101,291,141,63,192,283,78,43,243,54,52,81,56,217,26
61758,28,22,0,10,6,6,0,22,0,0,6,0,0,0,6,6,0
61759,629,463,83,207,134,39,160,219,36,48,166,21,58,30,57,150,16
61760,1032,730,148,323,155,104,274,323,72,61,302,39,67,93,103,269,33
61761,15197,8318,2210,3940,1736,432,3082,3493,1173,570,6879,4223,1097,807,752,3985,2894
61764,5223,3487,711,1720,816,240,1219,1528,516,224,1736,309,543,554,330,1524,212
61769,214,176,26,89,55,6,73,67,25,11,38,8,10,10,10,35,3
61770,458,329,71,143,82,33,113,167,36,13,129,28,49,33,19,114,15
61771,200,152,20,78,43,11,69,63,7,13,48,4,19,10,15,37,11
61772,164,103,19,47,37,0,26,62,15,0,61,11,12,21,17,43,18
61773,218,172,33,79,46,14,45,100,14,13,46,7,11,9,19,42,4
61774,386,303,72,141,70,20,107,117,41,38,83,12,28,35,8,82,1
61775,105,85,14,33,31,7,27,42,14,2,20,2,11,4,3,20,0
61776,503,431,65,302,53,11,211,184,14,22,72,13,28,23,8,67,5
61777,375,284,78,121,74,11,114,138,18,14,91,16,31,22,22,73,18
61778,271,187,39,88,44,16,76,81,16,14,84,7,28,23,26,74,10
61801,11178,4645,1544,1895,899,307,1376,2103,657,509,6533,4212,1152,627,542,4038,2495
61802,7180,4293,1298,1732,962,301,1269,1789,882,353,2887,946,1041,532,368,2416,471
61810,134,106,17,69,15,5,42,44,8,12,28,4,8,4,12,22,6
61811,290,249,42,130,73,4,102,94,31,22,41,16,13,4,8,36,5
61812,164,115,15,57,29,14,37,63,11,4,49,1,13,13,22,44,5
61813,815,586,115,253,166,52,199,283,49,55,229,44,80,50,55,192,37
61814,495,399,64,216,97,22,149,202,37,11,96,21,17,34,24,87,9
61815,65,44,8,23,8,5,13,18,8,5,21,3,9,8,1,13,8
61816,195,151,33,63,51,4,40,78,15,18,44,3,2,12,27,41,3
61817,1081,819,157,380,231,51,293,408,77,41,262,38,60,93,71,228,34
61818,679,522,102,241,133,46,180,226,77,39,157,24,46,50,37,131,26
61820,12636,3686,1173,1610,621,282,1148,1296,714,528,8950,6597,1349,600,404,5455,3495
61821,12281,7625,1742,3640,1729,514,2668,3456,939,562,4656,1850,1252,890,664,3690,966
61822,5998,4300,778,2340,999,183,1783,2028,306,183,1698,634,572,286,206,1386,312
61830,212,169,36,84,43,6,67,93,4,5,43,0,7,18,18,43,0
61831,57,38,5,24,6,3,16,20,0,2,19,0,9,6,4,15,4
61832,16242,10247,2380,4137,2812,918,2661,4518,2018,1050,5995,1089,1753,1771,1382,5299,696
61833,934,579,137,233,166,43,169,265,74,71,355,42,113,139,61,318,37
61834,2388,1781,262,890,527,102,638,945,79,119,607,70,196,216,125,546,61
61839,223,180,22,102,41,15,59,93,16,12,43,5,11,12,15,43,0
61840,274,217,14,113,81,9,87,105,10,15,57,4,21,19,13,33,24
61841,524,408,71,212,106,19,151,201,35,21,116,16,30,33,37,108,8
61842,1141,803,114,407,207,75,310,357,83,53,338,50,98,93,97,293,45
61843,797,604,120,287,150,47,256,286,44,18,193,58,52,28,55,166,27
61844,422,293,75,140,62,16,84,175,26,8,129,38,23,44,24,89,40
61845,140,116,15,62,35,4,36,68,2,10,24,6,8,8,2,24,0
61846,2097,1481,376,618,390,97,530,627,219,105,616,42,176,190,208,563,53
61847,442,331,70,161,86,14,131,162,27,11,111,13,33,27,38,93,18
61848,99,65,23,22,20,0,12,37,11,5,34,9,4,5,16,23,11
61849,709,509,110,230,135,34,183,253,55,18,200,15,49,84,52,185,15
61850,179,143,26,65,39,13,27,80,24,12,36,3,6,25,2,23,13
61851,191,137,28,55,44,10,55,60,8,14,54,5,28,12,9,46,8
61852,96,71,8,51,8,4,23,22,18,8,25,8,6,5,6,21,4
61853,3760,3034,625,1767,562,80,1398,1176,322,138,726,168,215,216,127,600,126
61854,617,473,104,206,137,26,164,256,32,21,144,23,55,40,26,132,12
61855,25,20,3,8,6,3,7,10,0,3,5,5,0,0,0,5,0
61856,2734,1915,283,930,562,140,696,951,161,107,819,138,208,220,253,713,106
61857,69,49,9,27,11,2,17,25,5,2,20,9,7,0,4,15,5
61858,1145,878,181,413,229,55,302,392,116,68,267,32,86,72,77,242,25
61859,459,355,76,198,68,13,187,115,38,15,104,11,31,37,25,87,17
61862,180,154,21,88,36,9,68,71,10,5,26,5,6,10,5,21,5
61863,344,256,24,124,91,17,93,148,9,6,88,16,19,29,24,80,8
61864,547,466,71,265,106,24,211,209,19,27,81,16,19,13,33,71,10
61865,487,383,81,189,87,26,154,173,41,15,104,7,42,27,28,96,8
61866,5842,3765,1214,1648,671,232,1204,1475,851,235,2077,568,626,509,374,1732,345
61870,537,384,70,152,123,39,85,232,40,27,153,20,41,62,30,139,14
61871,85,62,17,24,16,5,25,32,4,1,23,3,8,2,10,21,2
61872,298,231,43,134,48,6,67,132,10,22,67,16,21,16,14,48,19
61873,1924,1503,301,791,325,86,609,696,135,63,421,64,136,109,112,380,41
61874,1931,1045,342,433,193,77,453,501,60,31,886,414,192,114,166,752,134
61875,242,192,36,111,37,8,75,100,9,8,50,10,21,10,9,28,22
61876,340,261,42,117,82,20,102,127,20,12,79,10,31,21,17,68,11
61877,603,441,72,215,120,34,194,197,28,22,162,21,49,41,51,132,30
61878,636,445,102,200,118,25,158,219,52,16,191,38,53,42,58,160,31
61880,1346,935,218,444,222,51,382,402,84,67,411,81,173,87,70,358,53
61882,276,194,51,71,51,21,71,98,14,11,82,17,11,32,22,69,13
61883,1984,1271,264,553,353,101,385,583,192,111,713,114,152,236,211,630,83
61884,409,331,23,195,93,20,156,156,15,4,78,18,24,15,21,60,18
61910,1498,1185,269,532,295,89,543,502,70,70,313,65,69,90,89,267,46
61911,1426,1062,237,425,324,76,443,510,62,47,364,62,69,110,123,348,16
61912,611,414,91,200,105,18,154,202,21,37,197,46,66,46,39,153,44
61913,729,524,96,247,127,54,182,235,70,37,205,12,73,73,47,182,23
61914,774,564,103,262,159,40,177,320,44,23,210,25,50,57,78,182,28
61917,266,195,37,92,52,14,69,93,30,3,71,6,20,30,15,65,6
61919,324,236,39,119,58,20,80,132,13,11,88,14,29,29,16,71,17
61920,8922,4340,1011,2043,982,304,1482,1981,514,363,4582,2735,698,620,529,2915,1667
61924,987,700,126,337,173,64,274,341,58,27,287,43,64,98,82,259,28
61925,374,289,55,143,74,17,123,129,14,23,85,12,58,6,9,80,5
61928,310,239,34,97,82,26,85,112,27,15,71,22,17,12,20,62,9
61929,315,203,41,89,53,20,79,98,16,10,112,26,48,16,22,101,11
61930,208,156,24,72,43,17,45,84,23,4,52,0,8,22,22,45,7
61931,456,350,80,133,115,22,129,171,24,26,106,16,23,33,34,101,5
61932,234,156,23,58,47,28,44,74,15,23,78,5,22,15,36,70,8
61933,528,383,67,173,110,33,129,185,48,21,145,21,26,48,50,136,9
61936,123,88,0,61,19,8,37,38,8,5,35,10,0,6,19,25,10
61937,1001,768,153,360,207,48,312,370,52,34,233,34,59,66,74,217,16
61938,9612,6021,1360,2620,1572,469,1956,2861,759,445,3591,990,899,840,862,3082,509
61940,103,79,13,39,25,2,27,37,7,8,24,11,4,7,2,19,5
61941,36,36,0,5,24,7,5,17,0,14,0,0,0,0,0,0,0
61942,541,375,59,187,99,30,126,185,42,22,166,28,32,45,61,153,13
61943,740,548,86,275,154,33,192,257,61,38,192,8,57,77,50,185,7
61944,5537,3701,742,1614,964,381,1199,1767,447,288,1836,262,493,552,529,1620,216
61949,55,29,3,16,9,1,9,13,7,0,26,6,9,5,6,24,2
61951,2799,1977,338,950,514,175,693,997,136,151,822,159,196,206,261,725,97
61953,2536,1775,234,912,464,165,596,876,202,101,761,179,184,201,197,673,88
61956,1157,820,159,399,218,44,299,355,114,52,337,53,80,99,105,296,41
61957,762,557,112,256,126,63,209,268,57,23,205,36,62,39,68,178,27
62001,614,434,54,192,174,14,140,246,10,38,180,10,54,59,57,169,11
62002,14073,8853,2053,3848,2268,684,2581,3566,1648,1058,5220,1030,1457,1354,1379,4524,696
62006,188,144,21,61,51,11,52,79,2,11,44,1,8,11,24,42,2
62009,861,560,145,225,112,78,156,252,90,62,301,28,73,75,125,274,27
62010,4055,2914,554,1481,695,184,1121,1186,370,237,1141,317,306,279,239,983,158
62011,150,107,25,51,31,0,54,41,9,3,43,0,12,23,8,39,4
62012,2380,1914,374,961,492,87,790,886,175,63,466,58,133,166,109,380,86
62013,271,202,40,78,56,28,88,88,6,20,69,4,16,30,19,64,5
62014,1560,1180,213,544,356,67,477,561,83,59,380,39,106,140,95,327,53
62015,240,168,27,83,29,29,30,109,21,8,72,16,17,21,18,51,21
62016,1596,1132,257,424,339,112,421,522,102,87,464,50,97,166,151,401,63
62017,544,398,65,176,122,35,136,198,39,25,146,6,39,32,69,138,8
62018,1630,1188,384,432,329,43,394,390,245,159,442,113,135,107,87,361,81
62019,263,207,29,99,63,16,89,84,17,17,56,6,13,22,15,54,2
62021,354,292,28,149,107,8,144,133,8,7,62,0,32,8,22,55,7
62022,352,280,39,102,134,5,87,172,8,13,72,13,13,33,13,60,12
62023,37,25,6,10,9,0,11,14,0,0,12,0,3,4,5,12,0
62024,5255,3538,630,1589,1060,259,1070,1704,495,269,1717,259,436,539,483,1462,255
62025,10741,7435,1384,3930,1765,356,2852,3338,770,475,3306,1102,952,702,550,2531,775
62027,223,176,26,101,44,5,62,84,24,6,47,4,9,22,12,32,15
62028,307,216,31,117,60,8,102,100,14,0,91,15,35,30,11,77,14
62030,49,37,3,19,13,2,11,17,9,0,12,0,2,3,7,12,0
62031,439,340,62,160,113,5,119,169,22,30,99,31,13,30,25,71,28
62032,268,198,39,88,65,6,74,95,22,7,70,13,6,22,29,69,1
62033,2158,1429,292,681,356,100,483,700,148,98,729,96,228,233,172,625,104
62034,4547,3322,538,1827,751,206,1499,1419,210,194,1225,463,347,221,194,918,307
62035,6087,4510,694,2060,1440,316,1582,2321,343,264,1577,200,467,497,413,1338,239
62036,236,171,27,62,63,19,49,104,8,10,65,8,15,22,20,62,3
62037,691,504,53,260,157,34,182,238,40,44,187,11,54,74,48,165,22
62040,18387,12714,2742,5739,3352,881,3977,5366,1972,1399,5673,946,1806,1654,1267,4902,771
62044,840,593,115,269,156,53,204,256,78,55,247,32,44,81,90,227,20
62045,245,166,30,61,60,15,67,75,7,17,79,2,20,36,21,73,6
62046,151,113,16,50,34,13,46,53,5,9,38,10,6,12,10,36,2
62047,617,409,104,168,102,35,154,178,53,24,208,27,39,61,81,184,24
62048,655,440,97,196,112,35,137,210,65,28,215,25,55,72,63,182,33
62049,2834,1945,387,892,445,221,609,944,309,83,889,149,237,276,227,787,102
62050,211,157,37,65,28,27,61,87,5,4,54,16,17,6,15,45,9
62051,371,273,35,142,73,23,72,142,43,16,98,8,32,26,32,84,14
62052,4739,3242,672,1608,734,228,1327,1396,318,201,1497,249,334,433,481,1313,184
62053,334,243,33,118,65,27,89,125,11,18,91,15,21,30,25,77,14
62054,324,252,55,103,77,17,100,104,13,35,72,7,9,30,26,68,4
62056,3493,2396,560,1043,613,180,793,1088,354,161,1097,105,292,416,284,1000,97
62058,322,214,67,71,51,25,73,85,36,20,108,30,22,15,41,89,19
62059,222,125,10,23,83,9,0,11,21,93,97,10,0,49,38,91,6
62060,2380,1441,365,519,396,161,251,443,443,304,939,78,420,261,180,781,158
62061,527,379,64,204,75,36,149,171,38,21,148,25,42,47,34,132,16
62062,1657,1226,331,555,291,49,445,552,140,89,431,162,167,67,35,333,98
62063,470,355,81,158,105,11,164,150,31,10,115,4,45,41,25,106,9
62065,51,35,0,22,13,0,16,17,2,0,16,7,0,3,6,13,3
62067,889,680,117,310,224,29,225,342,57,56,209,40,48,94,27,201,8
62069,1350,943,184,429,237,93,354,415,108,66,407,79,77,92,159,369,38
62070,28,16,2,4,10,0,6,10,0,0,12,2,0,3,7,9,3
62074,449,365,46,175,115,29,129,186,29,21,84,8,19,27,30,77,7
62075,1508,1001,151,457,283,110,375,485,89,52,507,85,111,148,163,471,36
62077,60,33,5,18,5,5,6,20,5,2,27,3,6,16,2,25,2
62078,48,33,3,20,8,2,18,11,3,1,15,1,1,8,5,15,0
62079,64,46,5,28,7,6,22,24,0,0,18,0,12,0,6,12,6
62080,1030,745,164,312,201,68,239,369,82,55,285,51,70,68,96,246,39
62081,132,102,17,32,41,12,20,71,4,7,30,1,9,4,16,23,7
62082,1207,864,184,390,216,74,281,391,122,70,343,56,88,106,93,292,51
62083,109,62,21,24,17,0,7,26,23,6,47,19,7,8,13,35,12
62084,615,410,95,173,111,31,131,198,52,29,205,36,46,69,54,181,24
62085,15,8,0,4,1,3,2,6,0,0,7,0,2,0,5,5,2
62086,633,455,112,171,146,26,133,239,60,23,178,46,28,51,53,155,23
62087,713,523,135,238,131,19,176,193,101,53,190,39,55,56,40,144,46
62088,2724,1932,388,872,514,158,701,918,149,164,792,138,199,170,285,707,85
62089,116,80,12,48,15,5,32,30,13,5,36,5,12,10,9,31,5
62090,588,396,127,159,85,25,52,79,162,103,192,40,79,50,23,166,26
62091,135,114,8,62,38,6,42,56,11,5,21,3,10,2,6,18,3
62092,1272,856,178,383,208,87,277,385,108,86,416,48,113,115,140,402,14
62093,130,95,26,37,22,10,28,39,18,10,35,1,4,18,12,33,2
62094,534,340,61,176,86,17,121,153,37,29,194,33,39,64,58,161,33
62095,4447,2781,725,1141,620,295,961,1081,435,304,1666,277,488,491,410,1507,159
62097,964,754,137,311,259,47,288,383,55,28,210,28,83,32,67,173,37
62201,3119,2049,810,726,338,175,327,397,902,423,1070,71,342,386,271,1017,53
62203,3259,2406,438,1104,705,159,370,722,667,647,853,128,306,333,86,754,99
62204,3440,2472,727,1009,639,97,352,502,1014,604,968,93,410,406,59,867,101
62205,3781,2569,388,1003,907,271,308,621,648,992,1212,155,347,435,275,1058,154
62206,6337,4767,1301,2339,910,217,1209,1435,1494,629,1570,293,428,506,343,1327,243
62207,3511,2469,689,1025,555,200,378,419,955,717,1042,78,285,449,230,938,104
62208,5940,4151,718,1905,1126,402,1221,2001,549,380,1789,271,698,466,354,1568,221
62214,480,378,47,199,88,44,158,191,16,13,102,14,17,21,50,93,9
62215,394,309,51,164,64,30,133,124,29,23,85,17,28,25,15,71,14
62216,383,283,68,128,74,13,104,126,33,20,100,27,20,19,34,91,9
62217,389,278,54,116,65,43,95,128,31,24,111,11,42,37,21,100,11
62218,478,387,85,199,82,21,216,130,16,25,91,25,21,39,6,82,9
62219,384,274,67,127,57,23,105,97,50,22,110,29,15,31,35,98,12
62220,7823,5085,1038,2442,1184,421,1740,2011,782,552,2738,534,979,614,611,2311,427
62221,8895,5967,1452,3082,1094,339,2206,2301,963,497,2928,825,926,724,453,2424,504
62223,7269,4821,739,2305,1341,436,1615,2269,505,432,2448,388,679,739,642,2216,232
62225,1477,1440,710,721,9,0,1108,206,126,0,37,26,11,0,0,32,5
62226,11394,7050,1377,3454,1631,588,2171,2939,1167,773,4344,925,1313,1086,1020,3783,561
62230,2104,1570,289,782,385,114,708,621,171,70,534,94,124,193,123,473,61
62231,2654,1912,260,947,569,136,624,912,200,176,742,110,171,252,209,643,99
62232,2775,1975,351,868,557,199,585,853,211,326,800,165,289,194,152,636,164
62233,2550,1666,289,791,403,183,568,778,184,136,884,138,243,256,247,760,124
62234,13277,8799,1949,4072,2112,666,3046,3890,1077,786,4478,1034,1337,1076,1031,3801,677
62236,4036,2917,493,1525,756,143,1253,1362,184,118,1119,190,415,260,254,947,172
62237,1259,915,179,444,232,60,305,449,110,51,344,27,110,120,87,314,30
62238,276,199,47,98,42,12,55,80,37,27,77,13,25,22,17,59,18
62239,1851,1286,317,618,278,73,452,609,132,93,565,104,166,180,115,479,86
62240,711,531,102,296,123,10,262,161,66,42,180,27,62,49,42,133,47
62241,436,307,66,113,106,22,153,123,14,17,129,8,32,66,23,108,21
62242,573,401,95,134,120,52,127,197,20,57,172,27,60,41,44,155,17
62243,1999,1552,197,883,385,87,624,635,194,99,447,36,143,160,108,400,47
62244,445,363,55,239,63,6,176,154,19,14,82,9,44,20,9,65,17
62245,862,652,113,351,147,41,311,266,45,30,210,62,44,57,47,177,33
62246,3139,2160,389,1051,525,195,777,1103,203,77,979,146,241,289,303,881,98
62249,5097,3723,712,1803,948,260,1547,1703,283,190,1374,222,365,388,399,1218,156
62250,179,123,33,51,31,8,47,63,6,7,56,7,20,10,19,49,7
62253,362,247,48,91,86,22,50,174,21,2,115,21,10,60,24,94,21
62254,1900,1275,208,636,381,50,466,568,118,123,625,203,138,160,124,496,129
62255,386,322,56,150,92,24,101,109,60,52,64,18,6,31,9,53,11
62257,1534,1116,187,515,320,94,359,559,120,78,418,59,73,148,138,379,39
62258,2759,2041,342,1094,439,166,751,966,219,105,718,113,288,158,159,608,110
62260,2221,1710,248,885,449,128,700,797,115,98,511,64,213,90,144,454,57
62261,96,55,9,24,22,0,39,9,0,7,41,0,22,19,0,41,0
62262,750,537,102,240,162,33,167,266,65,39,213,58,50,38,67,176,37
62263,2194,1590,295,753,397,145,604,758,109,119,604,92,102,190,220,568,36
62264,1232,898,158,431,261,48,346,405,87,60,334,55,80,106,93,291,43
62265,1520,1133,217,588,275,53,450,478,125,80,387,69,113,114,91,342,45
62266,52,40,9,21,2,8,21,19,0,0,12,0,0,0,12,12,0
62268,271,231,38,105,71,17,109,100,18,4,40,7,5,15,13,40,0
62269,9853,7127,1424,4174,1288,241,3251,2723,723,430,2726,752,1001,591,382,2299,427
62271,817,581,123,241,154,63,208,295,48,30,236,36,57,51,92,210,26
62272,636,426,112,170,111,33,149,221,34,22,210,33,46,50,81,173,37
62273,24,15,8,7,0,0,2,2,11,0,9,2,2,3,2,9,0
62274,2681,1835,342,840,514,139,642,919,184,90,846,114,211,284,237,768,78
62275,1402,1045,204,551,227,63,429,447,126,43,357,79,113,83,82,292,65
62277,583,410,83,194,106,27,150,193,43,24,173,29,57,34,53,154,19
62278,2559,1874,320,906,543,105,721,942,120,91,685,102,168,173,242,614,71
62279,0,0,0,0,0,0,0,0,0,0,0,0,0,0,0,0,0
62280,182,117,12,61,34,10,46,59,2,10,65,7,15,13,30,52,13
62281,618,502,96,216,151,39,201,259,28,14,116,18,48,33,17,87,29
62283,298,201,45,69,77,10,75,102,16,8,97,18,18,9,52,81,16
62284,215,168,27,73,46,22,67,80,19,2,47,8,20,15,4,43,4
62285,1032,830,143,465,180,42,309,380,108,33,202,25,58,70,49,183,19
62286,2506,1701,262,802,504,133,594,809,194,104,805,167,191,217,230,726,79
62288,1255,898,181,379,252,86,304,435,62,97,357,36,61,127,133,327,30
62289,108,81,14,44,18,5,33,37,2,9,27,7,6,3,11,15,12
62292,245,180,32,97,42,9,58,77,35,10,65,12,16,25,12,42,23
62293,1713,1340,223,668,357,92,536,599,106,99,373,38,94,121,120,338,35
62294,4396,3529,665,2071,679,114,1610,1365,352,202,867,175,258,279,155,742,125
62295,347,272,34,167,62,9,107,136,10,19,75,12,21,29,13,72,3
62297,141,119,12,47,47,13,51,68,0,0,22,0,0,17,5,22,0
62298,5134,3969,776,2036,930,227,1653,1690,344,282,1165,192,306,414,253,1018,147
62301,21053,13770,2720,6386,3533,1131,4856,6304,1645,965,7283,1577,1661,2034,2011,6388,895
62311,385,247,37,126,59,25,89,118,26,14,138,15,29,43,51,122,16
62312,889,629,125,251,199,54,197,321,48,63,260,37,55,59,109,247,13
62313,153,111,18,50,28,15,33,61,10,7,42,9,12,10,11,35,7
62314,239,179,41,75,41,22,79,61,23,16,60,15,8,14,23,48,12
62316,290,216,45,94,57,20,69,119,19,9,74,23,18,7,26,59,15
62318,137,112,22,54,22,14,21,66,25,0,25,2,10,6,7,17,8
62319,109,73,10,20,38,5,11,54,6,2,36,14,12,3,7,28,8
62320,796,591,116,301,119,55,240,244,82,25,205,36,50,43,76,174,31
62321,1838,1219,185,508,408,118,459,590,74,96,619,112,170,146,191,536,83
62323,138,103,13,47,31,12,35,63,2,3,35,17,3,5,10,34,1
62324,508,354,70,121,123,40,126,180,32,16,154,52,8,39,55,132,22
62325,182,127,17,77,31,2,58,60,7,2,55,6,8,28,13,53,2
62326,1095,746,118,347,237,44,221,397,74,54,349,51,83,103,112,314,35
62330,730,500,77,213,162,48,138,288,29,45,230,24,72,63,71,203,27
62334,71,52,22,15,15,0,21,20,5,6,19,0,4,6,9,19,0
62336,33,25,7,10,4,4,6,9,3,7,8,1,0,5,2,8,0
62338,498,384,49,217,95,23,159,164,24,37,114,24,26,47,17,98,16
62339,417,311,54,123,93,41,113,163,28,7,106,28,6,23,49,104,2
62340,698,508,101,238,135,34,211,223,60,14,190,25,56,55,54,162,28
62341,1485,1019,183,488,269,79,391,510,54,64,466,94,116,136,120,400,66
62343,326,230,48,98,66,18,81,114,18,17,96,16,29,25,26,88,8
62344,69,55,11,34,10,0,32,11,6,6,14,4,5,0,5,14,0
62345,170,128,18,61,37,12,48,61,11,8,42,11,11,14,6,37,5
62346,76,44,6,8,14,16,11,33,0,0,32,0,20,9,3,22,10
62347,822,647,103,318,187,39,212,353,32,50,175,26,66,35,48,151,24
62348,90,76,15,34,20,7,27,32,7,10,14,4,2,3,5,12,2
62349,249,190,46,84,52,8,68,88,21,13,59,4,24,15,16,55,4
62351,650,497,94,254,134,15,177,251,43,26,153,23,24,42,64,134,19
62352,144,108,28,32,27,21,40,47,8,13,36,4,7,11,14,34,2
62353,1576,1023,172,495,262,94,358,532,100,33,553,163,125,146,119,497,56
62354,597,443,71,183,140,49,124,240,40,39,154,21,36,69,28,149,5
62355,370,285,69,106,82,28,81,153,37,14,85,6,26,36,17,73,12
62356,279,207,32,96,46,33,70,99,29,9,72,9,15,24,24,70,2
62357,103,91,10,46,24,11,15,67,9,0,12,3,0,4,5,12,0
62358,256,202,31,98,57,16,70,106,8,18,54,7,21,14,12,50,4
62359,61,54,10,17,25,2,15,39,0,0,7,0,0,7,0,7,0
62360,632,501,94,263,112,32,203,235,41,22,131,20,34,38,39,116,15
62361,220,143,12,60,56,15,48,70,11,14,77,0,31,22,24,73,4
62362,197,105,22,34,35,14,36,60,5,4,92,7,13,26,46,85,7
62363,2504,1687,238,749,494,206,574,857,115,141,817,130,128,233,326,774,43
62365,249,196,40,91,59,6,87,92,14,3,53,7,15,11,20,46,7
62366,595,420,87,159,134,40,141,214,48,17,175,21,28,53,73,169,6
62367,529,379,112,141,102,24,153,179,37,10,150,21,52,37,40,129,21
62370,229,172,30,91,40,11,78,68,14,12,57,10,18,9,20,54,3
62373,147,124,16,67,27,14,67,57,0,0,23,5,3,7,8,21,2
62374,136,95,23,38,22,12,27,51,10,7,41,1,21,5,14,39,2
62375,117,90,9,61,18,2,48,34,6,2,27,7,0,10,10,23,4
62376,456,327,55,157,80,35,123,166,25,13,129,20,37,25,47,117,12
62378,372,238,39,106,65,28,80,126,21,11,134,22,30,43,39,124,10
62379,901,635,104,310,173,48,225,318,62,30,266,32,75,78,81,241,25
62380,173,126,22,59,39,6,56,50,14,6,47,10,8,18,11,47,0
62401,7641,5027,1176,2262,1228,361,1904,2198,582,343,2614,526,753,674,661,2349,265
62410,373,292,47,155,68,22,128,126,23,15,81,12,25,16,28,69,12
62411,1566,1118,232,533,272,81,433,490,114,81,448,63,127,92,166,405,43
62413,159,135,21,69,38,7,44,65,9,17,24,5,0,0,19,19,5
62414,628,456,71,216,134,35,157,228,44,27,172,38,58,39,37,143,29
62417,1363,925,183,378,284,80,248,451,137,89,438,74,121,130,113,390,48
62418,828,564,104,244,157,59,168,293,67,36,264,36,62,90,76,230,34
62419,163,118,27,58,26,7,34,58,15,11,45,8,15,14,8,33,12
62420,2102,1420,236,656,399,129,429,729,178,84,682,103,108,222,249,633,49
62421,298,221,23,116,66,16,104,104,12,1,77,14,23,13,27,77,0
62422,470,349,91,159,84,15,115,190,33,11,121,11,33,46,31,119,2
62423,272,210,15,121,65,9,60,116,28,6,62,29,7,4,22,62,0
62424,657,540,119,254,137,30,242,205,63,30,117,24,30,35,28,95,22
62425,298,218,58,73,60,27,96,80,42,0,80,4,23,15,38,80,0
62426,473,357,104,147,89,17,151,128,52,26,116,13,25,33,45,105,11
62427,713,526,99,222,134,71,192,279,31,24,187,28,61,59,39,153,34
62428,1317,885,150,423,236,76,300,414,107,64,432,42,74,144,172,387,45
62431,467,334,71,110,127,26,122,170,19,23,133,25,29,40,39,123,10
62432,224,175,19,82,55,19,57,106,9,3,49,17,7,14,11,40,9
62433,412,305,59,126,95,25,74,178,35,18,107,14,18,31,44,93,14
62434,160,97,13,31,43,10,14,69,10,4,63,22,10,7,24,51,12
62436,211,156,18,79,40,19,58,84,8,6,55,16,18,13,8,49,6
62438,161,133,5,81,29,18,48,72,6,7,28,10,13,5,0,28,0
62439,3361,2209,405,917,711,176,610,1218,248,133,1152,140,274,353,385,1049,103
62440,595,441,112,204,88,37,185,178,49,29,154,38,37,54,25,138,16
62441,3067,2069,398,1001,545,125,732,953,238,146,998,150,197,301,350,906,92
62442,1039,768,127,329,240,72,261,404,69,34,271,44,71,68,88,256,15
62443,563,470,104,222,111,33,206,197,51,16,93,7,28,37,21,77,16
62444,169,98,11,55,21,11,22,62,6,8,71,12,18,32,9,65,6
62445,382,268,54,141,65,8,147,95,9,17,114,19,43,23,29,91,23
62446,165,132,34,40,36,22,44,72,6,10,33,6,9,9,9,29,4
62447,1358,1028,230,451,302,45,404,479,85,60,330,71,72,119,68,265,65
62448,2452,1671,301,855,365,150,661,802,156,52,781,151,182,186,262,698,83
62449,1291,901,165,373,296,67,309,424,110,58,390,55,97,98,140,342,48
62450,5038,3358,612,1463,987,296,1043,1617,424,274,1680,256,447,464,513,1455,225
62451,965,673,138,305,164,66,201,345,69,58,292,26,61,122,83,264,28
62452,170,118,26,53,33,6,35,69,8,6,52,7,13,21,11,43,9
62454,4398,2988,544,1397,785,262,1069,1417,337,165,1410,262,329,450,369,1272,138
62458,858,636,134,302,158,42,231,293,70,42,222,17,58,65,82,206,16
62459,112,71,24,12,20,15,30,37,0,4,41,1,5,5,30,40,1
62460,509,356,68,165,84,39,115,148,66,27,153,41,27,55,30,143,10
62461,287,229,35,113,46,35,82,100,32,15,58,11,15,19,13,51,7
62462,383,311,55,164,75,17,162,110,14,25,72,8,15,25,24,72,0
62463,538,396,74,184,98,40,141,197,29,29,142,19,24,41,58,135,7
62465,332,253,47,119,53,34,105,115,20,13,79,14,22,14,29,70,9
62466,953,712,132,357,172,51,292,334,49,37,241,38,51,79,73,222,19
62467,1188,960,160,510,216,74,480,377,52,51,228,63,50,66,49,197,31
62468,995,699,139,316,185,59,226,308,96,69,296,37,55,94,110,280,16
62469,130,91,5,57,25,4,56,35,0,0,39,7,5,9,18,30,9
62471,3530,2376,516,1063,580,217,808,1032,283,253,1154,178,293,354,329,1035,119
62473,493,438,114,231,65,28,194,149,69,26,55,16,25,9,5,45,10
62474,396,305,56,129,105,15,116,151,23,15,91,17,17,24,33,82,9
62475,140,140,23,57,39,21,55,70,11,4,0,0,0,0,0,0,0
62476,795,558,103,260,143,52,190,288,58,22,237,32,63,82,60,221,16
62477,434,316,54,165,78,19,114,130,42,30,118,9,53,30,26,109,9
62478,154,121,32,53,24,12,41,77,0,3,33,9,0,13,11,33,0
62479,279,221,36,90,76,19,72,130,11,8,58,5,1,25,27,55,3
62480,321,275,33,135,78,29,103,137,29,6,46,13,9,12,12,35,11
62481,177,120,30,74,6,10,47,61,10,2,57,8,19,10,20,57,0
62501,605,482,76,254,143,9,184,235,40,23,123,21,36,37,29,115,8
62510,736,502,95,216,141,50,162,258,51,31,234,26,54,66,88,221,13
62511,93,56,12,26,18,0,21,35,0,0,37,0,13,6,18,37,0
62512,195,167,27,85,35,20,94,61,0,12,28,12,0,7,9,28,0
62513,701,527,110,258,115,44,223,214,42,48,174,29,50,37,58,154,20
62514,117,85,10,49,20,6,33,46,0,6,32,13,6,0,13,24,8
62515,387,276,35,153,67,21,88,141,31,16,111,24,36,28,23,103,8
62517,90,59,5,18,30,6,10,30,1,18,31,3,2,18,8,29,2
62518,193,164,10,79,63,12,44,105,6,9,29,7,16,6,0,16,13
62519,31,25,19,6,0,0,25,0,0,0,6,0,0,0,6,6,0
62520,570,471,71,237,144,19,179,221,53,18,99,32,27,24,16,89,10
62521,15234,10692,2010,4920,2873,889,2986,5157,1685,864,4542,833,1367,1422,920,3994,548
62522,7063,4251,995,1911,991,354,1176,1744,824,507,2812,717,1071,614,410,2302,510
62523,354,94,39,34,14,7,0,21,60,13,260,55,20,85,100,243,17
62526,15653,9614,2025,4212,2557,820,2660,4353,1687,914,6039,1250,1716,1559,1514,5328,711
62530,598,442,90,232,95,25,163,199,51,29,156,23,67,51,15,130,26
62531,818,587,110,259,186,32,188,290,60,49,231,29,85,63,54,201,30
62532,15,15,0,15,0,0,9,0,6,0,0,0,0,0,0,0,0
62533,411,282,61,137,63,21,107,144,8,23,129,27,28,41,33,121,8
62534,503,363,52,168,121,22,120,189,29,25,140,33,41,38,28,129,11
62535,928,763,71,409,244,39,316,399,36,12,165,20,40,55,50,153,12
62536,347,271,39,173,50,9,109,153,9,0,76,11,23,33,9,56,20
62537,49,35,2,20,8,5,15,15,0,5,14,0,4,8,2,10,4
62538,172,120,22,56,38,4,67,42,8,3,52,9,10,19,14,40,12
62539,524,409,86,206,107,10,148,201,47,13,115,21,33,39,22,105,10
62540,613,406,99,166,116,25,119,186,67,34,207,29,56,55,67,194,13
62541,27,27,0,20,7,0,5,14,8,0,0,0,0,0,0,0,0
62543,216,157,41,72,35,9,45,92,18,2,59,11,10,10,28,52,7
62544,649,468,72,239,111,46,175,208,59,26,181,40,30,63,48,165,16
62545,420,284,60,132,70,22,114,116,29,25,136,39,45,21,31,97,39
62546,653,490,79,221,138,52,184,249,38,19,163,28,43,47,45,147,16
62547,319,262,47,131,70,14,82,133,24,23,57,6,13,23,15,54,3
62548,979,688,127,298,180,83,238,361,64,25,291,38,22,103,128,269,22
62549,2125,1698,298,916,387,97,709,817,141,31,427,143,137,119,28,364,63
62550,1159,889,167,436,237,49,333,445,77,34,270,16,58,86,110,236,34
62551,311,242,50,112,62,18,92,112,25,13,69,11,21,14,23,60,9
62552,413,344,39,172,109,24,78,234,23,9,69,2,19,39,9,58,11
62553,180,151,30,75,32,14,69,74,6,2,29,3,5,6,15,27,2
62554,673,584,77,291,202,14,176,313,47,48,89,8,23,41,17,78,11
62555,232,203,55,78,66,4,58,123,15,7,29,3,13,5,8,27,2
62556,164,122,17,59,33,13,39,74,7,2,42,2,10,13,17,32,10
62557,3099,2063,391,836,633,203,757,926,237,143,1036,192,254,245,345,958,78
62558,1349,1007,177,526,278,26,433,391,99,84,342,70,59,102,111,278,64
62560,570,418,69,176,113,60,139,226,30,23,152,12,55,42,43,134,18
62561,1842,1348,288,702,297,61,472,634,188,54,494,98,182,133,81,426,68
62563,1772,1461,118,915,356,72,588,719,109,45,311,34,108,95,74,287,24
62565,3174,2174,421,963,600,190,721,1057,238,158,1000,152,189,321,338,911,89
62567,477,339,79,135,84,41,120,174,31,14,138,6,39,37,56,123,15
62568,6235,4171,903,1919,1003,346,1362,1943,590,276,2064,326,451,609,678,1839,225
62570,217,143,38,56,35,14,52,75,13,3,74,17,16,28,13,65,9
62571,555,404,76,161,147,20,115,229,36,24,151,23,50,37,41,129,22
62572,180,155,24,81,37,13,68,57,11,19,25,7,4,4,10,21,4
62573,611,460,85,254,104,17,172,196,67,25,151,43,44,35,29,126,25
62601,205,162,13,90,43,16,60,80,14,8,43,5,25,5,8,32,11
62610,88,70,13,44,13,0,33,23,6,8,18,0,0,4,14,18,0
62611,457,336,34,186,95,21,149,167,12,8,121,21,39,22,39,103,18
62612,796,575,111,276,147,41,220,262,55,38,221,22,70,68,61,200,21
62613,1327,947,194,512,197,44,406,417,78,46,380,70,112,95,103,304,76
62615,2020,1483,433,731,244,75,660,524,221,78,537,120,156,134,127,428,109
62617,303,221,32,102,64,23,66,116,22,17,82,19,10,43,10,69,13
62618,2860,1962,496,803,526,137,685,860,245,172,898,168,238,245,247,750,148
62621,469,335,47,195,76,17,138,139,42,16,134,28,21,28,57,120,14
62624,272,205,28,72,81,24,66,122,7,10,67,11,24,13,19,56,11
62625,294,260,48,159,41,12,103,128,27,2,34,0,11,15,8,34,0
62626,3216,2269,403,987,607,272,777,1140,230,122,947,133,283,267,264,829,118
62627,466,329,49,142,113,25,110,172,21,26,137,27,36,30,44,120,17
62628,402,298,63,131,86,18,108,132,32,26,104,29,19,31,25,92,12
62629,3454,2843,530,1619,578,116,1232,1058,389,164,611,135,251,152,73,543,68
62630,232,182,35,80,44,23,63,100,14,5,50,8,12,14,16,39,11
62631,101,79,17,26,24,12,27,35,11,6,22,0,8,8,6,19,3
62633,286,229,51,103,55,20,86,110,20,13,57,7,18,10,22,54,3
62634,355,254,40,137,52,25,114,114,15,11,101,22,31,21,27,84,17
62635,288,202,35,86,60,21,83,95,21,3,86,12,22,18,34,78,8
62638,532,406,67,224,92,23,183,173,34,16,126,29,34,31,32,103,23
62639,141,93,32,28,26,7,45,41,0,7,48,11,17,16,4,48,0
62640,1503,1073,177,464,342,90,291,568,142,72,430,59,100,148,123,369,61
62642,613,459,86,228,120,25,190,202,34,33,154,22,41,54,37,142,12
62643,146,108,32,47,20,9,37,48,23,0,38,9,3,10,16,31,7
62644,2383,1697,353,677,454,213,485,904,181,127,686,129,163,181,213,647,39
62649,228,162,31,61,59,11,55,79,19,9,66,9,24,15,18,60,6
62650,10461,6665,1130,3178,1792,565,2168,3148,776,573,3796,701,1144,1054,897,3303,493
62655,251,195,29,101,57,8,74,92,15,14,56,4,11,23,18,52,4
62656,7072,4649,956,2153,1250,290,1614,2071,595,369,2423,444,667,636,676,2137,286
62661,495,402,54,211,114,23,130,208,40,24,93,11,65,9,8,74,19
62663,128,99,28,42,17,12,42,43,12,2,29,7,6,8,8,26,3
62664,1355,928,166,401,265,96,316,444,100,68,427,59,88,118,162,402,25
62665,707,502,105,219,143,35,155,250,65,32,205,28,46,71,60,187,18
62666,242,168,37,91,32,8,87,56,20,5,74,9,25,24,16,64,10
62667,239,194,50,77,58,9,76,87,15,16,45,7,15,10,13,40,5
62668,580,469,64,227,151,27,186,236,37,10,111,19,18,29,45,103,8
62670,1071,758,133,389,177,59,317,342,44,55,313,52,99,108,54,243,70
62671,293,221,36,92,77,16,79,120,19,3,72,13,18,14,27,61,11
62672,113,80,22,28,25,5,32,38,8,2,33,2,13,9,9,29,4
62673,240,177,42,70,46,19,79,77,13,8,63,8,5,30,20,55,8
62674,651,465,59,203,160,43,120,263,49,33,186,13,68,35,70,165,21
62675,2361,1695,250,935,422,88,619,777,236,63,666,87,190,198,191,613,53
62677,911,763,123,369,220,51,293,389,49,32,148,19,66,26,37,130,18
62681,2106,1439,238,663,404,134,536,743,81,79,667,85,163,211,208,596,71
62682,366,303,44,151,69,39,100,153,20,30,63,12,9,15,27,50,13
62684,1290,986,138,587,205,56,451,410,93,32,304,56,93,100,55,236,68
62685,836,612,95,318,144,55,210,340,42,20,224,41,66,74,43,199,25
62686,62,39,17,16,6,0,16,17,3,3,23,7,3,6,7,17,6
62688,359,289,44,142,74,29,97,144,31,17,70,12,19,21,18,60,10
62689,230,152,42,56,46,8,62,66,17,7,78,7,16,24,31,66,12
62690,1660,1115,282,510,241,82,432,519,116,48,545,73,151,134,187,482,63
62691,1081,752,128,371,168,85,297,331,79,45,329,39,103,101,86,288,41
62692,826,561,111,239,156,55,195,297,50,19,265,49,72,74,70,216,49
62693,644,529,84,249,148,48,183,286,43,17,115,16,24,43,32,112,3
62694,1368,944,191,402,284,67,364,427,84,69,424,50,98,139,137,381,43
62695,175,132,41,61,14,16,62,43,17,10,43,11,14,11,7,35,8
62701,667,57,0,15,28,14,0,13,0,44,610,158,204,171,77,546,64
62702,17474,9991,2521,4323,2276,871,2867,4159,1794,1171,7483,1497,2468,2007,1511,6368,1115
62703,12848,7752,2053,3486,1731,482,1899,2645,2158,1050,5096,976,1791,1480,849,4217,879
62704,19347,10449,2116,4874,2521,938,3213,4703,1439,1094,8898,2539,2883,1935,1541,7632,1266
62707,10304,7761,1149,4515,1854,243,3265,3556,619,321,2543,534,1070,614,325,2160,383
62801,9094,6028,1348,2660,1534,486,1831,2710,957,530,3066,412,814,917,923,2716,350
62803,327,231,41,104,61,25,87,117,16,11,96,10,27,24,35,79,17
62806,1441,1003,201,413,281,108,343,534,72,54,438,41,94,124,179,395,43
62807,376,235,48,101,48,38,63,140,27,5,141,23,58,24,36,130,11
62808,582,406,59,182,118,47,137,190,34,45,176,31,36,60,49,156,20
62809,91,73,15,34,10,14,21,41,5,6,18,2,10,6,0,16,2
62810,359,289,35,153,75,26,128,144,11,6,70,11,19,24,16,67,3
62811,174,115,31,52,26,6,52,47,16,0,59,16,14,17,12,52,7
62812,4646,3102,539,1271,947,345,1020,1618,253,211,1544,239,317,489,499,1399,145
62814,770,611,132,271,167,41,182,327,79,23,159,38,35,41,45,129,30
62815,163,136,22,87,25,2,62,56,3,15,27,7,5,11,4,25,2
62816,495,355,84,139,96,36,119,177,29,30,140,18,53,26,43,116,24
62817,255,205,45,78,62,20,67,106,10,22,50,5,10,26,9,48,2
62818,126,100,12,50,34,4,39,56,5,0,26,0,11,15,0,25,1
62819,223,125,38,40,38,9,27,57,22,19,98,15,25,44,14,82,16
62820,80,60,9,21,21,9,18,38,2,2,20,2,4,4,10,18,2
62821,3463,2271,381,992,660,238,648,1288,217,118,1192,139,338,367,348,1091,101
62822,1345,836,178,312,254,92,228,430,108,70,509,47,98,192,172,470,39
62823,713,506,122,206,144,34,187,248,60,11,207,29,35,72,71,196,11
62824,808,545,126,218,151,50,202,242,51,50,263,39,48,93,83,243,20
62825,87,57,13,26,16,2,16,26,5,10,30,8,2,15,5,24,6
62827,548,395,72,134,126,63,120,219,20,36,153,17,26,45,65,141,12
62828,600,448,97,219,109,23,206,203,24,15,152,8,35,50,59,143,9
62829,61,52,15,31,6,0,25,20,7,0,9,0,0,9,0,9,0
62830,622,401,93,198,81,29,163,187,29,22,221,17,37,78,89,205,16
62831,243,185,23,94,53,15,69,81,19,16,58,2,8,8,40,54,4
62832,3991,2628,485,1239,664,240,901,1215,305,207,1363,148,364,403,448,1219,144
62833,152,122,21,45,44,12,34,76,2,10,30,10,3,6,11,30,0
62835,522,337,56,168,102,11,152,133,20,32,185,19,20,77,69,167,18
62836,300,229,49,92,70,18,72,115,29,13,71,0,23,20,28,65,6
62837,3922,2582,492,1103,753,234,851,1265,279,187,1340,184,289,415,452,1211,129
62838,552,407,58,214,100,35,161,176,35,35,145,14,40,44,47,132,13
62839,2788,1832,415,770,442,205,571,871,241,149,956,125,208,301,322,854,102
62842,337,253,53,100,81,19,97,116,27,13,84,11,20,25,28,74,10
62843,50,36,6,20,8,2,16,15,5,0,14,6,3,5,0,14,0
62844,923,601,92,301,146,62,234,253,60,54,322,56,77,108,81,293,29
62846,307,217,40,79,69,29,60,116,35,6,90,9,38,24,19,77,13
62848,284,207,54,105,43,5,107,61,22,17,77,20,13,18,26,59,18
62849,809,648,153,298,169,28,284,283,41,40,161,18,35,44,64,152,9
62850,242,202,28,102,56,16,55,136,4,7,40,14,3,5,18,37,3
62851,149,109,28,57,4,20,26,55,21,7,40,0,12,20,8,35,5
62852,103,72,13,26,29,4,18,46,4,4,31,11,11,5,4,23,8
62853,351,296,59,119,91,27,101,152,14,29,55,4,16,12,23,50,5
62854,742,546,93,239,165,49,173,304,42,27,196,39,38,50,69,164,32
62857,39,32,14,3,15,0,8,12,0,12,7,0,0,0,7,7,0
62858,1242,879,181,344,248,106,292,445,66,76,363,37,81,118,127,331,32
62859,2308,1570,284,674,430,182,508,818,137,107,738,123,84,240,291,685,53
62860,236,193,25,100,54,14,90,89,6,8,43,3,13,17,10,41,2
62861,86,49,16,14,15,4,12,24,7,6,37,5,11,17,4,31,6
62862,183,132,29,50,42,11,46,72,10,4,51,2,20,11,18,49,2
62863,4419,3022,552,1419,761,290,1083,1481,255,203,1397,244,363,421,369,1215,182
62864,10358,6791,1381,3192,1702,516,2187,3193,930,481,3567,571,906,1050,1040,3176,391
62865,728,583,141,256,153,33,235,265,41,42,145,17,40,44,44,134,11
62867,264,200,43,77,73,7,74,105,16,5,64,3,31,15,15,57,7
62868,722,533,139,229,125,40,206,254,45,28,189,23,46,54,66,166,23
62869,1073,744,144,325,196,79,265,393,59,27,329,52,95,97,85,288,41
62870,827,587,141,256,131,59,220,259,72,36,240,28,85,82,45,224,16
62871,315,212,19,100,85,8,78,123,4,7,103,18,17,25,43,95,8
62872,471,395,113,187,75,20,177,153,46,19,76,4,24,33,15,66,10
62874,29,22,2,16,4,0,2,12,8,0,7,0,3,2,2,7,0
62875,492,358,69,156,110,23,117,167,48,26,134,19,30,37,48,112,22
62876,71,52,17,15,15,5,30,16,0,6,19,5,2,0,12,17,2
62877,218,169,32,76,45,16,65,77,14,13,49,8,21,10,10,46,3
62878,178,124,28,43,36,17,34,72,10,8,54,3,16,5,30,46,8
62879,51,36,4,16,14,2,5,23,8,0,15,2,2,2,9,15,0
62880,292,199,37,76,60,26,75,97,14,13,93,22,7,45,19,84,9
62881,4698,3299,660,1451,948,240,1078,1604,425,192,1399,252,292,330,525,1275,124
62882,1010,755,177,350,182,46,263,327,124,41,255,31,67,80,77,221,34
62883,255,188,40,69,49,30,57,106,0,25,67,17,10,35,5,61,6
62884,1301,904,203,367,255,79,282,447,100,75,397,44,91,102,160,369,28
62885,355,234,37,101,88,8,107,95,21,11,121,13,37,30,41,106,15
62886,159,132,26,54,40,12,31,67,28,6,27,8,5,6,8,22,5
62887,154,106,20,38,34,14,37,55,12,2,48,15,2,17,14,46,2
62888,833,628,106,277,189,56,193,335,58,42,205,25,54,63,63,175,30
62889,366,272,47,127,88,10,90,151,29,2,94,20,21,19,34,87,7
62890,996,768,198,354,157,59,313,329,61,65,228,14,72,65,77,197,31
62891,238,150,18,76,38,18,53,70,13,14,88,11,26,28,23,69,19
62892,161,110,6,65,30,9,41,54,4,11,51,7,10,24,10,51,0
62893,395,303,66,127,97,13,96,154,27,26,92,2,33,32,25,81,11
62894,375,279,61,119,75,24,105,151,16,7,96,21,16,32,27,80,16
62895,874,622,136,238,195,53,216,290,94,22,252,33,42,77,100,230,22
62896,5501,3648,699,1604,1033,312,1099,1701,455,393,1853,291,479,554,529,1660,193
62897,133,88,18,38,19,13,33,45,6,4,45,4,15,8,18,36,9
62898,720,575,156,258,137,24,244,262,47,22,145,18,43,41,43,128,17
62899,568,452,92,219,111,30,182,234,25,11,116,14,26,63,13,108,8
62901,14097,6040,1897,2502,1285,356,1946,2374,1000,720,8057,5348,1472,700,537,5558,2499
62905,246,188,33,82,64,9,61,116,9,2,58,15,16,11,16,46,12
62906,3101,1939,410,800,548,181,600,870,250,219,1162,144,217,405,396,1071,91
62907,838,626,137,275,181,33,253,305,33,35,212,37,53,61,61,171,41
62908,207,159,57,55,34,13,69,79,9,2,48,5,6,14,23,42,6
62910,1100,805,224,344,186,51,283,342,135,45,295,55,80,96,64,260,35
62912,422,353,83,146,101,23,154,159,24,16,69,8,12,36,13,62,7
62914,1745,1020,292,417,188,123,213,354,290,163,725,73,243,223,186,690,35
62915,83,48,22,18,8,0,18,10,13,7,35,30,0,3,2,32,3
62916,284,214,43,91,53,27,83,100,13,18,70,5,16,21,28,62,8
62917,1051,694,175,265,175,79,264,358,47,25,357,40,93,103,121,339,18
62918,3598,2419,523,1154,604,138,861,1067,300,191,1179,375,344,292,168,994,185
62919,427,295,59,138,78,20,91,147,43,14,132,5,25,47,55,132,0
62920,1266,885,184,386,232,83,337,406,89,53,381,46,110,133,92,315,66
62921,164,92,22,41,20,9,21,31,22,18,72,19,10,29,14,64,8
62922,1208,900,151,353,346,50,285,506,50,59,308,47,84,102,75,286,22
62923,197,127,27,49,32,19,41,67,4,15,70,7,24,17,22,68,2
62924,1144,777,187,367,177,46,269,346,96,66,367,98,109,87,73,313,54
62926,987,745,152,280,244,69,208,412,87,38,242,31,82,62,67,221,21
62927,140,85,21,34,22,8,33,23,18,11,55,16,8,19,12,43,12
62928,98,60,12,32,12,4,25,27,8,0,38,0,19,9,10,38,0
62930,2791,1804,378,780,542,104,608,861,231,104,987,156,164,312,355,924,63
62931,708,490,89,196,175,30,118,282,60,30,218,18,70,70,60,197,21
62932,670,506,123,200,143,40,174,235,64,33,164,28,50,29,57,142,22
62933,384,282,51,116,102,13,77,151,27,27,102,20,23,33,26,76,26
62934,480,341,60,128,129,24,95,177,38,31,139,23,25,45,46,123,16
62935,847,550,123,255,141,31,186,282,57,25,297,22,65,126,84,270,27
62938,1212,868,146,373,272,77,291,411,96,70,344,21,95,135,93,302,42
62939,1208,865,138,367,297,63,280,475,54,56,343,39,78,120,106,290,53
62940,167,127,32,67,24,4,33,59,20,15,40,6,6,9,19,35,5
62941,345,264,37,130,70,27,73,143,32,16,81,12,20,25,24,77,4
62942,301,210,43,90,65,12,90,92,9,19,91,13,15,54,9,85,6
62943,263,195,26,92,55,22,74,103,18,0,68,0,6,29,33,58,10
62946,5890,3886,695,1741,1120,330,1237,1822,411,416,2004,258,544,619,583,1853,151
62947,250,184,7,96,81,0,52,84,29,19,66,23,17,19,7,66,0
62948,5124,3233,781,1328,878,246,997,1537,455,244,1891,280,449,517,645,1685,206
62949,279,171,45,75,42,9,49,68,35,19,108,5,30,45,28,95,13
62950,103,55,6,17,14,18,16,39,0,0,48,16,0,7,25,48,0
62951,2275,1601,392,654,397,158,600,723,172,106,674,65,142,205,262,625,49
62952,1414,1006,193,468,250,95,315,493,123,75,408,46,86,152,124,368,40
62953,159,104,25,34,35,10,30,44,15,15,55,13,11,21,10,49,6
62954,233,191,30,115,36,10,87,79,22,3,42,2,10,15,15,33,9
62956,394,270,53,103,81,33,89,131,21,29,124,13,34,32,45,104,20
62957,483,337,75,116,131,15,128,147,42,20,146,3,51,61,31,140,6
62958,774,476,79,276,107,14,182,211,57,26,298,138,84,72,4,221,77
62959,10090,6980,1532,3024,1758,666,2264,3440,840,436,3110,398,706,1090,916,2812,298
62960,4764,3188,610,1356,992,230,1026,1533,381,248,1576,244,360,479,493,1432,144
62962,36,23,0,0,23,0,0,19,0,4,13,0,5,0,8,13,0
62963,287,181,47,90,36,8,52,31,61,37,106,12,27,38,29,95,11
62964,619,421,70,186,124,41,115,153,89,64,198,22,59,68,49,175,23
62966,6610,4201,879,1924,1068,330,1334,1977,578,312,2409,649,550,631,579,2061,348
62967,128,103,36,35,23,9,36,42,12,13,25,8,0,9,8,22,3
62969,356,239,31,148,51,9,85,119,27,8,117,17,22,42,36,111,6
62970,312,210,27,101,68,14,76,97,16,21,102,11,23,29,39,102,0
62972,155,127,39,64,24,0,62,45,15,5,28,7,8,8,5,21,7
62974,513,342,67,152,109,14,112,199,16,15,171,53,46,38,34,162,9
62975,79,71,21,45,5,0,32,17,13,9,8,8,0,0,0,8,0
62976,279,177,43,67,45,22,54,68,23,32,102,22,23,35,22,88,14
62977,228,181,26,101,44,10,52,94,32,3,47,3,16,6,22,47,0
62979,604,385,74,171,98,42,119,209,37,20,219,27,33,74,85,205,14
62982,600,401,72,155,135,39,147,186,35,33,199,31,31,73,64,179,20
62983,646,410,72,178,102,58,115,194,61,40,236,31,39,105,61,208,28
62984,917,597,129,220,189,59,151,309,92,45,320,31,74,110,105,284,36
62985,395,265,42,107,90,26,74,164,21,6,130,26,18,59,27,125,5
62987,348,261,46,134,56,25,100,145,4,12,87,0,27,42,18,87,0
62988,675,509,81,236,155,37,122,229,82,76,166,11,54,44,57,154,12
62990,441,353,80,122,121,30,75,197,51,30,88,0,12,34,42,74,14
62991,326,262,27,116,109,10,89,126,14,33,64,8,27,21,8,57,7
62992,361,243,37,124,59,23,53,100,53,37,118,3,35,24,56,118,0
62993,69,42,8,25,0,9,27,15,0,0,27,0,0,27,0,27,0
62994,254,186,44,98,44,0,84,68,20,14,68,14,6,31,17,59,9
62995,1311,910,172,398,242,98,310,426,109,65,401,71,60,151,119,367,34
62996,297,221,39,124,53,5,86,115,20,0,76,15,20,25,16,74,2
62997,246,184,53,62,58,11,71,76,26,11,62,4,21,20,17,55,7
62998,176,123,32,52,39,0,71,16,7,29,53,0,29,9,15,53,0
62999,750,463,114,186,147,16,133,233,58,39,287,23,53,98,113,259,28
63005,5488,4721,374,3203,1021,123,2561,1893,134,133,767,207,385,143,32,696,71
63010,13384,10257,2207,5243,2430,377,4025,4265,1230,737,3127,637,1112,999,379,2581,546
63011,14080,11114,1471,6002,2952,689,4918,5021,635,540,2966,523,783,913,747,2574,392
63012,3067,2595,535,1500,488,72,1174,990,267,164,472,108,272,75,17,354,118
63013,577,460,101,233,100,26,198,207,28,27,117,18,41,28,30,111,6
63014,294,211,36,87,73,15,75,108,9,19,83,11,34,27,11,76,7
63015,771,602,169,280,104,49,235,243,83,41,169,20,83,30,36,147,22
63016,2662,2078,427,1121,455,75,934,837,181,126,584,109,215,178,82,486,98
63017,16365,12016,1002,6326,3912,776,4535,6355,570,556,4349,1054,969,1213,1113,3771,578
63019,1653,1125,258,464,282,121,350,477,201,97,528,103,140,137,148,475,53
63020,7478,5681,1167,2789,1465,260,2104,2561,702,314,1797,370,501,520,406,1523,274
63021,19953,14851,2688,8841,2910,412,7103,5610,1320,818,5102,1420,1942,1284,456,4248,854
63023,1820,1435,249,785,352,49,559,627,143,106,385,41,169,136,39,337,48
63025,3536,2944,576,1743,555,70,1428,1213,178,125,592,60,319,117,96,503,89
63026,15055,11558,2406,6588,2214,350,5030,4370,1358,800,3497,890,1395,832,380,2826,671
63028,8347,6387,1474,3001,1603,309,2317,2772,847,451,1960,311,657,578,414,1697,263
63030,125,98,18,57,19,4,32,52,12,2,27,0,15,10,2,16,11
63031,19030,13580,2641,6792,3260,887,4917,5569,1668,1426,5450,966,1910,1423,1151,4795,655
63033,17973,12267,2187,5842,3345,893,3938,5024,1872,1433,5706,1045,1693,1646,1322,4984,722
63034,5857,4874,446,2856,1317,255,1999,2148,302,425,983,98,343,396,146,877,106
63036,370,298,30,109,129,30,61,180,21,36,72,15,52,0,5,49,23
63037,1168,879,128,456,235,60,304,426,97,52,289,49,84,98,58,231,58
63038,1595,1449,68,920,436,25,695,673,65,16,146,23,73,21,29,132,14
63039,309,236,24,122,82,8,69,142,10,15,73,11,38,24,0,38,35
63040,2927,2352,498,1474,338,42,1340,760,156,96,575,127,257,103,88,527,48
63041,97,77,8,44,25,0,35,42,0,0,20,3,8,2,7,10,10
63042,8299,4880,1228,2213,1188,251,1360,1913,931,676,3419,986,1196,838,399,2836,583
63043,9528,6007,1218,2901,1628,260,1986,2804,683,534,3521,1357,1119,748,297,2848,673
63044,5765,3870,526,1787,1285,272,1198,1928,382,362,1895,412,557,554,372,1591,304
63048,879,621,122,286,155,58,213,280,77,51,258,15,43,89,111,223,35
63049,5025,3881,825,2112,790,154,1558,1640,380,303,1144,282,493,284,85,888,256
63050,4608,3636,629,2031,880,96,1437,1530,399,270,972,197,302,352,121,790,182
63051,4709,3688,815,2039,733,101,1563,1394,446,285,1021,201,436,298,86,752,269
63052,6744,5478,1448,2858,1029,143,2233,2094,746,405,1266,264,541,344,117,937,329
63055,663,547,81,298,145,23,215,298,34,0,116,18,28,57,13,100,16
63056,817,619,114,243,220,42,223,316,30,50,198,19,65,69,45,179,19
63060,856,704,122,344,204,34,293,347,49,15,152,29,72,28,23,126,26
63061,80,59,6,28,22,3,18,36,0,5,21,4,5,12,0,12,9
63068,1678,1272,286,585,320,81,523,571,90,88,406,53,124,129,100,363,43
63069,5393,4025,848,2007,1011,159,1551,1796,472,206,1368,334,445,348,241,1163,205
63070,2230,1634,451,751,387,45,581,586,320,147,596,119,236,171,70,498,98
63071,393,284,66,145,57,16,125,106,29,24,109,10,20,54,25,92,17
63072,971,781,132,382,236,31,239,370,91,81,190,17,126,34,13,145,45
63074,7142,3860,935,1635,820,470,954,1519,778,609,3282,791,1265,735,491,2853,429
63077,4326,3193,902,1390,757,144,1344,1348,348,153,1133,191,346,290,306,969,164
63080,4907,3495,800,1487,924,284,1192,1644,402,257,1412,246,368,399,399,1197,215
63084,5114,3717,852,1756,966,143,1459,1508,435,315,1397,312,478,306,301,1172,225
63087,329,225,55,89,70,11,111,91,15,8,104,26,30,48,0,85,19
63088,3558,2163,693,1051,309,110,811,750,382,220,1395,458,501,320,116,1131,264
63089,2017,1597,331,805,350,111,678,637,172,110,420,111,187,89,33,322,98
63090,7968,5779,1160,2744,1549,326,2393,2516,552,318,2189,599,632,467,491,1852,337
63091,527,376,81,170,95,30,131,199,33,13,151,14,29,63,45,147,4
63101,929,207,75,75,46,11,21,47,87,52,722,90,192,263,177,682,40
63102,629,91,36,12,43,0,0,53,11,27,538,177,254,70,37,514,24
63103,2688,464,204,136,91,33,43,120,136,165,2224,669,674,417,464,1879,345
63104,8366,3973,1406,1768,664,135,816,896,1510,751,4393,1242,1833,841,477,3470,923
63105,6254,3022,420,1565,744,293,1221,1366,292,143,3232,1473,723,463,573,2686,546
63106,4303,2338,1015,832,354,137,203,189,1377,569,1965,161,496,803,505,1856,109
63107,5648,3818,1112,1504,947,255,458,614,1494,1252,1830,260,608,640,322,1592,238
63108,10917,3210,915,1259,647,389,494,1267,671,778,7707,2991,2362,1399,955,6676,1031
63109,14136,7049,1649,3226,1442,732,2368,3056,704,921,7087,2020,2179,1422,1466,6175,912
63110,8123,4460,1418,2033,765,244,943,1207,1512,798,3663,1218,1425,644,376,3013,650
63111,9046,4929,1585,2137,856,351,1214,1435,1419,861,4117,800,1567,1016,734,3427,690
63112,9444,4922,1413,1875,1161,473,675,1155,1719,1373,4522,1398,1454,1110,560,3691,831
63113,6116,3536,670,1569,878,419,435,625,1180,1296,2580,332,790,856,602,2305,275
63114,15784,10101,2376,4825,2107,793,2885,3808,2070,1338,5683,1194,2042,1332,1115,4710,973
63115,9905,6208,1201,2477,1916,614,789,1566,1842,2011,3697,294,1189,1216,998,3329,368
63116,20186,11282,3183,5208,1996,895,3621,3630,2162,1869,8904,2198,3102,1956,1648,7488,1416
63117,4715,2359,493,1067,590,209,770,1108,220,261,2356,1010,584,346,416,1967,389
63118,11287,6768,2306,3192,1027,243,1385,1297,2764,1322,4519,1304,1682,997,536,3666,853
63119,14748,8735,1379,4391,1904,1061,3186,3865,852,832,6013,1476,1544,1346,1647,5154,859
63120,4383,3129,810,1193,899,227,308,728,1161,932,1254,88,429,469,268,1122,132
63121,11686,7482,1642,3359,2106,375,1454,2316,1983,1729,4204,1079,1542,1166,417,3571,633
63122,16112,10540,1332,5237,2830,1141,3895,4965,808,872,5572,944,1724,1466,1438,4895,677
63123,22138,13700,2276,5750,4011,1663,4229,6693,1202,1576,8438,1632,2439,2330,2037,7489,949
63124,4228,2789,186,1210,1027,366,1007,1578,86,118,1439,86,215,404,734,1388,51
63125,14174,8843,1643,3824,2466,910,2672,4061,1119,991,5331,932,1570,1451,1378,4688,643
63126,6488,4520,476,1934,1523,587,1486,2452,227,355,1968,287,516,682,483,1751,217
63127,2035,1334,98,637,477,122,431,760,83,60,701,10,117,162,412,622,79
63128,11851,8317,633,3753,3187,744,2677,4698,410,532,3534,825,816,981,912,3080,454
63129,19256,14180,2144,7735,3749,552,5670,6302,1171,1037,5076,1496,1552,1197,831,4227,849
63130,13152,7805,1662,3614,1951,578,2223,2939,1367,1276,5347,2040,1692,1118,497,4004,1343
63131,5983,4971,210,2593,1753,415,2051,2582,208,130,1012,75,266,361,310,894,118
63132,6046,3729,700,1704,1026,299,1069,1491,645,524,2317,703,646,631,337,1887,430
63133,3049,2117,533,870,581,133,322,458,741,596,932,197,320,284,131,763,169
63134,5523,3862,889,1807,940,226,915,1140,1068,739,1661,269,603,624,165,1358,303
63135,8253,5619,1102,2908,1131,478,1695,1902,1307,715,2634,416,1072,631,515,2227,407
63136,19882,14102,3861,6548,3048,645,3054,3241,4893,2914,5780,1048,2007,1696,1029,5183,597
63137,8346,5683,1337,2496,1222,628,1494,2058,1421,710,2663,449,888,643,683,2441,222
63138,8553,5892,1605,2810,1063,414,1585,1689,1700,918,2661,830,782,591,458,2343,318
63139,11712,5599,1409,2544,1010,636,1747,2190,804,858,6113,1915,2190,1003,1005,5111,1002
63140,255,201,53,109,30,9,7,32,105,57,54,9,22,19,4,46,8
63141,7949,5438,496,2548,1879,515,2065,2857,264,252,2511,643,596,728,544,2150,361
63143,5653,2527,740,1157,509,121,705,1030,447,345,3126,1311,1122,411,282,2638,488
63144,4655,2107,505,929,465,208,714,897,196,300,2548,1031,804,435,278,2176,372
63146,13957,7811,1340,3670,2121,680,2512,3945,650,704,6146,2093,1675,1312,1066,5170,976
63147,4570,3065,564,1420,928,153,509,863,874,819,1505,178,674,431,222,1399,106
63301,18355,11838,2317,5413,3375,733,3798,5635,1504,901,6517,1755,1965,1510,1287,5472,1045
63303,16240,11300,2249,6005,2669,377,4656,4884,1111,649,4940,1630,1665,1118,527,3840,1100
63304,12750,10646,1980,6357,1974,335,5393,3779,1044,430,2104,340,802,626,336,1667,437
63330,59,32,9,6,15,2,9,23,0,0,27,0,4,18,5,27,0
63332,448,338,41,177,85,35,153,149,12,24,110,9,46,31,24,95,15
63333,308,247,49,80,88,30,88,107,27,25,61,5,24,17,15,40,21
63334,2319,1639,338,764,389,148,524,796,250,69,680,59,204,240,177,603,77
63336,468,309,60,129,92,28,80,164,51,14,159,16,58,42,43,143,16
63339,325,250,61,118,68,3,123,70,24,33,75,6,17,25,27,59,16
63341,1145,973,95,600,262,16,346,578,33,16,172,17,85,37,33,151,21
63343,1675,1207,231,590,294,92,406,548,203,50,468,57,153,165,93,393,75
63344,542,412,66,207,101,38,164,190,34,24,130,21,31,43,35,104,26
63345,191,137,12,67,44,14,34,81,16,6,54,20,19,8,7,42,12
63347,858,693,188,349,154,2,333,224,98,38,165,27,64,57,17,139,26
63348,1536,1290,203,720,351,16,571,594,87,38,246,20,121,63,42,189,57
63349,480,360,81,147,100,32,148,142,37,33,120,12,28,41,39,111,9
63350,215,159,31,72,42,14,54,84,7,14,56,0,13,25,18,53,3
63351,634,379,75,184,108,12,141,173,41,24,255,31,80,81,63,227,28
63352,500,372,41,186,105,40,100,214,47,11,128,11,44,44,29,111,17
63353,2093,1357,222,617,431,87,405,640,166,146,736,72,219,242,203,665,71
63357,1750,1394,220,687,414,73,540,677,103,74,356,75,93,66,122,296,60
63359,570,399,52,176,150,21,125,213,40,21,171,27,32,70,42,136,35
63361,1728,1208,217,551,330,110,445,533,115,115,520,97,117,142,164,467,53
63362,1551,1188,381,560,209,38,551,411,175,51,363,109,121,99,34,281,82
63363,592,433,73,188,146,26,159,201,44,29,159,23,52,19,65,132,27
63366,19654,15765,4565,8079,2720,401,7714,5608,1700,743,3889,1165,1436,913,375,3092,797
63367,3019,2558,241,1451,761,105,1003,1406,103,46,461,64,178,171,48,382,79
63369,712,547,128,302,88,29,252,203,53,39,165,41,30,33,61,153,12
63370,17,6,0,6,0,0,0,6,0,0,11,6,5,0,0,5,6
63373,258,182,43,67,59,13,81,80,6,15,76,9,29,27,11,62,14
63376,23601,18844,3757,11009,3516,562,8928,7057,1782,1077,4757,1190,1801,1154,612,3835,922
63377,808,566,71,306,151,38,232,280,25,29,242,43,80,54,65,226,16
63379,5493,4182,945,2115,913,209,1599,1764,603,216,1311,249,406,330,326,1090,221
63381,197,155,25,78,41,11,57,69,17,12,42,4,11,9,18,42,0
63382,1540,988,207,449,248,84,300,486,135,67,552,78,108,131,235,503,49
63383,4613,3481,682,1666,924,209,1288,1602,381,210,1132,171,319,333,309,959,173
63384,794,573,119,238,165,51,207,264,69,33,221,36,55,59,71,201,20
63385,4912,3822,822,1888,969,143,1508,1548,540,226,1090,189,402,321,178,853,237
63386,229,144,18,72,43,11,47,70,11,16,85,15,38,17,15,69,16
63387,41,33,12,8,7,6,9,13,8,3,8,0,3,3,2,8,0
63388,246,186,25,106,38,17,53,100,5,28,60,8,15,9,28,39,21
63389,1613,1277,259,664,292,62,524,529,140,84,336,93,106,104,33,265,71
63390,2573,1871,402,897,470,102,641,906,231,93,702,88,286,227,101,557,145
63401,8643,5799,1319,2707,1333,440,2035,2585,787,392,2844,539,757,711,837,2477,367
63430,270,191,35,84,65,7,76,97,16,2,79,5,33,13,28,79,0
63431,161,142,21,78,35,8,47,87,0,8,19,1,13,0,5,14,5
63432,236,167,42,78,24,23,81,78,8,0,69,15,16,16,22,63,6
63433,30,23,16,0,7,0,16,7,0,0,7,0,7,0,0,7,0
63434,190,125,18,60,38,9,35,75,12,3,65,15,24,13,13,61,4
63435,1480,1022,236,441,269,76,391,449,134,48,458,90,119,133,116,404,54
63436,512,351,64,158,97,32,119,175,40,17,161,31,22,64,44,133,28
63437,649,419,84,174,109,52,154,214,39,12,230,27,47,71,85,209,21
63438,220,196,31,73,62,30,27,123,21,25,24,8,0,9,7,11,13
63439,75,65,7,30,18,10,33,30,2,0,10,0,7,1,2,6,4
63440,526,398,65,216,94,23,169,203,24,2,128,24,14,38,52,118,10
63441,439,345,71,164,78,32,132,170,17,26,94,16,24,31,23,82,12
63443,173,115,17,42,43,13,41,59,9,6,58,2,23,10,23,55,3
63445,1611,1113,224,433,371,85,350,601,97,65,498,68,104,151,175,435,63
63446,261,187,27,101,40,19,84,90,12,1,74,8,11,27,28,71,3
63447,435,276,55,138,53,30,79,132,52,13,159,13,19,73,54,141,18
63448,730,480,108,199,133,40,133,231,78,38,250,45,64,71,70,193,57
63450,55,55,1,25,29,0,13,42,0,0,0,0,0,0,0,0,0
63451,124,99,21,48,22,8,54,40,3,2,25,2,11,6,6,25,0
63452,452,310,55,132,100,23,120,148,31,11,142,25,36,44,37,126,16
63453,197,161,41,84,36,0,81,61,13,6,36,7,7,13,9,24,12
63454,317,238,40,114,69,15,82,129,12,15,79,16,32,6,25,67,12
63456,1599,1094,188,476,317,113,426,463,107,98,505,112,145,124,124,449,56
63457,119,85,23,39,11,12,28,49,6,2,34,4,11,17,2,34,0
63458,101,60,2,36,21,1,31,21,2,6,41,12,0,15,14,36,5
63459,1470,1108,217,507,318,66,422,545,72,69,362,48,112,119,83,301,61
63460,134,88,9,45,31,3,29,43,11,5,46,5,13,17,11,38,8
63461,2114,1570,306,694,442,128,603,775,114,78,544,115,115,135,179,508,36
63462,609,414,80,170,125,39,131,237,32,14,195,30,39,53,73,176,19
63463,229,187,47,94,40,6,96,76,15,0,42,11,7,11,13,38,4
63464,28,8,0,4,4,0,4,4,0,0,20,0,0,11,9,16,4
63465,184,132,26,58,37,11,46,78,6,2,52,2,24,20,6,49,3
63468,1252,823,136,337,248,102,272,400,114,37,429,70,107,85,167,396,33
63469,485,353,55,179,90,29,149,169,20,15,132,18,26,28,60,127,5
63471,274,202,56,83,56,7,74,113,15,0,72,16,26,17,13,72,0
63472,235,139,24,66,31,18,38,66,25,10,96,9,21,26,40,83,13
63473,138,83,7,30,46,0,17,59,7,0,55,0,36,12,7,55,0
63474,269,190,25,83,54,28,48,119,7,16,79,7,19,29,24,76,3
63501,8101,4254,1072,1921,944,317,1539,1944,508,263,3847,1957,738,559,593,2680,1167
63530,374,284,56,126,86,16,90,146,28,20,90,14,16,26,34,84,6
63531,234,166,23,57,67,19,54,92,1,19,68,0,23,41,4,63,5
63532,536,363,94,142,103,24,134,151,38,40,173,23,42,57,51,151,22
63533,314,223,29,116,62,16,93,98,4,28,91,11,22,25,33,83,8
63534,348,225,34,111,53,27,69,122,19,15,123,25,54,23,21,101,22
63535,50,38,0,20,18,0,7,28,0,3,12,0,0,6,6,12,0
63536,335,230,38,93,72,27,78,113,26,13,105,18,15,26,46,100,5
63537,763,517,88,220,152,57,141,283,53,40,246,39,63,66,78,236,10
63538,127,87,13,34,34,6,31,49,5,2,40,6,9,12,13,35,5
63539,134,92,14,19,39,20,18,57,7,10,42,2,3,15,22,39,3
63540,63,55,12,23,14,6,14,32,3,6,8,2,4,2,0,8,0
63541,189,138,26,59,35,18,50,71,17,0,51,1,0,22,28,40,11
63543,153,106,19,48,29,10,40,46,14,6,47,2,14,15,16,44,3
63544,325,227,47,82,69,29,80,126,5,16,98,9,33,27,29,90,8
63545,522,351,57,139,106,49,107,184,28,32,171,14,61,42,54,162,9
63546,596,425,68,194,133,30,132,256,26,11,171,30,35,60,46,157,14
63547,234,166,24,84,42,16,65,85,10,6,68,6,16,36,10,56,12
63548,498,366,55,147,121,43,144,171,26,25,132,26,24,41,41,120,12
63549,1008,679,146,262,199,72,241,317,76,45,329,58,57,102,112,282,47
63551,172,134,15,50,56,13,53,70,6,5,38,11,14,0,13,27,11
63552,3292,2132,348,956,622,206,651,1052,283,146,1160,195,254,359,352,1048,112
63555,1315,883,165,407,226,85,327,424,84,48,432,52,90,112,178,396,36
63556,1524,1023,260,442,239,82,348,455,130,90,501,49,135,131,186,445,56
63557,109,91,18,31,31,11,30,55,2,4,18,0,8,7,3,17,1
63558,338,230,23,112,74,21,84,116,14,16,108,10,28,34,36,101,7
63559,626,458,107,201,123,27,157,220,56,25,168,26,52,47,43,153,15
63560,131,87,30,27,17,13,23,46,11,7,44,0,18,17,9,31,13
63561,439,305,50,132,95,28,99,156,36,14,134,26,23,26,59,128,6
63563,210,167,41,42,59,25,52,95,4,16,43,3,4,9,27,43,0
63565,1731,1144,227,441,375,101,367,603,128,46,587,97,118,162,210,538,49
63566,35,21,7,6,4,4,9,10,2,0,14,2,2,8,2,12,2
63567,65,48,16,20,4,8,13,27,6,2,17,8,1,6,2,8,9
63601,6157,4347,1096,1975,1013,263,1426,1741,712,468,1810,324,455,641,390,1559,251
63620,575,403,77,177,121,28,134,217,33,19,172,20,49,72,31,155,17
63621,516,365,72,144,118,31,122,183,33,27,151,7,33,61,50,141,10
63622,352,265,58,123,56,28,116,117,20,12,87,9,24,28,26,82,5
63623,295,208,26,88,74,20,69,94,26,19,87,22,25,25,15,81,6
63624,1412,1064,220,478,289,77,345,501,138,80,348,43,117,105,83,295,53
63625,172,144,16,60,57,11,33,93,12,6,28,3,6,11,8,24,4
63626,65,56,20,28,8,0,33,15,8,0,9,0,0,9,0,9,0
63627,1033,808,139,434,208,27,363,331,92,22,225,50,74,53,48,174,51
63628,4535,3392,761,1485,937,209,1179,1646,378,189,1143,131,274,457,281,1013,130
63629,571,409,98,183,119,9,171,166,42,30,162,14,48,70,30,138,24
63630,1498,1123,307,544,238,34,409,440,205,69,375,99,114,118,44,309,66
63631,393,294,76,120,82,16,109,139,34,12,99,16,17,46,20,90,9
63633,312,216,47,88,67,14,75,99,24,18,96,8,31,43,14,91,5
63636,263,176,46,73,47,10,62,86,21,7,87,8,19,40,20,65,22
63637,304,246,40,133,54,19,82,83,56,25,58,16,33,9,0,51,7
63638,1222,831,188,326,267,50,281,432,80,38,391,47,101,135,108,355,36
63640,7904,5423,1070,2451,1348,554,1777,2600,623,423,2481,517,723,728,513,2162,319
63645,4322,2996,633,1277,848,238,1031,1454,342,169,1326,101,363,462,400,1160,166
63648,492,375,84,164,112,15,142,183,28,22,117,29,27,51,10,112,5
63650,1736,1237,240,566,349,82,416,599,166,56,499,58,141,181,119,422,77
63653,382,292,92,132,55,13,111,106,44,31,90,7,19,30,34,86,4
63654,235,170,30,70,61,9,45,91,14,20,65,2,24,22,17,62,3
63655,567,424,102,187,118,17,164,175,40,45,143,22,36,49,36,124,19
63656,180,145,35,49,54,7,47,81,4,13,35,2,10,12,11,32,3
63660,1151,922,246,406,224,46,340,372,121,89,229,26,81,75,47,208,21
63662,435,321,92,127,74,28,121,162,32,6,114,7,29,37,41,108,6
63663,255,171,43,65,49,14,31,85,37,18,84,27,17,24,16,70,14
63664,3322,2370,514,1057,653,146,785,1063,336,186,952,162,238,334,218,818,134
63665,98,78,10,23,33,12,28,43,2,5,20,5,5,3,7,20,0
63670,4306,3203,526,1672,768,237,1183,1493,362,165,1103,168,274,311,350,975,128
63673,765,596,89,245,196,66,211,308,34,43,169,18,81,48,22,140,29
63674,50,37,24,13,0,0,32,0,0,5,13,7,0,6,0,13,0
63675,70,48,7,20,16,5,14,28,2,4,22,5,8,6,3,22,0
63701,13277,8383,1822,3730,2186,645,2914,4026,816,627,4894,2018,1339,856,681,3827,1067
63703,3593,1903,586,784,376,157,445,722,523,213,1690,376,459,397,458,1433,257
63730,1369,972,158,429,287,98,324,502,78,68,397,50,78,139,130,345,52
63732,249,195,33,76,64,22,70,93,8,24,54,11,10,11,22,51,3
63735,361,244,68,101,57,18,89,89,38,28,117,17,31,35,34,112,5
63736,1139,885,204,445,186,50,373,376,102,34,254,62,55,86,51,214,40
63738,40,15,0,6,9,0,0,0,6,9,25,0,0,0,25,25,0
63739,212,184,44,62,69,9,74,88,7,15,28,6,22,0,0,22,6
63740,2193,1509,344,683,363,119,543,618,229,119,684,113,159,229,183,629,55
63742,38,24,2,15,7,0,8,12,0,4,14,0,6,4,4,14,0
63743,12,12,0,8,2,2,6,6,0,0,0,0,0,0,0,0,0
63747,131,106,26,54,20,6,60,43,1,2,25,2,6,10,7,25,0
63748,463,341,34,145,116,46,118,184,9,30,122,17,36,29,40,111,11
63750,46,34,6,10,16,2,8,20,2,4,12,0,3,7,2,12,0
63751,396,316,66,124,103,23,81,192,33,10,80,0,27,36,17,77,3
63753,94,83,10,40,26,7,42,35,6,0,11,0,1,6,4,11,0
63755,7868,5974,1236,3065,1350,323,2402,2669,664,239,1894,439,508,463,484,1675,219
63758,88,51,15,16,12,8,7,32,7,5,37,7,18,5,7,33,4
63760,242,196,37,104,41,14,90,77,13,16,46,4,9,10,23,44,2
63763,39,27,0,5,22,0,13,6,0,8,12,0,0,12,0,8,4
63764,2240,1654,346,756,439,113,557,835,161,101,586,66,123,254,143,512,74
63766,350,266,51,143,65,7,110,127,22,7,84,8,35,17,24,81,3
63767,331,226,64,98,46,18,86,89,32,19,105,10,28,42,25,90,15
63769,528,439,53,225,128,33,116,278,19,26,89,14,19,33,23,81,8
63770,44,33,15,8,8,2,12,18,2,1,11,1,2,2,6,9,2
63771,1101,816,191,394,168,63,298,389,85,44,285,27,62,107,89,256,29
63774,58,41,12,14,9,6,15,16,4,6,17,0,4,5,8,17,0
63775,6103,4325,1018,1947,1050,310,1659,1982,454,230,1778,360,452,451,515,1515,263
63780,2515,1920,431,895,482,112,681,869,224,146,595,74,145,202,174,553,42
63781,383,324,50,166,80,28,128,168,13,15,59,8,13,17,21,53,6
63782,133,114,20,65,24,5,50,50,10,4,19,6,7,6,0,17,2
63783,59,44,0,29,11,4,11,30,0,3,15,0,7,0,8,12,3
63784,102,76,9,36,20,11,28,29,10,9,26,0,7,9,10,23,3
63785,309,263,72,107,58,26,118,123,10,12,46,6,14,14,12,38,8
63787,292,197,42,100,41,14,65,95,22,15,95,12,20,44,19,93,2
63801,9283,6638,1561,3020,1561,496,2012,2873,1170,583,2645,449,740,881,575,2380,265
63820,120,94,16,32,40,6,25,54,9,6,26,2,9,10,5,26,0
63821,416,270,56,108,79,27,71,139,42,18,146,7,48,35,56,130,16
63822,1184,812,163,394,195,60,268,399,106,39,372,43,75,123,131,325,47
63823,456,340,51,147,114,28,60,217,44,19,116,14,32,35,35,109,7
63824,52,40,9,15,11,5,15,21,0,4,12,0,5,7,0,7,5
63825,1675,1260,283,554,330,93,380,644,145,91,415,62,79,152,122,384,31
63826,58,40,9,17,8,6,12,14,9,5,18,3,4,2,9,14,4
63827,450,344,82,146,99,17,135,129,35,45,106,20,29,20,37,89,17
63828,125,93,31,34,28,0,40,30,20,3,32,5,3,11,13,27,5
63829,551,376,82,159,104,31,111,170,53,42,175,35,43,44,53,164,11
63830,2983,1994,597,813,484,100,552,726,545,171,989,107,333,291,258,874,115
63833,117,91,12,45,34,0,26,57,2,6,26,0,4,12,10,26,0
63834,2348,1625,353,729,455,88,413,650,383,179,723,92,165,224,242,687,36
63837,685,474,138,205,108,23,152,185,85,52,211,25,48,95,43,183,28
63839,206,145,46,47,38,14,55,55,16,19,61,5,17,31,8,48,13
63841,5413,3725,759,1618,1020,328,1206,1910,409,200,1688,328,427,518,415,1513,175
63845,2409,1653,453,610,488,102,467,724,277,185,756,100,171,254,231,678,78
63846,597,440,110,165,119,46,178,194,35,33,157,13,33,59,52,146,11
63847,42,33,8,22,3,0,13,7,8,5,9,0,7,2,0,2,7
63848,612,428,100,195,97,36,144,199,67,18,184,26,43,64,51,164,20
63849,109,83,4,53,18,8,33,32,11,7,26,2,5,8,11,24,2
63850,24,20,0,15,2,3,5,4,4,7,4,0,2,2,0,3,1
63851,1863,1180,321,495,271,93,246,402,310,222,683,63,164,257,199,618,65
63852,603,441,77,205,123,36,158,198,45,40,162,14,35,64,49,143,19
63853,88,68,21,32,12,3,34,25,7,2,20,0,11,6,3,18,2
63855,486,334,69,151,97,17,113,175,17,29,152,22,49,41,40,131,21
63857,5269,3602,956,1526,866,254,1109,1556,628,309,1667,284,359,594,430,1499,168
63860,75,45,6,19,20,0,0,33,12,0,30,5,16,0,9,25,5
63862,699,486,100,247,105,34,170,177,84,55,213,19,55,70,69,191,22
63863,2775,1942,462,758,587,135,596,906,247,193,833,102,230,286,215,765,68
63866,279,180,51,64,49,16,43,68,47,22,99,13,30,35,21,79,20
63867,419,307,70,117,95,25,102,161,31,13,112,8,33,35,36,99,13
63868,452,295,78,103,89,25,105,144,11,35,157,19,19,83,36,136,21
63869,1634,1147,275,522,279,71,321,429,274,123,487,76,130,155,126,457,30
63870,497,377,88,166,98,25,120,176,54,27,120,20,25,40,35,117,3
63873,2078,1473,297,657,425,94,484,641,236,112,605,71,144,207,183,547,58
63874,161,110,20,53,30,7,41,49,8,12,51,11,11,23,6,47,4
63876,967,649,152,258,173,66,183,338,70,58,318,33,66,128,91,276,42
63877,1656,1150,297,440,307,106,286,509,249,106,506,65,122,179,140,454,52
63878,74,60,15,14,28,3,10,23,21,6,14,2,0,9,3,9,5
63879,355,252,53,116,55,28,66,118,43,25,103,6,38,25,34,88,15
63880,12,8,5,1,2,0,5,2,1,0,4,2,0,0,2,4,0
63882,242,151,42,29,57,23,34,54,34,29,91,8,24,35,24,80,11
63901,13341,9019,1989,3909,2411,710,2830,4170,1248,771,4322,631,1152,1510,1029,3775,547
63932,538,402,54,218,102,28,157,173,43,29,136,19,35,49,33,104,32
63933,1563,1069,256,413,299,101,357,494,141,77,494,58,93,193,150,443,51
63934,32,19,8,11,0,0,19,0,0,0,13,0,7,0,6,13,0
63935,3805,2681,554,1124,791,212,892,1333,270,186,1124,118,242,453,311,1023,101
63936,377,279,73,110,57,39,67,140,42,30,98,24,35,17,22,84,14
63937,1048,798,144,364,234,56,259,387,82,70,250,19,64,119,48,223,27
63938,17,17,5,7,0,5,5,12,0,0,0,0,0,0,0,0,0
63939,599,442,85,166,138,53,167,222,22,31,157,15,33,83,26,134,23
63940,557,394,101,155,106,32,166,174,21,33,163,7,53,54,49,141,22
63941,204,140,8,77,40,15,47,59,17,17,64,7,20,27,10,64,0
63942,269,200,19,96,76,9,63,118,13,6,69,10,14,26,19,56,13
63943,319,250,88,77,76,9,79,129,29,13,69,0,30,35,4,65,4
63944,532,374,77,147,138,12,117,193,33,31,158,23,16,70,49,143,15
63945,466,330,87,144,99,0,141,154,15,20,136,22,50,52,12,131,5
63947,78,42,8,17,17,0,18,24,0,0,36,8,0,14,14,32,4
63951,168,152,26,50,60,16,31,111,5,5,16,0,16,0,0,16,0
63952,225,174,24,74,66,10,40,88,30,16,51,2,20,23,6,48,3
63953,709,512,95,231,158,28,170,225,59,58,197,27,43,73,54,178,19
63954,557,396,112,161,114,9,115,160,81,40,161,35,44,53,29,141,20
63955,110,70,14,26,30,0,15,26,16,13,40,12,9,16,3,40,0
63956,350,249,32,108,78,31,89,105,30,25,101,4,34,44,19,86,15
63957,2296,1620,274,618,563,165,385,881,218,136,676,53,145,277,201,612,64
63960,1189,827,182,331,253,61,250,465,77,35,362,14,78,156,114,329,33
63961,685,452,76,187,148,41,124,224,46,58,233,15,48,104,66,226,7
63963,59,59,5,14,29,11,13,40,0,6,0,0,0,0,0,0,0
63964,486,315,36,123,121,35,60,219,18,18,171,5,19,84,63,160,11
63965,1096,720,135,335,229,21,245,356,83,36,376,41,82,133,120,331,45
63966,1083,696,61,330,273,32,180,413,88,15,387,27,88,219,53,316,71
63967,672,453,54,202,160,37,128,263,35,27,219,18,86,69,46,187,32
64001,260,191,19,83,84,5,42,123,7,19,69,7,9,23,30,66,3
64011,1312,1027,165,548,269,45,345,505,128,49,285,53,96,103,33,225,60
64012,9386,6958,1686,3460,1556,256,2646,2969,963,380,2428,487,895,729,317,2022,406
64014,8224,6378,1662,3509,1082,125,2760,2342,882,394,1846,497,656,380,313,1473,373
64015,10550,8183,1772,4478,1772,161,3453,3315,875,540,2367,639,814,601,313,1917,450
64016,1509,1187,255,570,288,74,412,520,156,99,322,53,95,132,42,278,44
64017,181,129,25,64,39,1,52,62,10,5,52,0,11,22,19,48,4
64018,337,270,33,136,81,20,100,148,15,7,67,30,15,16,6,40,27
64019,837,640,154,305,149,32,238,291,79,32,197,39,60,57,41,176,21
64020,1358,985,172,436,261,116,331,503,86,65,373,73,72,103,125,330,43
64021,349,236,36,117,46,37,89,109,17,21,113,7,43,44,19,93,20
64022,61,52,15,19,12,6,29,20,1,2,9,0,0,9,0,7,2
64024,6012,4394,1042,2088,1088,176,1598,1973,509,314,1618,259,477,585,297,1362,256
64029,2990,2345,736,1208,363,38,1134,909,209,93,645,208,227,146,64,514,131
64030,9727,6506,1573,3006,1637,290,1947,2631,1231,697,3221,1004,1193,694,330,2666,555
64034,2075,1753,433,933,355,32,800,723,136,94,322,87,151,48,36,263,59
64035,410,296,64,120,75,37,125,137,19,15,114,9,25,42,38,106,8
64036,128,88,18,37,22,11,33,33,7,15,40,6,9,16,9,33,7
64037,2307,1562,385,618,471,88,583,721,177,81,745,78,221,235,211,667,78
64040,2281,1705,296,781,538,90,615,853,161,76,576,95,211,132,138,479,97
64048,1439,1167,152,571,398,46,442,592,49,84,272,29,135,77,31,233,39
64050,9772,6050,1379,2743,1443,485,1678,2469,1078,825,3722,624,1118,1030,950,3257,465
64052,9562,5485,1149,2247,1468,621,1387,2692,766,640,4077,840,1536,955,746,3414,663
64053,2535,1441,382,634,292,133,367,522,342,210,1094,251,468,232,143,888,206
64054,1830,1072,213,495,312,52,298,455,143,176,758,175,271,195,117,607,151
64055,14776,9702,1727,3966,3124,885,2700,5199,944,859,5074,1132,1492,1401,1049,4430,644
64056,5373,4256,1183,2046,866,161,1466,1592,885,313,1117,217,334,333,233,923,194
64057,4290,3092,521,1620,794,157,1194,1395,319,184,1198,291,348,311,248,990,208
64058,2084,1707,301,949,400,57,614,792,198,103,377,61,149,126,41,298,79
64060,3377,2853,592,1625,583,53,1362,1114,245,132,524,125,151,134,114,465,59
64061,979,803,135,423,215,30,255,471,37,40,176,16,75,46,39,123,53
64062,2051,1618,296,809,427,86,689,751,133,45,433,55,142,127,109,400,33
64063,7755,5485,1602,2718,920,245,2385,1935,836,329,2270,662,849,467,292,1887,383
64064,4200,3374,475,1909,919,71,1360,1645,227,142,826,170,385,236,35,675,151
64066,29,22,5,9,8,0,10,10,0,2,7,0,2,0,5,7,0
64067,2307,1626,319,768,439,100,475,716,268,167,681,99,147,208,227,612,69
64068,12099,8878,2002,4597,1935,344,3437,3707,1140,594,3221,692,1180,831,518,2656,565
64070,869,675,117,349,183,26,271,320,38,46,194,34,96,34,30,163,31
64071,290,245,39,140,63,3,122,108,15,0,45,5,6,22,12,35,10
64072,49,30,8,11,6,5,7,13,8,2,19,6,10,3,0,13,6
64074,216,168,26,85,49,8,55,98,7,8,48,9,9,13,17,44,4
64075,3235,2570,648,1208,647,67,1024,1061,315,170,665,129,236,151,149,551,114
64076,3268,2431,580,1008,676,167,908,1088,308,127,837,197,218,191,231,697,140
64077,747,585,128,260,165,32,227,258,56,44,162,27,52,51,32,139,23
64078,2463,2066,311,1143,525,87,816,972,201,77,397,63,155,85,94,322,75
64079,3055,2381,524,1299,454,104,966,984,279,152,674,129,274,144,127,576,98
64080,3625,2795,594,1415,664,122,1179,1285,243,88,830,127,299,261,143,667,163
64081,7105,4756,773,2668,915,400,2110,2095,340,211,2349,241,325,581,1202,2181,168
64082,1964,1696,216,994,450,36,754,766,137,39,268,32,150,77,9,213,55
64083,4626,3651,792,1839,789,231,1590,1587,343,131,975,110,220,299,346,863,112
64084,529,439,62,186,170,21,100,287,36,16,90,18,57,15,0,74,16
64085,3528,2418,578,1097,554,189,869,1120,298,131,1110,153,324,320,313,981,129
64086,7213,5571,1214,3214,996,147,2608,2061,628,274,1642,487,790,263,102,1286,356
64088,504,408,91,192,98,27,173,184,29,22,96,5,27,43,21,77,19
64089,2824,2218,480,1179,460,99,961,951,227,79,606,116,223,148,119,527,79
64090,35,27,7,15,5,0,12,9,6,0,8,0,2,3,3,8,0
64093,8921,5316,1532,2499,1062,223,2104,2195,739,278,3605,1874,687,631,413,2356,1249
64096,418,302,57,134,94,17,111,156,23,12,116,17,24,41,34,102,14
64097,618,425,80,187,130,28,150,214,46,15,193,26,58,54,55,172,21
64098,1158,836,123,426,231,56,280,422,99,35,322,31,128,94,69,288,34
64101,17,17,10,7,0,0,0,0,17,0,0,0,0,0,0,0,0
64102,0,0,0,0,0,0,0,0,0,0,0,0,0,0,0,0,0
64105,1962,310,205,58,24,23,40,199,26,45,1652,823,512,194,123,1402,250
64106,2298,1053,355,416,243,39,183,173,488,209,1245,300,459,298,188,1174,71
64108,2757,1305,514,494,203,94,259,332,444,270,1452,542,492,247,171,1199,253
64109,5200,2433,717,1116,425,175,467,629,846,491,2767,708,1054,634,371,2219,548
64110,7135,3845,1254,1681,735,175,696,1077,1286,786,3290,871,1539,623,257,2487,803
64111,10256,2630,992,988,475,175,611,1055,416,548,7626,3523,2621,1000,482,6140,1486
64112,5632,1420,370,510,421,119,283,968,71,98,4212,2239,1080,526,367,3474,738
64113,4725,3233,571,1787,693,182,1273,1642,145,173,1492,294,579,321,298,1163,329
64114,11969,5831,1260,2341,1415,815,1547,3142,461,681,6138,1382,1954,1239,1563,5200,938
64116,7504,3943,1000,1714,942,287,1169,1799,578,397,3561,1213,1174,659,515,3001,560
64117,5602,3605,1144,1455,761,245,1019,1442,779,365,1997,584,735,445,233,1616,381
64118,16627,10687,2688,4847,2439,713,3427,4944,1346,970,5940,2072,1911,1219,738,4793,1147
64119,10262,7310,1445,3501,2006,358,2598,3433,734,545,2952,827,1057,682,386,2480,472
64120,206,99,38,20,30,11,31,14,14,40,107,0,46,34,27,101,6
64123,3854,2434,650,1085,556,143,748,859,477,350,1420,252,465,343,360,1179,241
64124,4804,2963,923,1327,571,142,835,841,830,457,1841,402,710,513,216,1468,373
64125,815,549,175,261,72,41,191,139,135,84,266,65,134,45,22,189,77
64126,2464,1565,526,732,221,86,458,347,533,227,899,148,335,278,138,751,148
64127,7667,4871,1423,2182,945,321,1034,1056,1609,1172,2796,367,1079,976,374,2442,354
64128,5666,3600,925,1498,778,399,500,866,1366,868,2066,176,654,794,442,1881,185
64129,4045,2587,735,1138,583,131,740,875,559,413,1458,430,536,384,108,1144,314
64130,9950,6494,1379,2595,2040,480,926,1651,2017,1900,3456,418,1129,1329,580,3072,384
64131,10333,5745,1635,2587,1232,291,1361,2144,1418,822,4588,1323,1650,1007,608,3775,813
64132,6202,4069,1221,1792,866,190,784,929,1538,818,2133,506,760,665,202,1843,290
64133,14770,9513,1610,4117,2712,1074,2621,4553,1177,1162,5257,988,1770,1259,1240,4518,739
64134,8854,6187,1703,2822,1369,293,1776,2251,1431,729,2667,745,1016,635,271,2130,537
64136,467,297,62,151,84,0,130,103,47,17,170,33,34,26,77,142,28
64137,4033,2600,498,1270,679,153,684,1190,409,317,1433,470,384,376,203,1203,230
64138,10140,6715,1341,3154,1776,444,2010,2764,1075,866,3425,847,1231,895,452,2963,462
64139,258,206,55,80,67,4,80,108,8,10,52,1,21,13,17,48,4
64145,1776,1206,147,495,444,120,333,658,135,80,570,54,108,195,213,514,56
64146,712,395,37,187,96,75,72,238,37,48,317,30,80,142,65,293,24
64147,246,186,174,6,0,6,0,19,167,0,60,46,14,0,0,60,0
64149,105,99,13,40,33,13,30,62,7,0,6,0,0,6,0,0,6
64150,1187,661,217,308,120,16,170,239,174,78,526,128,209,133,56,419,107
64151,9650,6231,1258,3281,1389,303,2233,2875,751,372,3419,1174,1206,606,433,2797,622
64152,8625,6632,1207,3776,1419,230,2783,2787,686,376,1993,526,848,479,140,1607,386
64153,1465,953,292,507,111,43,417,379,100,57,512,267,184,34,27,404,108
64154,2046,1174,339,579,227,29,385,514,169,106,872,291,211,167,203,709,163
64155,6095,4776,1041,2830,801,104,2325,1881,369,201,1319,589,466,203,61,1057,262
64156,449,326,105,146,69,6,90,173,54,9,123,15,52,46,10,104,19
64157,957,856,327,431,98,0,487,273,77,19,101,39,53,9,0,59,42
64158,792,650,295,331,24,0,435,179,28,8,142,61,65,8,8,84,58
64161,180,124,38,37,40,9,38,50,20,16,56,26,14,9,7,40,16
64163,343,161,41,84,31,5,72,57,16,16,182,59,87,21,15,147,35
64164,96,56,4,22,30,0,17,30,9,0,40,8,12,7,13,35,5
64165,25,13,0,0,6,7,0,13,0,0,12,0,12,0,0,5,7
64166,93,86,15,41,30,0,41,45,0,0,7,0,0,7,0,7,0
64167,134,117,20,73,24,0,93,24,0,0,17,0,0,17,0,6,11
64192,7,7,7,0,0,0,0,0,0,7,0,0,0,0,0,0,0
64401,518,391,77,177,120,17,159,180,34,18,127,13,34,58,22,105,22
64402,1108,715,120,294,225,76,241,364,66,44,393,27,95,128,143,382,11
64421,349,249,48,127,65,9,104,114,13,18,100,11,45,24,20,86,14
64422,152,120,28,56,28,8,47,63,10,0,32,6,5,10,11,32,0
64423,302,211,35,89,68,19,79,116,9,7,91,18,19,26,28,77,14
64424,1752,1190,234,446,356,154,355,656,123,56,562,81,90,200,191,547,15
64426,177,126,25,50,37,14,33,58,22,13,51,6,14,10,21,44,7
64427,232,183,29,96,40,18,64,99,16,4,49,14,17,14,4,39,10
64428,421,316,62,153,64,37,117,152,31,16,105,19,24,30,32,94,11
64429,3278,2265,495,1017,591,162,870,1025,272,98,1013,188,235,246,344,864,149
64430,315,231,42,112,64,13,97,117,13,4,84,11,26,21,26,75,9
64431,193,121,25,36,47,13,34,71,11,5,72,11,11,30,20,66,6
64432,27,25,2,15,8,0,10,13,0,2,2,0,0,0,2,2,0
64433,21,7,0,3,4,0,3,0,0,4,14,0,7,5,2,12,2
64434,161,122,16,68,28,10,52,53,15,2,39,4,4,17,14,37,2
64436,338,265,46,131,62,26,107,138,3,17,73,4,24,35,10,68,5
64437,416,291,37,130,85,39,87,154,27,23,125,14,27,45,39,117,8
64438,89,73,18,20,25,10,29,39,4,1,16,2,4,10,0,10,6
64439,578,417,61,194,122,40,129,220,38,30,161,30,36,58,37,133,28
64440,280,213,56,73,66,18,86,113,8,6,67,5,20,22,20,57,10
64441,80,58,6,31,16,5,11,31,10,6,22,10,2,8,2,22,0
64442,344,248,31,103,93,21,80,140,10,18,96,18,15,37,26,85,11
64443,440,343,72,133,103,35,108,188,29,18,97,9,25,39,24,82,15
64444,577,451,69,243,111,28,178,237,18,18,126,14,31,36,45,105,21
64445,149,91,13,38,32,8,35,40,6,10,58,4,11,18,25,54,4
64446,502,353,46,181,91,35,132,173,29,19,149,19,24,53,53,140,9
64448,432,330,58,184,78,10,127,152,43,8,102,20,40,35,7,71,31
64449,197,116,35,48,22,11,47,46,17,6,81,20,31,25,5,50,31
64451,210,152,30,66,44,12,53,77,8,14,58,6,12,28,12,46,12
64453,90,60,7,41,9,3,25,28,7,0,30,9,10,8,3,30,0
64454,864,660,121,346,150,43,298,296,45,21,204,23,53,65,63,163,41
64455,198,154,17,72,55,10,58,76,7,13,44,8,10,12,14,40,4
64456,688,477,71,193,156,57,157,253,44,23,211,40,39,57,75,197,14
64457,134,110,30,57,15,8,63,35,6,6,24,0,9,6,9,23,1
64458,80,65,11,24,28,2,14,28,11,12,15,0,5,6,4,15,0
64459,200,129,23,46,38,22,32,73,8,16,71,18,35,9,9,54,17
64461,418,308,69,134,74,31,112,151,32,13,110,17,24,32,37,102,8
64463,650,465,88,190,118,69,178,231,41,15,185,24,38,41,82,176,9
64465,1545,1197,248,574,333,42,468,544,137,48,348,49,90,117,92,297,51
64466,224,152,21,86,27,18,51,75,18,8,72,10,21,14,27,66,6
64467,75,58,7,18,33,0,14,37,7,0,17,7,2,0,8,17,0
64468,5057,2693,627,1229,622,215,996,1226,276,195,2364,1246,366,319,433,1634,730
64469,828,589,87,292,144,66,228,279,60,22,239,50,55,67,67,210,29
64470,744,469,65,201,147,56,130,266,56,17,275,25,43,76,131,261,14
64471,223,158,25,70,37,26,51,91,7,9,65,8,16,17,24,58,7
64473,623,439,73,201,94,71,146,212,51,30,184,44,46,35,59,169,15
64474,359,269,57,116,77,19,98,132,30,9,90,9,30,23,28,84,6
64475,214,124,23,57,34,10,49,54,10,11,90,27,8,25,30,76,14
64476,172,120,27,41,39,13,44,74,1,1,52,14,8,24,6,41,11
64477,1267,908,161,442,246,59,308,409,107,84,359,25,135,87,112,322,37
64479,366,272,54,143,51,24,105,137,19,11,94,21,14,27,32,77,17
64480,149,114,21,43,36,14,41,62,5,6,35,5,14,8,8,25,10
64481,472,334,56,134,96,48,93,171,38,32,138,13,30,44,51,127,11
64482,992,630,84,255,192,99,171,375,38,46,362,64,66,99,133,330,32
64483,245,186,40,89,45,12,72,83,22,9,59,11,14,19,15,46,13
64484,470,353,91,156,90,16,138,154,36,25,117,13,47,33,24,97,20
64485,2922,2116,481,953,462,220,758,981,272,105,806,113,190,260,243,747,59
64486,177,102,19,42,25,16,36,43,11,12,75,3,20,26,26,72,3
64487,350,233,38,124,61,10,95,102,28,8,117,15,39,38,25,106,11
64489,733,547,84,239,172,52,231,262,31,23,186,24,18,51,93,180,6
64490,779,609,98,291,191,29,234,300,36,39,170,18,39,51,62,155,15
64491,938,605,108,263,173,61,172,310,86,37,333,57,71,104,101,296,37
64492,459,347,43,184,107,13,101,194,42,10,112,6,37,50,19,100,12
64493,212,178,51,67,54,6,64,100,8,6,34,1,7,11,15,32,2
64494,401,270,48,123,77,22,98,136,21,15,131,22,37,32,40,112,19
64496,79,47,2,23,14,8,17,28,2,0,32,12,6,11,3,26,6
64497,181,143,46,62,29,6,86,48,3,6,38,6,14,5,13,34,4
64498,174,131,27,48,38,18,53,56,12,10,43,14,14,11,4,36,7
64499,69,47,12,29,4,2,19,23,5,0,22,1,10,9,2,17,5
64501,4969,2813,992,1176,442,203,873,929,710,301,2156,489,702,559,406,1827,329
64503,4857,3400,863,1514,810,213,1123,1422,549,306,1457,234,463,483,277,1292,165
64504,4230,2980,657,1383,701,239,1057,1225,427,271,1250,229,322,413,286,1044,206
64505,4728,3372,853,1535,797,187,1180,1452,551,189,1356,255,464,300,337,1106,250
64506,8469,5324,994,2355,1404,571,1690,2698,588,348,3145,887,699,709,850,2628,517
64507,5404,3513,861,1564,784,304,1166,1510,493,344,1891,348,497,494,552,1610,281
64601,4671,3062,584,1387,802,289,1053,1454,355,200,1609,253,411,467,478,1469,140
64620,161,113,27,52,32,2,46,55,10,2,48,12,5,25,6,37,11
64622,288,218,23,95,72,28,78,130,4,6,70,10,11,25,24,61,9
64623,304,232,30,109,72,21,90,130,8,4,72,6,24,19,23,61,11
64624,674,463,87,211,131,34,152,206,70,35,211,36,61,60,54,183,28
64625,294,203,59,74,52,18,57,93,30,23,91,11,28,31,21,80,11
64628,2636,1691,310,703,521,157,551,778,201,161,945,123,248,232,342,858,87
64630,309,217,27,91,80,19,54,119,24,20,92,9,25,34,24,78,14
64631,460,304,47,120,94,43,75,179,36,14,156,14,37,47,58,137,19
64632,346,236,37,108,78,13,93,120,11,12,110,12,22,44,32,102,8
64633,2285,1526,363,560,419,184,581,714,130,101,759,72,222,228,237,698,61
64635,206,142,35,59,41,7,49,68,20,5,64,6,14,23,21,59,5
64636,102,74,13,23,32,6,20,36,14,4,28,2,8,13,5,23,5
64637,266,183,23,74,62,24,56,96,8,23,83,5,15,34,29,77,6
64638,251,180,29,92,51,8,76,97,7,0,71,11,25,19,16,68,3
64639,96,73,8,32,25,8,22,35,8,8,23,10,4,5,4,20,3
64640,1368,955,171,362,310,112,329,514,77,35,413,97,98,87,131,384,29
64641,309,208,40,84,68,16,70,105,26,7,101,18,33,19,31,91,10
64642,341,238,39,106,80,13,77,131,16,14,103,22,23,22,36,94,9
64643,435,319,43,133,106,37,110,183,15,11,116,32,22,29,33,92,24
64644,1162,801,185,347,179,90,316,360,88,37,361,64,90,94,113,322,39
64645,117,89,21,33,27,8,33,42,7,7,28,3,9,2,14,24,4
64646,154,116,13,64,32,7,40,46,9,21,38,4,8,13,13,36,2
64647,131,92,10,38,39,5,25,54,5,8,39,5,11,13,10,34,5
64648,675,502,118,197,143,44,211,219,33,39,173,26,23,61,63,154,19
64649,276,216,42,104,48,22,79,116,21,0,60,21,10,18,11,54,6
64650,266,186,30,92,55,9,60,99,17,10,80,17,22,22,19,72,8
64651,333,247,39,127,69,12,61,142,24,20,86,7,26,24,29,78,8
64652,201,140,15,51,63,11,46,78,2,14,61,6,14,23,18,59,2
64653,295,200,50,93,40,17,82,86,17,15,95,19,21,27,28,81,14
64655,116,80,0,54,19,7,29,50,1,0,36,2,11,5,18,32,4
64656,158,110,34,39,29,8,37,48,17,8,48,2,10,18,18,40,8
64657,167,131,29,49,39,14,44,60,17,10,36,2,14,7,13,30,6
64658,1456,1020,220,468,251,81,339,478,137,66,436,39,92,140,165,388,48
64659,378,270,48,121,66,35,112,140,6,12,108,12,14,40,42,99,9
64660,235,157,33,65,46,13,68,75,7,7,78,10,14,28,26,76,2
64661,453,310,53,123,109,25,100,172,20,18,143,10,34,60,39,132,11
64664,115,82,12,41,25,4,34,42,2,4,33,5,5,12,11,30,3
64667,187,133,29,54,31,19,39,62,21,11,54,8,11,12,23,54,0
64668,664,447,77,198,123,49,141,246,32,28,217,21,48,62,86,196,21
64670,428,308,67,131,88,22,105,144,42,17,120,25,30,36,29,108,12
64671,675,499,56,249,157,37,153,269,43,34,176,10,59,49,58,145,31
64672,109,78,16,22,40,0,31,42,2,3,31,2,3,15,11,31,0
64673,963,629,114,274,189,52,198,325,86,20,334,51,56,94,133,309,25
64674,206,141,37,45,53,6,50,76,13,2,65,0,9,24,32,59,6
64676,100,70,13,31,23,3,29,35,4,2,30,3,13,12,2,26,4
64679,331,241,48,85,76,32,66,142,27,6,90,20,10,34,26,81,9
64681,102,64,9,30,19,6,10,36,14,4,38,2,5,10,21,36,2
64682,140,109,22,47,28,12,41,53,13,2,31,3,4,7,17,31,0
64683,3544,2312,445,946,701,220,680,1246,258,128,1232,154,318,395,365,1118,114
64686,115,94,7,53,17,17,29,49,10,6,21,2,4,10,5,17,4
64688,209,135,24,54,40,17,44,74,17,0,74,8,20,25,21,66,8
64689,201,154,32,63,43,16,42,90,14,8,47,9,17,15,6,41,6
64701,5017,3648,746,1715,941,246,1417,1493,406,332,1369,242,369,435,323,1179,190
64720,1370,1032,204,453,296,79,409,505,83,35,338,47,78,135,78,299,39
64722,196,132,27,56,43,6,65,55,6,6,64,8,6,31,19,53,11
64723,285,201,37,84,58,22,79,87,21,14,84,17,23,33,11,67,17
64724,872,614,90,282,164,78,189,333,67,25,258,28,39,70,121,252,6
64725,681,521,110,237,131,43,205,240,48,28,160,37,41,40,42,149,11
64726,222,173,33,88,40,12,58,88,18,9,49,6,19,17,7,43,6
64728,243,182,55,73,38,16,79,80,17,6,61,6,12,29,14,57,4
64730,2890,1968,428,837,517,186,661,968,258,81,922,171,204,252,295,808,114
64733,421,295,54,132,101,8,103,147,26,19,126,21,25,32,48,105,21
64734,654,533,59,296,169,9,175,303,27,28,121,12,58,37,14,90,31
64735,5439,3660,723,1563,1000,374,1086,1817,534,223,1779,310,477,564,428,1569,210
64738,507,387,72,143,136,36,85,222,55,25,120,16,27,45,32,108,12
64739,355,260,36,147,65,12,114,114,20,12,95,12,31,32,20,81,14
64740,853,625,76,219,306,24,137,382,50,56,228,17,71,85,55,205,23
64741,185,122,5,57,58,2,33,71,11,7,63,11,14,18,20,61,2
64742,829,643,128,339,143,33,295,270,50,28,186,32,38,60,56,173,13
64743,113,77,24,38,7,8,40,23,12,2,36,6,6,22,2,32,4
64744,3284,2226,430,904,715,177,722,1127,254,123,1058,97,214,349,398,940,118
64745,22,14,8,5,1,0,11,3,0,0,8,0,0,5,3,8,0
64746,551,440,84,230,98,28,179,194,44,23,111,14,46,34,17,94,17
64747,1406,1073,242,484,290,57,428,503,85,57,333,53,121,101,58,278,55
64748,646,421,106,160,115,40,160,184,39,38,225,26,70,79,50,200,25
64750,160,107,21,48,31,7,40,49,14,4,53,7,5,10,31,49,4
64751,76,64,0,29,28,7,21,35,8,0,12,0,7,0,5,12,0
64752,322,237,38,101,74,24,77,133,14,13,85,6,27,23,29,68,17
64755,1056,780,156,384,202,38,296,372,95,17,276,41,77,72,86,246,30
64756,306,230,32,94,94,10,85,128,15,2,76,13,12,34,17,76,0
64759,3221,2271,447,1036,610,178,842,996,253,180,950,107,268,243,332,856,94
64761,568,404,88,186,99,31,133,185,55,31,164,22,61,43,38,131,33
64762,630,465,109,211,106,39,179,218,42,26,165,25,37,42,61,156,9
64763,569,350,73,132,108,37,90,184,64,12,219,13,65,72,69,182,37
64767,273,219,24,116,71,8,61,123,18,17,54,15,19,18,2,51,3
64769,254,189,45,75,63,6,66,88,28,7,65,8,11,31,15,62,3
64770,463,296,46,128,78,44,88,163,28,17,167,40,33,41,53,141,26
64771,208,159,14,67,57,21,52,90,7,10,49,3,20,11,15,46,3
64772,5132,3355,906,1422,802,225,1212,1405,513,225,1777,277,572,507,421,1560,217
64776,1567,1065,146,392,455,72,261,643,92,69,502,73,128,150,151,430,72
64778,129,106,30,42,28,6,36,49,12,9,23,0,0,4,19,21,2
64779,1101,741,163,316,195,67,267,336,85,53,360,38,88,127,107,331,29
64780,235,183,16,81,57,29,65,105,8,5,52,5,7,24,16,47,5
64781,47,35,2,9,24,0,2,22,6,5,12,0,2,5,5,10,2
64783,348,221,45,77,77,22,78,118,14,11,127,21,26,55,25,101,26
64784,545,413,71,185,124,33,126,239,31,17,132,28,35,33,36,107,25
64788,495,366,44,199,97,26,144,169,35,18,129,16,47,25,41,119,10
64790,319,240,61,104,61,14,88,116,18,18,79,7,29,22,21,77,2
64801,13062,8243,2276,3642,1814,511,2702,3563,1308,670,4819,1385,1513,1211,710,3941,878
64804,14254,9583,2037,4138,2524,884,2971,4750,1149,713,4671,1084,1542,1113,932,3901,770
64830,202,163,35,98,20,10,72,58,25,8,39,6,10,15,8,32,7
64831,2173,1654,464,726,373,91,627,673,251,103,519,100,168,132,119,450,69
64832,326,257,53,93,91,20,81,148,19,9,69,8,28,10,23,54,15
64833,41,28,9,6,13,0,6,13,4,5,13,0,6,7,0,9,4
64834,2527,2041,484,1024,456,77,822,884,241,94,486,75,165,179,67,397,89
64835,686,482,118,233,107,24,179,190,64,49,204,37,78,54,35,171,33
64836,8450,5974,1404,2687,1332,551,2079,2735,729,431,2476,407,590,787,692,2184,292
64840,978,786,228,332,166,60,299,388,69,30,192,20,80,40,52,172,20
64841,179,129,46,62,21,0,43,49,25,12,50,14,14,12,10,44,6
64842,354,272,64,123,68,17,130,102,21,19,82,17,32,21,12,80,2
64843,1209,889,245,370,238,36,319,384,125,61,320,34,71,139,76,279,41
64844,1709,1257,336,559,324,38,478,517,153,109,452,60,137,129,126,411,41
64847,180,105,40,24,41,0,36,50,9,10,75,9,26,17,23,71,4
64848,226,186,52,80,43,11,73,81,15,17,40,16,13,5,6,34,6
64849,34,24,9,9,6,0,8,10,3,3,10,0,2,8,0,10,0
64850,8037,5757,1542,2417,1412,386,2203,2553,629,372,2280,421,558,759,542,1943,337
64854,1436,1014,256,414,291,53,310,454,147,103,422,80,159,128,55,337,85
64855,620,525,71,298,121,35,167,276,54,28,95,7,34,20,34,83,12
64856,1397,992,229,478,244,41,354,421,159,58,405,85,148,99,73,319,86
64857,114,84,23,33,21,7,37,41,1,5,30,2,4,22,2,27,3
64858,56,44,13,17,14,0,24,14,6,0,12,6,0,6,0,12,0
64859,442,318,78,151,75,14,120,142,31,25,124,26,49,31,18,109,15
64861,488,368,43,162,154,9,81,208,41,38,120,7,54,26,33,101,19
64862,1208,893,185,351,267,90,304,445,78,66,315,34,108,99,74,263,52
64863,632,472,176,210,55,31,162,190,113,7,160,22,66,52,20,131,29
64865,2081,1595,355,695,472,73,578,755,181,81,486,74,117,161,134,437,49
64866,489,344,47,162,115,20,118,179,24,23,145,37,40,42,26,122,23
64867,462,307,123,102,61,21,123,112,59,13,155,2,64,52,37,136,19
64870,4424,3075,834,1401,620,220,1216,1191,467,201,1349,376,339,397,237,1105,244
64873,317,251,59,105,73,14,118,107,19,7,66,5,15,22,24,54,12
64874,351,251,74,91,60,26,95,109,35,12,100,17,23,34,26,88,12
65001,182,142,27,45,57,13,51,78,4,9,40,8,4,12,16,38,2
65010,1474,1088,298,531,206,53,447,437,150,54,386,84,151,84,67,289,97
65011,770,640,113,271,204,52,227,320,52,41,130,5,45,75,5,97,33
65013,1371,926,203,377,278,68,296,464,99,67,445,72,111,167,95,390,55
65014,945,662,124,308,213,17,245,336,55,26,283,26,80,95,82,249,34
65016,519,397,53,194,129,21,148,197,30,22,122,43,21,24,34,114,8
65017,484,357,52,190,83,32,113,178,44,22,127,6,40,42,39,104,23
65018,2867,2085,512,921,502,150,782,938,263,102,782,135,170,218,259,703,79
65020,4824,3395,549,1372,1230,244,912,1817,408,258,1429,191,386,530,322,1157,272
65023,605,450,87,209,124,30,197,216,27,10,155,51,57,30,17,141,14
65024,435,299,53,143,69,34,113,150,15,21,136,19,35,47,35,129,7
65025,312,219,39,109,59,12,71,110,25,13,93,14,33,23,23,82,11
65026,4965,3295,671,1520,901,203,1060,1523,441,271,1670,238,400,603,429,1440,230
65032,518,405,84,198,92,31,190,165,24,26,113,2,39,46,26,95,18
65034,190,141,39,53,47,2,58,57,9,17,49,7,16,17,9,33,16
65035,561,456,103,229,101,23,236,176,22,22,105,23,23,38,21,100,5
65036,98,60,20,17,16,7,17,24,14,5,38,8,11,13,6,27,11
65037,2040,1422,153,409,701,159,232,965,145,80,618,79,190,253,96,528,90
65039,874,680,75,393,182,30,270,331,56,23,194,57,38,57,42,155,39
65040,429,342,87,185,53,17,184,122,14,22,87,10,20,30,27,75,12
65041,2483,1689,249,734,538,168,500,943,181,65,794,90,177,233,294,719,75
65043,3304,2506,607,1278,554,67,965,1086,338,117,798,239,304,179,76,623,175
65046,475,320,66,139,98,17,116,145,40,19,155,18,67,38,32,132,23
65047,554,370,90,189,66,25,133,149,88,0,184,40,57,55,32,170,14
65048,45,35,12,23,0,0,15,13,0,7,10,5,5,0,0,10,0
65049,2177,1451,195,570,622,64,337,909,149,56,726,159,206,291,70,602,124
65050,157,126,30,68,24,4,65,52,7,2,31,7,12,6,6,29,2
65051,1792,1245,300,557,323,65,487,547,133,78,547,153,109,127,158,436,111
65052,1214,938,179,398,325,36,302,495,105,36,276,46,115,62,53,205,71
65053,451,393,50,197,127,19,196,137,15,45,58,5,19,12,22,53,5
65054,184,140,44,56,30,10,68,55,17,0,44,12,16,10,6,35,9
65058,431,305,42,155,85,23,137,133,17,18,126,17,49,28,32,108,18
65059,285,223,31,114,53,25,108,102,5,8,62,15,23,15,9,50,12
65061,262,177,26,48,73,30,44,88,16,29,85,7,21,39,18,76,9
65062,7,7,0,0,0,7,0,7,0,0,0,0,0,0,0,0,0
65063,1068,818,176,407,207,28,317,381,82,38,250,68,73,68,41,225,25
65064,226,186,65,89,29,3,74,68,38,6,40,7,9,7,17,33,7
65065,2203,1491,193,574,625,99,359,978,98,56,712,162,270,167,113,583,129
65066,2500,1781,314,844,452,171,655,839,183,104,719,85,199,202,233,627,92
65067,157,106,6,92,8,0,56,36,6,8,51,14,8,20,9,51,0
65068,261,176,31,95,38,12,81,69,13,13,85,3,27,18,37,83,2
65069,305,226,56,105,53,12,91,89,25,21,79,11,14,12,42,68,11
65072,808,550,54,161,269,66,107,393,7,43,258,40,56,126,36,218,40
65074,1045,775,156,378,183,58,313,368,76,18,270,47,71,79,73,221,49
65075,275,202,39,87,62,14,87,87,9,19,73,10,12,29,22,65,8
65076,298,255,61,97,78,19,122,92,18,23,43,16,3,9,15,35,8
65077,203,158,14,70,74,0,34,85,26,13,45,0,19,16,10,26,19
65078,1456,994,169,343,428,54,288,600,71,35,462,58,106,190,108,387,75
65079,2198,1592,133,452,863,144,225,1189,122,56,606,47,170,253,136,499,107
65080,287,197,33,99,43,22,96,86,15,0,90,22,28,15,25,90,0
65081,1226,841,168,414,197,62,318,402,98,23,385,58,75,107,145,343,42
65082,400,282,37,126,88,31,106,133,23,20,118,18,34,18,48,107,11
65083,126,94,27,40,20,7,28,43,19,4,32,16,0,11,5,24,8
65084,2422,1685,310,779,425,171,616,828,154,87,737,121,188,255,173,654,83
65085,368,268,44,151,47,26,146,87,12,23,100,15,36,30,19,90,10
65101,10145,6399,1508,3087,1461,343,2456,2552,860,531,3746,1150,1223,855,518,3227,519
65109,14457,9671,2265,4726,2135,545,3808,4048,1241,574,4786,1260,1608,1063,855,4076,710
65201,12611,5203,1662,2470,785,286,1571,2213,836,583,7408,4876,1532,636,364,4715,2693
65202,14273,9160,3039,4174,1558,389,3377,3596,1465,722,5113,2134,1612,920,447,3676,1437
65203,18719,11661,2771,6121,2159,610,4600,4523,1660,878,7058,3154,1901,1214,789,5274,1784
65230,292,214,37,93,61,23,83,105,15,11,78,6,9,27,36,78,0
65231,1194,896,187,444,188,77,330,401,121,44,298,62,60,91,85,233,65
65232,86,69,12,22,29,6,23,44,0,2,17,4,7,6,0,12,5
65233,3767,2592,477,1266,639,210,886,1205,318,183,1175,199,296,300,380,1011,164
65236,653,408,56,188,105,59,133,202,37,36,245,21,47,86,91,224,21
65237,373,270,41,137,62,30,91,129,29,21,103,20,38,23,22,87,16
65239,467,337,69,160,83,25,138,158,37,4,130,22,28,36,44,120,10
65240,2674,2062,432,981,519,130,776,982,236,68,612,103,165,158,186,557,55
65243,836,678,222,329,99,28,367,253,30,28,158,27,49,54,28,149,9
65244,201,136,9,66,45,16,40,78,4,14,65,15,10,24,16,54,11
65246,54,37,0,11,18,8,7,25,2,3,17,1,7,7,2,13,4
65247,267,163,28,98,35,2,68,72,21,2,104,13,34,30,27,89,15
65248,1666,1120,229,493,278,120,339,540,145,96,546,118,166,114,148,458,88
65250,253,189,46,88,47,8,70,74,34,11,64,10,14,28,12,60,4
65251,7029,4811,975,2409,1102,325,1706,2008,736,361,2218,552,559,548,559,1846,372
65254,759,516,102,228,150,36,198,223,56,39,243,39,91,49,64,221,22
65255,1144,808,184,400,191,33,318,362,92,36,336,45,118,90,83,284,52
65256,561,453,63,267,91,32,164,223,45,21,108,11,49,28,20,98,10
65257,624,462,85,221,113,43,157,234,29,42,162,28,54,54,26,133,29
65258,219,160,21,60,70,9,53,87,11,9,59,6,16,13,24,50,9
65259,990,747,127,412,164,44,297,314,71,65,243,51,68,66,58,214,29
65260,201,155,49,71,24,11,58,58,17,22,46,3,13,13,17,43,3
65261,489,307,45,126,103,33,109,156,22,20,182,15,30,64,73,169,13
65262,184,141,19,50,57,15,47,74,12,8,43,13,4,26,0,20,23
65263,722,544,136,234,139,35,203,268,56,17,178,28,51,51,48,162,16
65264,364,282,41,116,100,25,91,156,22,13,82,11,31,14,26,76,6
65265,6388,4338,909,1884,1189,356,1407,2008,634,289,2050,409,482,488,671,1831,219
65270,6414,4209,994,1879,1034,302,1330,1914,613,352,2205,369,512,710,614,1948,257
65274,703,489,105,216,125,43,186,226,44,33,214,28,42,62,82,194,20
65275,1062,718,122,258,263,75,233,390,51,44,344,48,91,106,99,303,41
65276,562,405,71,191,103,40,159,190,31,25,157,32,48,35,42,144,13
65278,66,50,12,25,13,0,17,16,10,7,16,0,7,5,4,11,5
65279,571,421,47,261,101,12,166,189,52,14,150,14,51,43,42,140,10
65280,79,59,5,34,12,8,32,21,4,2,20,5,5,6,4,13,7
65281,1270,877,133,384,235,125,335,424,64,54,393,39,99,105,150,370,23
65282,64,49,0,35,14,0,26,23,0,0,15,0,0,5,10,15,0
65283,221,170,19,64,80,7,35,104,19,12,51,13,11,22,5,49,2
65284,851,621,116,332,118,55,264,283,52,22,230,44,65,47,74,193,37
65285,269,217,16,109,71,21,78,113,5,21,52,12,10,18,12,49,3
65286,65,50,9,12,25,4,12,32,0,6,15,1,2,2,10,15,0
65287,137,103,34,36,27,6,46,50,4,3,34,4,5,14,11,28,6
65301,12820,8526,2225,3589,1996,716,2910,3658,1208,750,4294,801,1284,1207,1002,3650,644
65305,942,909,610,299,0,0,664,161,84,0,33,18,15,0,0,19,14
65320,55,30,3,12,7,8,5,17,3,5,25,3,0,13,9,19,6
65321,158,101,23,49,20,9,41,45,7,8,57,0,18,18,21,48,9
65322,280,190,33,68,62,27,62,114,8,6,90,15,25,30,20,81,9
65323,362,271,41,135,84,11,88,142,17,24,91,2,20,41,28,84,7
65324,711,555,47,176,281,51,114,392,29,20,156,12,41,74,29,142,14
65325,1153,821,151,371,224,75,307,377,73,64,332,30,87,117,98,325,7
65326,938,595,32,143,358,62,69,481,24,21,343,37,42,201,63,297,46
65327,96,78,13,32,22,11,31,41,5,1,18,2,5,9,2,16,2
65329,150,107,27,49,31,0,43,27,20,17,43,6,12,8,17,42,1
65330,205,149,28,62,48,11,43,60,21,25,56,5,13,18,20,47,9
65332,563,430,94,200,118,18,173,186,46,25,133,6,41,57,29,114,19
65333,304,248,34,117,71,26,103,123,15,7,56,10,14,15,17,48,8
65334,275,223,55,89,62,17,100,99,13,11,52,2,21,16,13,45,7
65335,121,74,5,37,19,13,18,42,4,10,47,9,11,25,2,42,5
65336,2037,1428,443,637,307,41,597,556,184,91,609,225,231,71,82,499,110
65337,728,509,132,220,120,37,215,212,45,37,219,46,69,48,56,183,36
65338,1195,885,123,388,292,82,258,495,113,19,310,31,91,86,102,270,40
65339,333,229,46,100,68,15,91,107,23,8,104,28,31,14,31,77,27
65340,5758,3778,905,1662,947,264,1193,1704,599,282,1980,288,549,595,548,1671,309
65344,125,83,18,35,24,6,25,45,9,4,42,8,10,12,12,32,10
65345,138,125,17,62,39,7,49,67,9,0,13,0,6,0,7,6,7
65347,245,197,30,81,69,17,57,110,12,18,48,2,21,17,8,31,17
65348,514,393,83,178,100,32,149,202,27,15,121,14,25,45,37,108,13
65349,1173,724,153,309,179,83,245,305,97,77,449,61,89,147,152,393,56
65350,593,483,92,238,120,33,235,172,45,31,110,9,54,23,24,99,11
65351,984,743,140,347,187,69,261,370,64,48,241,28,53,81,79,225,16
65354,94,71,16,27,24,4,23,44,2,2,23,4,10,6,3,20,3
65355,4048,2786,310,1017,1212,247,585,1796,248,157,1262,119,265,580,298,1088,174
65360,1897,1385,335,605,361,84,459,694,160,72,512,68,129,146,169,468,44
65401,10793,6875,1664,3025,1743,443,2440,3154,856,425,3918,1514,880,816,708,3162,756
65436,45,27,4,13,10,0,4,19,4,0,18,0,5,9,4,13,5
65438,1162,868,174,376,261,57,282,416,106,64,294,30,65,133,66,261,33
65439,126,95,12,53,23,7,26,64,0,5,31,7,12,12,0,19,12
65440,252,190,30,86,44,30,44,118,12,16,62,7,19,22,14,50,12
65441,1644,1215,233,599,314,69,484,537,137,57,429,52,127,158,92,379,50
65443,46,35,0,21,8,6,5,25,0,5,11,0,5,6,0,11,0
65444,405,307,38,144,104,21,102,164,31,10,98,9,43,37,9,94,4
65446,135,113,21,52,36,4,30,60,18,5,22,0,12,0,10,18,4
65449,208,141,13,57,64,7,48,93,0,0,67,13,6,29,19,62,5
65452,1174,843,185,386,214,58,308,412,74,49,331,28,98,112,93,281,50
65453,3159,2281,456,973,665,187,803,1113,257,108,878,130,266,282,200,779,99
65456,239,178,27,55,88,8,41,114,17,6,61,3,22,19,17,56,5
65457,34,19,8,3,8,0,3,8,8,0,15,0,8,7,0,15,0
65459,3041,2324,546,1074,610,94,876,1066,264,118,717,125,209,233,150,652,65
65461,33,15,0,11,4,0,0,9,6,0,18,3,0,3,12,13,5
65462,518,404,65,199,127,13,166,185,25,28,114,9,24,43,38,104,10
65463,332,262,50,124,60,28,93,129,24,16,70,19,17,0,34,58,12
65464,165,125,30,50,34,11,44,65,14,2,40,0,7,20,13,36,4
65466,732,463,68,189,164,42,126,255,41,41,269,19,75,77,98,251,18
65468,19,13,0,7,4,2,0,10,3,0,6,0,2,2,2,4,2
65470,389,304,66,128,100,10,97,182,12,13,85,2,35,46,2,66,19
65473,2648,2333,1531,792,10,0,1709,424,185,15,315,229,76,10,0,208,107
65479,143,100,17,49,25,9,35,48,13,4,43,5,5,25,8,39,4
65483,1988,1351,245,572,407,127,387,688,201,75,637,79,141,244,173,577,60
65484,68,53,4,13,24,12,4,27,6,16,15,5,7,1,2,10,5
65486,1199,892,215,374,256,47,341,399,90,62,307,60,72,85,90,269,38
65501,80,62,8,25,23,6,18,39,3,2,18,2,5,6,5,17,1
65529,105,71,11,35,17,8,18,42,11,0,34,5,5,17,7,34,0
65532,27,27,3,12,8,4,0,22,0,5,0,0,0,0,0,0,0
65534,300,243,54,99,82,8,86,121,28,8,57,0,20,37,0,57,0
65535,592,446,82,207,120,37,145,233,45,23,146,20,51,57,18,124,22
65536,10481,7510,1713,3322,1946,529,2759,3502,798,451,2971,521,798,926,726,2602,369
65540,144,123,28,51,35,9,61,59,0,3,21,5,4,6,6,21,0
65541,71,63,4,33,26,0,16,36,4,7,8,0,8,0,0,8,0
65542,1920,1363,292,552,419,100,397,684,179,103,557,57,168,177,155,508,49
65543,87,68,10,30,28,0,19,42,7,0,19,0,11,6,2,19,0
65548,2223,1530,322,616,496,96,511,755,179,85,693,74,120,267,232,604,89
65550,1361,942,164,462,250,66,241,527,105,69,419,36,163,160,60,367,52
65552,625,438,71,223,128,16,178,196,37,27,187,42,52,59,34,160,27
65555,397,293,56,136,78,23,114,117,26,36,104,7,24,45,28,96,8
65556,2120,1489,298,700,400,91,535,713,148,93,631,112,187,186,146,564,67
65557,86,46,6,12,20,8,8,38,0,0,40,2,3,13,22,40,0
65559,3319,2332,440,1016,613,263,879,1097,240,116,987,177,245,314,251,902,85
65560,5438,3838,793,1615,1140,290,1324,1848,370,296,1600,187,381,515,517,1426,174
65564,76,59,14,25,20,0,24,31,0,4,17,5,1,7,4,16,1
65565,2037,1443,325,633,384,101,525,680,167,71,594,92,162,182,158,518,76
65566,340,244,71,96,68,9,102,101,36,5,96,17,13,44,22,89,7
65567,483,372,65,194,87,26,168,151,30,23,111,17,31,32,31,105,6
65570,226,179,24,89,52,14,47,97,20,15,47,5,20,13,9,42,5
65571,913,642,117,261,193,71,233,314,65,30,271,13,70,130,58,255,16
65580,363,264,49,77,115,23,94,134,15,21,99,7,44,30,18,89,10
65582,813,567,128,256,137,46,205,278,52,32,246,30,42,104,70,229,17
65583,5374,3758,788,2041,759,170,1375,1582,570,231,1616,427,551,429,209,1400,216
65588,986,717,170,316,195,36,251,320,104,42,269,32,75,106,56,238,31
65589,94,79,6,44,23,6,37,36,4,2,15,0,6,7,2,13,2
65590,535,434,101,193,116,24,168,193,44,29,101,14,61,26,0,88,13
65591,326,239,25,113,91,10,79,139,15,6,87,9,39,33,6,68,19
65601,304,220,27,66,96,31,54,153,2,11,84,19,11,33,21,63,21
65603,80,57,7,20,25,5,20,33,4,0,23,0,5,10,8,23,0
65604,1410,1062,209,493,252,108,393,512,108,49,348,47,107,113,81,308,40
65605,4635,3250,796,1343,856,255,1193,1509,306,242,1385,233,303,482,367,1248,137
65606,1326,915,165,411,288,51,286,467,91,71,411,53,83,149,126,366,45
65608,3672,2529,553,1019,748,209,874,1259,268,128,1143,100,317,404,322,1035,108
65609,281,226,55,107,56,8,88,110,13,15,55,8,11,27,9,55,0
65610,1664,1307,228,666,332,81,441,702,100,64,357,56,98,107,96,297,60
65611,805,640,139,207,246,48,194,365,36,45,165,16,57,43,49,158,7
65612,447,397,68,202,102,25,156,187,33,21,50,10,8,28,4,39,11
65613,5462,3881,1028,1549,892,412,1378,1853,397,253,1581,419,350,452,360,1335,246
65614,211,163,20,85,32,26,62,81,6,14,48,6,12,11,19,45,3
65616,7249,4886,811,2132,1568,375,1543,2523,473,347,2363,578,658,745,382,1937,426
65617,507,412,54,255,85,18,157,221,27,7,95,26,41,18,10,63,32
65618,82,58,4,32,20,2,21,29,0,8,24,0,2,10,12,24,0
65619,1653,1273,289,636,297,51,470,639,90,74,380,79,124,138,39,325,55
65620,139,123,27,73,23,0,52,57,8,6,16,7,6,3,0,12,4
65622,3036,2165,474,974,538,179,803,965,271,126,871,95,197,285,294,767,104
65623,13,7,0,6,1,0,6,1,0,0,6,4,0,2,0,6,0
65624,190,135,16,65,47,7,31,82,22,0,55,7,0,42,6,48,7
65625,2960,2102,439,902,589,172,723,1030,214,135,858,115,235,297,211,778,80
65626,595,431,59,209,132,31,150,213,34,34,164,15,43,60,46,151,13
65627,235,139,33,81,25,0,32,83,23,1,96,12,11,54,19,71,25
65629,298,211,40,106,52,13,65,117,18,11,87,11,23,40,13,72,15
65630,53,45,0,23,10,12,15,18,0,12,8,0,0,8,0,8,0
65631,918,696,206,302,140,48,332,287,65,12,222,37,72,50,63,187,35
65632,1004,783,145,390,223,25,315,388,60,20,221,22,51,94,54,192,29
65633,1290,952,248,429,230,45,416,375,99,62,338,26,93,124,95,311,27
65634,320,204,43,68,90,3,61,126,10,7,116,1,30,34,51,116,0
65635,225,174,20,70,60,24,60,104,10,0,51,4,20,9,18,42,9
65637,479,361,80,161,102,18,133,176,32,20,118,22,39,32,25,111,7
65638,181,133,13,51,56,13,34,85,2,12,48,6,14,19,9,39,9
65640,275,204,12,98,81,13,50,138,4,12,71,7,6,15,43,71,0
65641,621,478,60,147,202,69,102,312,36,28,143,8,51,62,22,114,29
65644,1015,732,159,315,196,62,264,385,45,38,283,36,70,121,56,234,49
65646,726,555,85,270,165,35,191,295,41,28,171,20,36,65,50,157,14
65647,913,693,121,319,211,42,223,354,68,48,220,40,73,79,28,195,25
65648,1660,1293,252,670,345,26,536,607,110,40,367,60,118,129,60,329,38
65649,581,435,76,164,159,36,131,267,25,12,146,33,28,43,42,121,25
65650,482,371,43,106,185,37,95,252,22,2,111,19,27,49,16,90,21
65652,1142,876,201,446,193,36,349,369,108,50,266,44,99,55,68,231,35
65653,2058,1379,228,412,543,196,362,840,108,69,679,78,163,228,210,614,65
65655,1270,932,186,359,309,78,294,479,88,71,338,31,78,126,103,313,25
65656,2248,1673,322,634,585,132,420,988,123,142,575,71,147,243,114,498,77
65657,50,35,9,16,8,2,10,14,9,2,15,1,6,6,2,12,3
65658,440,338,41,103,179,15,102,214,10,12,102,8,39,35,20,85,17
65659,148,114,32,45,33,4,31,67,14,2,34,2,17,11,4,31,3
65660,80,75,5,34,36,0,33,38,0,4,5,3,0,0,2,5,0
65661,1135,724,106,324,209,85,203,383,86,52,411,27,97,145,142,377,34
65662,497,377,66,182,105,24,111,177,66,23,120,19,29,36,36,102,18
65663,648,514,123,224,127,40,236,229,25,24,134,22,39,48,25,115,19
65664,17,15,4,7,2,2,4,11,0,0,2,0,0,2,0,2,0
65667,1256,868,177,381,264,46,309,413,88,58,388,41,69,162,116,349,39
65668,746,539,51,153,274,61,113,382,27,17,207,18,49,79,61,192,15
65669,667,552,69,282,161,40,216,270,28,38,115,6,27,55,27,113,2
65672,2970,1927,410,797,563,157,522,1008,259,138,1043,326,350,207,160,822,221
65674,950,641,102,266,217,56,220,319,54,48,309,35,67,122,85,281,28
65675,45,33,8,19,5,1,20,7,4,2,12,2,0,4,6,12,0
65676,224,174,9,55,100,10,43,116,11,4,50,7,13,24,6,37,13
65679,876,719,172,298,232,17,271,366,55,27,157,43,41,45,28,122,35
65680,428,327,64,144,119,0,65,205,52,5,101,9,28,48,16,78,23
65681,941,722,120,257,296,49,200,460,38,24,219,42,75,77,25,163,56
65682,821,613,119,270,150,74,222,287,55,49,208,34,36,64,74,201,7
65685,390,282,69,93,96,24,88,161,27,6,108,4,27,39,38,92,16
65686,1953,1404,95,404,746,159,207,1066,57,74,549,50,106,230,163,471,78
65689,1955,1366,208,643,411,104,429,687,160,90,589,67,151,215,156,522,67
65690,225,171,15,70,62,24,45,87,14,25,54,8,8,24,14,52,2
65692,523,378,82,172,102,22,131,210,24,13,145,23,43,51,28,129,16
65701,11,7,0,4,3,0,0,7,0,0,4,0,0,2,2,4,0
65702,154,121,35,43,37,6,47,59,9,6,33,2,16,10,5,27,6
65704,1482,1077,257,449,300,71,399,491,120,67,405,46,100,134,125,376,29
65705,1491,1105,233,460,290,122,345,574,110,76,386,80,98,93,115,336,50
65706,4865,3670,778,1741,942,209,1390,1773,334,173,1195,188,328,381,298,1036,159
65707,881,639,135,276,167,61,219,333,53,34,242,28,64,80,70,232,10
65708,4324,3107,755,1426,713,213,1146,1359,437,165,1217,162,381,348,326,1132,85
65710,392,265,63,139,60,3,124,105,24,12,127,18,57,27,25,94,33
65711,3795,2657,597,1026,811,223,808,1369,373,107,1138,187,285,348,318,1035,103
65712,2839,2033,447,766,614,206,660,956,255,162,806,89,208,303,206,738,68
65713,893,681,135,337,184,25,268,326,59,28,212,53,50,73,36,181,31
65714,7943,6231,1713,2886,1319,313,2628,2710,656,237,1712,337,656,468,251,1425,287
65715,65,40,9,15,9,7,13,9,6,12,25,0,3,15,7,25,0
65717,874,707,161,306,188,52,300,330,63,14,167,22,52,58,35,161,6
65720,190,143,16,75,48,4,52,65,10,16,47,13,10,20,4,47,0
65721,7098,5481,1689,2490,1119,183,2218,2376,635,252,1617,425,501,441,250,1381,236
65722,577,466,149,185,112,20,153,217,59,37,111,13,23,26,49,84,27
65723,1405,996,217,459,220,100,410,415,83,88,409,51,131,115,112,367,42
65724,643,411,43,97,219,52,81,308,22,0,232,7,86,110,29,200,32
65725,882,694,171,331,171,21,281,306,66,41,188,34,40,63,51,156,32
65727,48,31,10,7,8,6,5,26,0,0,17,0,9,8,0,17,0
65728,38,29,8,0,21,0,8,21,0,0,9,0,9,0,0,9,0
65729,116,65,0,21,43,1,8,53,4,0,51,8,13,10,20,43,8
65730,48,17,0,0,17,0,0,8,0,9,31,8,15,8,0,31,0
65731,138,106,29,30,31,16,56,50,0,0,32,0,12,11,9,20,12
65732,329,245,24,108,91,22,52,144,33,16,84,2,25,32,25,72,12
65733,229,176,14,67,80,15,53,111,4,8,53,4,3,20,26,53,0
65734,1201,881,196,421,213,51,370,350,105,56,320,41,94,80,105,270,50
65735,83,59,8,19,32,0,19,29,0,11,24,4,0,5,15,24,0
65737,2648,2000,394,742,773,91,499,1181,207,113,648,84,242,204,118,515,133
65738,4289,3295,807,1631,681,176,1338,1340,424,193,994,152,259,349,234,847,147
65739,454,337,69,134,118,16,117,191,23,6,117,18,46,46,7,97,20
65740,1093,723,154,269,233,67,202,353,112,56,370,42,144,120,64,289,81
65742,3329,2616,448,1299,730,139,999,1246,251,120,713,123,236,254,100,586,127
65744,64,54,4,20,22,8,10,33,5,6,10,0,1,7,2,10,0
65745,910,658,150,313,170,25,210,303,77,68,252,49,87,90,26,214,38
65746,2298,1839,527,819,428,65,868,698,159,114,459,46,100,182,131,412,47
65747,1776,1278,92,429,578,179,165,953,93,67,498,32,127,185,154,456,42
65752,178,132,20,64,40,8,52,56,16,8,46,6,26,8,6,44,2
65753,1504,1102,250,496,310,46,349,549,131,73,402,59,129,112,102,343,59
65754,209,189,64,97,24,4,93,76,20,0,20,5,4,11,0,20,0
65755,160,119,22,33,46,18,32,77,5,5,41,6,4,17,14,36,5
65756,297,235,69,89,65,12,72,120,25,18,62,19,15,20,8,50,12
65757,2250,1738,403,802,447,86,674,799,172,93,512,80,215,124,93,413,99
65759,427,318,88,131,75,24,125,136,40,17,109,21,32,35,21,82,27
65760,245,175,18,68,64,25,52,103,14,6,70,6,41,11,12,58,12
65761,585,421,37,132,216,36,76,287,34,24,164,7,45,71,41,142,22
65762,179,138,11,62,52,13,50,75,9,4,41,4,9,19,9,31,10
65764,477,366,59,163,115,29,146,161,40,19,111,12,19,36,44,111,0
65766,58,48,10,7,27,4,10,33,0,5,10,0,4,2,4,10,0
65767,765,580,69,241,219,51,154,329,41,56,185,20,58,39,68,163,22
65768,161,132,2,61,61,8,34,92,3,3,29,0,13,10,6,27,2
65769,998,813,213,345,201,54,344,334,89,46,185,32,71,40,42,160,25
65770,1098,837,192,391,209,45,354,407,44,32,261,47,79,60,75,236,25
65771,335,269,59,126,82,2,98,124,33,14,66,16,31,13,6,52,14
65772,853,628,159,305,146,18,283,272,53,20,225,20,52,94,59,205,20
65773,297,218,49,55,91,23,51,143,7,17,79,2,28,38,11,71,8
65774,467,330,55,147,94,34,125,155,37,13,137,11,22,50,54,126,11
65775,9095,6558,1611,2689,1809,449,2349,3029,763,417,2537,364,674,921,578,2274,263
65777,126,116,19,50,33,14,26,67,0,23,10,0,5,5,0,10,0
65778,212,180,32,71,60,17,51,101,19,9,32,7,9,10,6,23,9
65779,853,561,74,190,217,80,138,359,37,27,292,21,32,128,111,234,58
65781,2287,1796,401,809,497,89,641,917,187,51,491,78,140,133,140,404,87
65783,84,67,3,50,14,0,30,32,5,0,17,0,3,4,10,17,0
65784,7,5,1,4,0,0,5,0,0,0,2,0,0,2,0,2,0
65785,2134,1522,250,550,585,137,489,882,80,71,612,43,173,228,168,570,42
65786,781,593,126,287,144,36,227,294,37,35,188,26,51,62,49,167,21
65787,514,400,46,108,199,47,72,309,6,13,114,14,15,70,15,98,16
65788,161,124,21,57,38,8,43,61,7,13,37,7,9,10,11,37,0
65789,718,611,113,300,160,38,219,318,60,14,107,18,33,38,18,107,0
65790,250,191,45,90,43,13,62,121,4,4,59,5,18,27,9,59,0
65791,1696,1165,256,483,326,100,394,557,128,86,531,71,117,178,165,498,33
65793,2367,1713,340,722,520,131,585,886,140,102,654,70,194,194,196,595,59
65802,15673,9553,2949,3935,2039,630,2795,3890,1831,1037,6120,2021,1889,1410,800,4863,1257
65803,15242,9978,2303,4600,2336,739,3074,4528,1401,975,5264,1153,1927,1307,877,4337,927
65804,16648,9567,1942,3950,2639,1036,2621,4905,1170,871,7081,2449,1613,1596,1423,5654,1427
65806,5346,1613,650,656,221,86,459,480,380,294,3733,1815,928,622,368,2762,971
65807,20176,11663,3019,5026,2629,989,3487,5577,1491,1108,8513,3325,2167,1676,1345,6565,1948
65809,3412,2867,239,1558,901,169,1076,1529,160,102,545,110,155,228,52,448,97
65810,5804,4657,829,2527,1053,248,2039,2155,272,191,1147,403,394,268,82,919,228
66002,5021,3307,784,1413,837,273,1156,1419,480,252,1714,313,471,492,438,1493,221
66006,2054,1568,272,792,414,90,651,740,131,46,486,90,134,96,166,429,57
66007,1433,1166,143,688,272,63,442,589,88,47,267,48,87,69,63,226,41
66008,134,108,20,57,28,3,52,53,3,0,26,4,4,4,14,26,0
66010,222,148,28,61,50,9,50,75,18,5,74,6,27,24,17,67,7
66012,3508,2693,554,1282,703,154,961,1262,278,192,815,132,257,212,214,694,121
66013,589,487,64,264,144,15,158,276,38,15,102,36,22,35,9,95,7
66014,159,130,0,55,67,8,34,84,0,12,29,0,0,20,9,29,0
66015,296,242,43,118,52,29,90,119,18,15,54,5,10,12,27,54,0
66016,213,172,49,76,23,24,84,66,16,6,41,0,19,8,14,35,6
66017,164,108,15,55,25,13,53,40,6,9,56,12,13,11,20,49,7
66018,1573,1246,294,622,271,59,577,480,117,72,327,49,147,95,36,272,55
66019,124,47,22,18,7,0,20,6,9,12,77,4,28,19,26,77,0
66020,562,466,49,284,106,27,165,211,61,29,96,9,36,43,8,84,12
66021,773,630,165,318,109,38,311,220,58,41,143,41,65,33,4,104,39
66023,429,333,39,156,112,26,126,169,26,12,96,12,21,36,27,91,5
66024,330,237,56,115,62,4,69,96,61,11,93,18,28,22,25,82,11
66025,2156,1550,420,727,317,86,674,597,161,118,606,144,224,154,84,459,147
66026,288,247,55,106,69,17,76,127,26,18,41,1,10,8,22,38,3
66027,1545,1499,572,927,0,0,1229,134,120,16,46,28,18,0,0,41,5
66030,3983,2983,1112,1416,373,82,1413,981,402,187,1000,291,308,270,131,765,235
66032,2046,1401,304,572,355,170,544,656,136,65,645,75,143,224,203,591,54
66033,305,207,27,84,63,33,79,109,9,10,98,16,26,31,25,81,17
66035,433,261,27,119,72,43,81,148,18,14,172,36,42,37,57,152,20
66039,245,185,27,78,63,17,81,87,4,13,60,3,19,14,24,57,3
66040,1206,902,144,471,263,24,342,482,55,23,304,41,91,124,48,277,27
66041,271,205,29,99,71,6,66,109,18,12,66,7,18,24,17,57,9
66042,170,145,19,80,43,3,30,91,18,6,25,4,8,7,6,23,2
66043,2377,1928,374,1124,357,73,798,827,207,96,449,37,233,116,63,377,72
66044,11515,4543,1637,1967,718,221,1357,1984,711,491,6972,4757,1345,531,339,4164,2808
66046,7844,4507,1600,1880,795,232,1585,1785,711,426,3337,1686,921,499,231,2086,1251
66047,6219,3645,882,1813,746,204,1416,1683,371,175,2574,1388,519,370,297,1630,944
66048,12481,8413,1687,4191,2068,467,2938,3581,1217,677,4068,739,1442,1004,883,3514,554
66049,8270,5191,1121,2798,1018,254,2139,2286,472,294,3079,1773,630,437,239,2111,968
66050,541,411,63,223,104,21,173,195,31,12,130,7,38,49,36,118,12
66052,692,541,90,279,144,28,205,271,46,19,151,12,60,66,13,136,15
66053,2029,1637,369,824,340,104,731,701,114,91,392,57,149,112,74,334,58
66054,1010,819,148,409,233,29,331,402,58,28,191,50,58,46,37,162,29
66056,746,544,80,181,192,91,142,331,48,23,202,23,44,86,49,182,20
66058,172,124,33,62,17,12,38,58,24,4,48,5,13,20,10,35,13
66060,407,322,47,143,103,29,109,163,37,13,85,15,21,13,36,73,12
66061,15208,11179,3217,5826,1822,314,4802,4259,1329,789,4029,1270,1435,856,468,3258,771
66062,18408,14903,4155,8923,1629,196,8067,4956,1422,458,3505,1564,1121,537,283,2729,776
66064,2490,1653,455,696,411,91,565,688,296,104,837,172,175,255,235,727,110
66066,986,714,108,384,187,35,287,320,72,35,272,36,124,39,73,231,41
66067,6016,4165,1051,1865,918,331,1448,1842,595,280,1851,333,536,486,496,1624,227
66070,842,673,81,301,262,29,262,372,29,10,169,13,109,41,6,130,39
66071,4283,3162,506,1697,803,156,1313,1449,267,133,1121,180,378,278,285,943,178
66072,392,299,36,114,102,47,90,176,13,20,93,0,37,36,20,80,13
66073,878,640,117,322,158,43,265,293,50,32,238,38,71,64,65,190,48
66075,886,645,127,306,144,68,248,284,70,43,241,32,51,67,91,209,32
66076,786,592,130,231,194,37,225,274,40,53,194,25,53,73,43,176,18
66077,21,14,0,7,7,0,0,14,0,0,7,0,7,0,0,7,0
66078,355,291,101,110,63,17,128,123,34,6,64,1,16,32,15,61,3
66079,269,227,41,128,48,10,83,116,13,15,42,4,13,13,12,30,12
66080,368,307,56,126,95,30,100,174,18,15,61,2,12,24,23,53,8
66083,2110,1757,415,931,353,58,729,802,179,47,353,81,66,118,88,280,73
66085,1778,1592,167,939,462,24,723,729,91,49,186,45,93,35,13,137,49
66086,2491,1953,402,1009,443,99,883,795,183,92,538,76,201,143,118,475,63
66087,804,573,112,271,141,49,210,264,53,46,231,33,43,83,72,201,30
66088,937,669,103,333,169,64,266,310,47,46,268,30,59,52,127,243,25
66090,1018,705,167,321,172,45,250,337,85,33,313,40,82,87,104,282,31
66091,158,113,9,46,50,8,25,79,5,4,45,0,18,11,16,45,0
66092,1368,1067,242,569,231,25,454,454,119,40,301,63,73,109,56,282,19
66093,223,172,16,76,70,10,50,84,17,21,51,14,11,10,16,35,16
66094,210,138,42,62,28,6,58,52,20,8,72,20,14,33,5,63,9
66095,366,253,56,117,54,26,91,119,27,16,113,10,25,50,28,105,8
66097,421,329,58,153,89,29,122,150,27,30,92,7,22,27,36,86,6
66101,5232,3092,999,1370,515,208,799,754,965,574,2140,234,657,698,551,1883,257
66102,10624,6795,2186,2947,1279,383,1994,1985,1818,998,3829,659,1427,1030,713,3336,493
66103,6632,3143,1199,1298,500,146,933,1005,707,498,3489,1648,1119,513,209,2782,707
66104,10363,7038,1516,3323,1635,564,1568,2428,1635,1407,3325,456,1045,1141,683,2902,423
66105,988,718,250,300,139,29,250,220,161,87,270,42,116,76,36,214,56
66106,8790,6470,1600,3071,1462,337,2084,2469,1176,741,2320,417,758,643,502,1976,344
66109,5676,4567,630,2452,1229,256,1756,2120,368,323,1109,170,351,371,217,964,145
66111,4162,2930,734,1310,784,102,905,1304,424,297,1232,246,373,394,219,1040,192
66112,4824,3048,795,1329,691,233,860,1187,653,348,1776,514,563,405,294,1538,238
66115,0,0,0,0,0,0,0,0,0,0,0,0,0,0,0,0,0
66118,0,0,0,0,0,0,0,0,0,0,0,0,0,0,0,0,0
66202,8158,4103,987,1834,907,375,1213,1929,509,452,4055,1652,1394,586,423,3334,721
66203,8588,5412,1235,2386,1402,389,1757,2484,744,427,3176,954,1125,690,407,2629,547
66204,8629,4692,1388,1968,978,358,1488,2202,640,362,3937,1383,1286,724,544,3185,752
66205,6396,3886,852,1798,851,385,1313,1820,400,353,2510,613,837,628,432,2062,448
66206,3865,2903,178,1402,930,393,1034,1537,128,204,962,76,264,208,414,892,70
66207,5333,3869,237,1807,1352,473,1394,2023,172,280,1464,136,387,516,425,1275,189
66208,9383,6118,1015,2887,1478,738,2223,3046,528,321,3265,655,1061,815,734,2860,405
66209,6571,5289,263,3305,1427,294,2560,2420,180,129,1282,303,345,312,322,1155,127
66210,7566,4762,898,2750,959,155,1980,2230,277,275,2804,1259,1023,397,125,2250,554
66211,1441,971,60,495,305,111,413,522,5,31,470,79,173,128,90,425,45
66212,14688,8889,1633,3997,2536,723,2810,4424,922,733,5799,1747,1490,1435,1127,4811,988
66213,9877,6939,1453,4400,981,105,3822,2484,402,231,2938,1308,1061,337,232,2295,643
66214,5401,3186,763,1505,725,193,1238,1427,263,258,2215,991,719,358,147,1745,470
66215,9838,6652,1206,3760,1383,303,2781,2901,608,362,3186,1178,777,628,603,2469,717
66216,8370,6621,958,4089,1405,169,2972,2776,480,393,1749,449,671,470,159,1479,270
66217,1577,1182,181,554,397,50,464,639,36,43,395,186,108,66,35,303,92
66218,1121,968,282,500,178,8,417,491,26,34,153,19,99,26,9,118,35
66219,3122,2112,533,1285,274,20,1065,845,138,64,1010,670,311,29,0,764,246
66220,519,460,48,245,167,0,193,255,12,0,59,16,43,0,0,43,16
66221,1753,1678,184,1227,260,7,1101,490,54,33,75,21,33,21,0,58,17
66223,4089,3530,808,2258,434,30,2155,1122,181,72,559,100,328,103,28,444,115
66224,2096,1783,242,1254,287,0,1100,554,94,35,313,51,142,61,59,283,30
66226,2220,1941,581,1124,210,26,1095,732,69,45,279,125,103,43,8,186,93
66227,578,482,49,298,119,16,196,248,17,21,96,8,40,20,28,85,11
66401,704,518,61,231,155,71,165,289,29,35,186,22,48,51,65,173,13
66402,942,774,114,428,200,32,340,353,57,24,168,18,61,60,29,140,28
66403,304,234,36,109,57,32,106,95,18,15,70,17,19,24,10,64,6
66404,203,161,20,91,37,13,100,45,5,11,42,9,3,15,15,40,2
66406,209,145,32,72,27,14,67,61,5,12,64,0,21,24,19,55,9
66407,193,127,32,56,21,18,44,61,12,10,66,9,40,11,6,45,21
66408,196,154,19,87,39,9,73,66,11,4,42,2,3,9,28,42,0
66409,936,819,83,480,232,24,313,456,33,17,117,28,38,36,15,101,16
66411,566,400,64,175,120,41,144,199,33,24,166,22,33,62,49,146,20
66412,138,103,0,37,55,11,25,78,0,0,35,0,10,9,16,35,0
66413,772,534,82,266,142,44,196,272,37,29,238,20,51,96,71,225,13
66414,1158,868,146,478,188,56,319,341,175,33,290,49,121,86,34,242,48
66415,360,230,25,105,72,28,85,133,12,0,130,22,6,30,72,126,4
66416,190,137,25,56,43,13,51,70,13,3,53,10,21,9,13,50,3
66417,122,108,24,53,17,14,64,34,6,4,14,1,1,5,7,10,4
66418,196,156,38,58,50,10,58,80,5,13,40,0,18,5,17,34,6
66419,163,136,38,52,41,5,43,73,15,5,27,2,7,13,5,25,2
66422,211,165,25,81,42,17,59,84,15,7,46,8,18,12,8,37,9
66423,358,249,29,95,110,15,67,145,24,13,109,10,36,29,34,97,12
66424,240,156,43,65,22,26,61,75,19,1,84,17,11,13,43,73,11
66425,240,171,14,86,40,31,71,87,7,6,69,7,12,29,21,69,0
66427,583,402,40,187,119,56,151,211,12,28,181,18,25,50,88,174,7
66428,174,113,10,65,34,4,45,54,6,8,61,18,20,0,23,48,13
66429,228,196,15,120,52,9,66,113,10,7,32,0,11,15,6,32,0
66431,270,209,58,100,39,12,102,83,14,10,61,16,16,13,16,46,15
66432,177,132,15,61,41,15,49,72,5,6,45,3,16,19,7,44,1
66434,2143,1446,258,674,381,133,443,715,201,87,697,113,146,190,248,646,51
66436,2183,1529,280,718,380,151,552,683,175,119,654,108,117,177,252,595,59
66438,58,45,14,27,4,0,27,18,0,0,13,0,0,0,13,13,0
66439,1090,703,138,318,184,63,233,309,106,55,387,52,73,116,146,358,29
66440,654,559,100,273,152,34,232,262,27,38,95,21,14,43,17,87,8
66441,8710,6048,2059,2603,1137,249,2117,2436,1016,479,2662,575,832,736,519,2223,439
66442,2076,2059,1493,558,8,0,1574,317,159,9,17,17,0,0,0,7,10
66449,298,214,40,104,36,34,103,95,12,4,84,18,15,27,24,72,12
66450,62,45,5,27,9,4,14,21,6,4,17,4,5,2,6,11,6
66451,657,474,56,234,148,36,163,252,40,19,183,35,49,58,41,141,42
66501,115,72,14,42,14,2,26,32,14,0,43,5,29,4,5,33,10
66502,15882,7729,2684,3195,1453,397,2614,3544,934,637,8153,5438,1167,788,760,4829,3324
66503,4254,3048,679,1568,690,111,1190,1514,198,146,1206,433,304,299,170,932,274
66506,0,0,0,0,0,0,0,0,0,0,0,0,0,0,0,0,0
66507,364,285,40,147,92,6,133,126,11,15,79,9,26,9,35,74,5
66508,1926,1229,190,553,361,125,460,617,85,67,697,92,200,182,223,622,75
66509,806,641,125,336,153,27,280,240,81,40,165,14,61,64,26,137,28
66510,327,230,43,120,49,18,95,109,11,15,97,9,42,18,28,90,7
66512,1172,927,180,513,193,41,388,387,80,72,245,22,79,100,44,223,22
66514,616,489,85,251,144,9,147,286,43,13,127,18,50,41,18,114,13
66515,181,152,18,74,54,6,51,91,6,4,29,3,8,7,11,26,3
66516,124,105,21,51,29,4,57,44,2,2,19,7,3,0,9,17,2
66517,658,447,241,140,54,12,227,145,61,14,211,70,81,48,12,163,48
66518,89,70,3,41,24,2,38,29,3,0,19,8,8,2,1,18,1
66520,209,167,20,93,34,20,72,76,7,12,42,12,11,12,7,35,7
66521,650,422,77,182,121,42,163,209,33,17,228,50,56,52,70,203,25
66522,17,12,4,4,1,3,4,3,2,3,5,0,0,5,0,3,2
66523,1602,1117,214,476,326,101,375,553,156,33,485,117,83,110,175,442,43
66524,924,713,129,331,186,67,255,388,46,24,211,20,64,43,84,189,22
66526,263,206,68,89,38,11,91,81,18,16,57,4,11,16,26,55,2
66527,146,119,26,48,19,26,35,45,29,10,27,4,3,5,15,23,4
66528,330,268,52,145,58,13,105,106,40,17,62,9,25,19,9,55,7
66531,478,356,94,146,87,29,155,149,32,20,122,12,29,53,28,104,18
66532,324,231,43,101,58,29,94,108,21,8,93,7,10,37,39,84,9
66533,622,472,95,197,144,36,158,257,42,15,150,19,30,56,45,138,12
66534,1291,896,171,407,227,91,365,422,54,55,395,81,82,75,157,365,30
66535,902,643,163,305,136,39,254,291,83,15,259,58,110,47,44,199,60
66536,988,702,137,343,167,55,323,280,51,48,286,73,80,66,67,277,9
66537,536,392,75,179,120,18,166,188,23,15,144,19,56,40,29,127,17
66538,1356,926,145,420,238,123,390,436,46,54,430,50,79,151,150,395,35
66539,973,788,122,482,163,21,338,348,58,44,185,24,93,50,18,171,14
66540,223,163,27,74,51,11,62,75,18,8,60,5,12,30,13,60,0
66541,96,70,10,27,23,10,28,38,3,1,26,1,0,11,14,25,1
66542,1056,876,118,454,297,7,304,419,88,65,180,13,72,31,64,148,32
66543,287,243,28,101,95,19,82,135,16,10,44,7,16,3,18,40,4
66544,149,105,16,57,24,8,63,42,0,0,44,4,5,19,16,41,3
66546,422,351,35,223,81,12,156,157,26,12,71,11,22,21,17,71,0
66547,2444,1831,370,939,403,119,844,745,135,107,613,139,123,154,197,516,97
66548,408,270,52,111,67,40,110,119,20,21,138,7,16,35,80,132,6
66549,574,414,83,161,126,44,148,234,13,19,160,25,44,51,40,144,16
66550,261,195,45,79,51,20,66,104,18,7,66,8,17,29,12,60,6
66552,161,91,24,30,26,11,25,49,12,5,70,8,14,24,24,67,3
66554,241,157,21,85,35,16,77,69,4,7,84,12,36,15,21,79,5
66603,867,365,167,131,53,14,77,76,159,53,502,153,188,122,39,446,56
66604,10292,5919,1500,2534,1366,519,1794,2653,928,544,4373,1135,1295,961,982,3712,661
66605,7225,5238,1129,2520,1269,320,1652,2094,952,540,1987,324,718,649,296,1714,273
66606,5677,2933,715,1324,649,245,896,1377,498,162,2744,630,964,517,633,2411,333
66607,3332,2198,659,840,531,168,580,651,575,392,1134,201,405,338,190,983,151
66608,2443,1509,390,639,375,105,431,560,276,242,934,159,346,258,171,802,132
66609,2978,1914,404,935,504,71,568,935,313,98,1064,312,375,304,73,903,161
66610,2371,2101,173,1286,579,63,964,1002,59,76,270,42,84,120,24,219,51
66611,4750,2676,507,1144,743,282,710,1369,343,254,2074,515,542,444,573,1791,283
66612,1580,520,174,253,77,16,100,168,142,110,1060,264,355,291,150,962,98
66614,12878,8211,1798,3844,1999,570,3026,3688,927,570,4667,1401,1331,1206,729,3932,735
66615,559,466,30,228,185,23,126,279,41,20,93,0,34,40,19,75,18
66616,2587,1698,382,819,360,137,510,690,280,218,889,140,224,327,198,760,129
66617,3005,2471,301,1351,701,118,1036,1215,105,115,534,83,139,240,72,442,92
66618,2656,2240,341,1163,647,89,904,1165,135,36,416,46,153,133,84,354,62
66619,1050,813,289,463,51,10,376,191,223,23,237,121,82,28,6,167,70
66701,4997,3332,730,1456,832,314,1208,1503,391,230,1665,312,313,561,479,1482,183
66710,382,270,23,118,87,42,69,156,21,24,112,12,17,38,45,110,2
66711,305,223,35,116,56,16,90,90,20,23,82,12,19,22,29,65,17
66712,903,545,128,232,144,41,198,266,58,23,358,46,85,92,135,336,22
66713,2363,1653,389,705,428,131,591,779,173,110,710,104,92,258,256,644,66
66714,69,39,4,13,14,8,9,26,4,0,30,0,10,11,9,27,3
66716,219,143,32,48,46,17,56,75,10,2,76,4,15,37,20,74,2
66717,220,168,28,70,55,15,51,98,18,1,52,6,13,19,14,46,6
66720,4761,3249,630,1540,840,239,1141,1540,370,198,1512,303,343,432,434,1365,147
66724,394,246,41,104,82,19,79,125,21,21,148,26,56,40,26,119,29
66725,2483,1705,356,776,420,153,605,787,195,118,778,91,191,245,251,722,56
66732,150,114,18,46,31,19,36,68,2,8,36,1,5,15,15,34,2
66733,938,669,85,329,161,94,218,382,38,31,269,41,72,96,60,244,25
66734,97,84,29,18,27,10,36,48,0,0,13,13,0,0,0,13,0
66735,161,103,13,61,23,6,32,47,13,11,58,0,10,15,33,47,11
66736,1781,1189,231,448,371,139,432,623,92,42,592,45,120,222,205,537,55
66738,182,119,23,68,24,4,40,72,5,2,63,4,24,15,20,56,7
66739,2300,1658,416,693,476,73,545,706,241,166,642,86,171,221,164,576,66
66740,145,119,38,54,21,6,54,52,8,5,26,4,5,12,5,26,0
66741,101,89,0,35,36,18,22,61,0,6,12,6,6,0,0,12,0
66743,1626,1166,220,528,314,104,411,586,122,47,460,72,109,106,173,406,54
66746,104,86,7,38,28,13,25,57,4,0,18,4,5,4,5,16,2
66748,1177,778,146,319,237,76,260,385,73,60,399,52,96,104,147,350,49
66749,3442,2266,489,1014,577,186,708,1046,366,146,1176,233,292,277,374,1032,144
66751,376,278,50,127,74,27,106,137,22,13,98,20,24,33,21,90,8
66753,434,347,52,163,93,39,119,184,36,8,87,10,12,35,30,74,13
66754,180,105,0,65,33,7,38,47,12,8,75,0,33,6,36,57,18
66755,488,352,37,171,104,40,97,201,42,12,136,18,26,38,54,111,25
66756,424,295,66,135,75,19,93,148,28,26,129,9,41,38,41,111,18
66757,1585,1075,257,491,240,87,376,490,147,62,510,83,156,96,175,443,67
66758,104,86,6,32,34,14,20,44,18,4,18,0,6,2,10,16,2
66759,18,13,0,9,2,2,4,7,0,2,5,0,0,3,2,2,3
66760,40,23,0,18,5,0,8,15,0,0,17,0,8,9,0,17,0
66761,116,78,11,29,33,5,13,46,19,0,38,19,9,5,5,32,6
66762,9882,5669,1566,2377,1264,462,1864,2455,887,463,4213,1740,939,758,776,3160,1053
66763,1147,768,194,307,177,90,248,375,100,45,379,91,55,97,136,322,57
66767,225,134,8,60,60,6,24,77,8,25,91,11,10,41,29,78,13
66769,197,153,30,87,36,0,67,71,15,0,44,13,5,17,9,33,11
66770,404,292,87,125,64,16,112,104,52,24,112,21,26,33,32,100,12
66771,359,262,44,139,64,15,123,93,35,11,97,16,13,32,36,86,11
66772,100,66,8,38,17,3,32,24,3,7,34,1,13,9,11,33,1
66773,347,258,56,113,59,30,91,104,36,27,89,5,8,51,25,83,6
66775,101,73,14,34,19,6,19,44,7,3,28,3,2,10,13,28,0
66776,405,338,72,133,114,19,148,132,25,33,67,18,13,20,16,54,13
66777,303,168,6,60,66,36,34,116,17,1,135,3,32,54,46,117,18
66778,60,40,10,20,8,2,12,17,3,8,20,0,6,11,3,18,2
66779,238,177,34,78,49,16,64,90,17,6,61,10,9,22,20,61,0
66780,268,186,46,62,62,16,77,96,9,4,82,9,15,32,26,79,3
66781,603,411,109,186,95,21,186,152,47,26,192,25,40,65,62,164,28
66782,105,76,20,32,19,5,28,28,10,10,29,11,6,8,4,19,10
66783,1091,705,97,333,170,105,219,377,71,38,386,44,85,119,138,374,12
66801,11571,7173,1956,3400,1366,451,2875,2972,960,366,4398,1893,968,700,837,3360,1038
66830,126,88,23,43,20,2,46,34,8,0,38,2,21,11,4,33,5
66833,221,163,34,63,51,15,67,83,7,6,58,4,10,19,25,54,4
66834,392,292,48,164,52,28,110,136,23,23,100,15,21,20,44,100,0
66835,521,398,91,204,88,15,160,175,43,20,123,17,35,37,34,110,13
66838,87,58,8,19,17,14,15,37,2,4,29,3,9,7,10,29,0
66839,1615,1129,222,594,216,97,424,527,125,53,486,54,135,136,161,450,36
66840,283,226,44,92,75,15,96,111,9,10,57,10,18,14,15,56,1
66842,131,101,16,37,39,9,18,69,4,10,30,1,10,10,9,30,0
66843,117,75,5,31,37,2,21,45,4,5,42,0,18,22,2,42,0
66845,485,318,60,131,99,28,93,151,45,29,167,26,40,51,50,152,15
66846,1693,1170,163,541,325,141,418,591,105,56,523,63,110,150,200,495,28
66849,228,156,21,81,36,18,57,86,10,3,72,18,10,26,18,58,14
66850,121,69,11,36,18,4,32,33,4,0,52,7,25,8,12,45,7
66851,308,226,29,101,71,25,62,131,19,14,82,12,29,29,12,66,16
66852,289,194,27,113,32,22,88,85,12,9,95,23,15,32,25,76,19
66853,203,157,38,48,58,13,50,85,12,10,46,11,13,10,12,44,2
66854,395,273,32,136,88,17,100,132,26,15,122,13,31,48,30,111,11
66856,632,479,102,220,116,41,176,234,51,18,153,17,42,40,54,139,14
66857,395,286,33,120,107,26,84,165,29,8,109,18,37,30,24,102,7
66858,187,130,18,54,38,20,60,56,6,8,57,4,15,13,25,47,10
66859,75,50,6,25,15,4,15,22,8,5,25,2,6,6,11,25,0
66860,569,374,61,163,111,39,116,214,27,17,195,22,51,60,62,166,29
66861,1365,965,145,401,297,122,336,513,91,25,400,65,64,103,168,357,43
66862,83,48,4,18,14,12,15,29,4,0,35,7,11,8,9,32,3
66863,33,25,0,6,11,8,6,11,0,8,8,0,8,0,0,8,0
66864,209,140,37,55,44,4,55,63,16,6,69,10,8,32,19,63,6
66865,393,295,52,133,83,27,106,154,25,10,98,19,23,29,27,86,12
66866,741,522,94,219,149,60,190,252,49,31,219,27,74,67,51,198,21
66868,327,240,38,112,65,25,87,107,31,15,87,14,40,9,24,62,25
66869,347,249,46,122,57,24,111,101,23,14,98,16,21,33,28,86,12
66870,97,69,4,33,20,12,19,39,2,9,28,0,0,11,17,28,0
66871,560,403,68,206,88,41,167,208,20,8,157,14,40,56,47,141,16
66872,425,326,64,150,93,19,126,163,24,13,99,8,30,28,33,91,8
66901,2849,1813,366,731,521,195,624,906,180,103,1036,255,228,247,306,880,156
66930,70,58,8,20,26,4,20,38,0,0,12,2,6,2,2,12,0
66932,90,72,10,44,12,6,37,35,0,0,18,2,4,2,10,18,0
66933,180,109,10,32,39,28,32,53,8,16,71,5,20,24,22,64,7
66935,1260,787,97,324,252,114,217,481,60,29,473,48,122,109,194,445,28
66936,241,153,14,74,45,20,47,83,11,12,88,10,26,23,29,80,8
66937,402,260,36,130,75,19,112,114,22,12,142,24,14,44,60,134,8
66938,462,314,35,132,90,57,116,173,13,12,148,13,18,53,64,140,8
66939,313,230,30,96,73,31,93,124,11,2,83,6,12,21,44,80,3
66940,182,128,16,54,40,18,33,87,8,0,54,5,20,14,15,52,2
66941,146,88,9,31,40,8,24,58,6,0,58,19,15,8,16,55,3
66942,139,85,7,29,43,6,23,58,0,4,54,4,13,19,18,50,4
66943,221,137,11,59,46,21,42,74,13,8,84,8,16,15,45,81,3
66944,119,75,5,26,26,18,26,44,0,5,44,5,10,9,20,42,2
66945,435,293,45,136,76,36,114,154,8,17,142,15,23,60,44,134,8
66946,71,53,8,18,23,4,17,32,0,4,18,5,11,2,0,18,0
66948,254,187,27,77,65,18,60,108,9,10,67,3,22,18,24,55,12
66949,318,199,38,68,63,30,70,105,17,7,119,15,31,35,38,106,13
66951,348,229,23,125,52,29,95,110,15,9,119,13,11,22,73,119,0
66952,308,220,43,49,86,42,58,129,3,30,88,8,26,34,20,75,13
66953,280,196,30,78,63,25,60,110,12,14,84,18,13,15,38,78,6
66955,52,35,13,10,12,0,8,18,7,2,17,2,6,6,3,15,2
66956,592,365,23,168,111,63,120,217,18,10,227,31,60,72,64,209,18
66958,149,98,17,39,32,10,42,46,6,4,51,5,12,17,17,47,4
66959,116,81,12,40,21,8,33,46,2,0,35,4,9,0,22,33,2
66960,94,54,9,19,20,6,17,33,3,1,40,0,10,11,19,38,2
66962,113,81,3,41,24,13,34,35,3,9,32,9,5,9,9,30,2
66963,85,61,5,35,10,11,24,35,2,0,24,2,0,10,12,24,0
66964,142,93,5,41,37,10,19,71,3,0,49,4,13,21,11,39,10
66966,284,182,23,84,51,24,75,93,12,2,102,14,25,14,49,96,6
66967,1041,701,77,323,203,98,207,403,70,21,340,35,56,107,142,326,14
66968,793,524,72,203,173,76,162,309,39,14,269,30,57,81,101,242,27
66970,60,51,4,15,22,10,10,39,0,2,9,0,5,2,2,9,0
67001,333,263,56,137,55,15,176,70,5,12,70,3,10,32,25,70,0
67002,3288,2666,483,1615,452,116,1318,986,274,88,622,150,191,213,68,554,68
67003,1256,809,133,312,241,123,274,407,68,60,447,75,96,109,167,419,28
67004,389,267,39,117,92,19,89,133,25,20,122,19,31,23,49,116,6
67005,6521,4424,942,2004,1143,335,1528,2054,543,299,2097,379,550,602,566,1842,255
67008,292,242,35,99,92,16,75,125,16,26,50,6,11,19,14,47,3
67009,348,238,28,110,67,33,69,141,15,13,110,19,28,22,41,103,7
67010,4901,3658,729,1892,776,261,1508,1703,272,175,1243,259,318,335,331,1100,143
67012,14,0,0,0,0,0,0,0,0,0,14,0,0,7,7,14,0
67013,1207,926,116,561,225,24,456,375,69,26,281,70,42,119,50,232,49
67016,143,106,34,45,23,4,47,46,12,1,37,11,4,15,7,33,4
67017,641,507,91,252,142,22,201,260,32,14,134,23,48,20,43,124,10
67018,61,40,2,24,12,2,22,18,0,0,21,2,4,13,2,19,2
67019,395,279,63,102,92,22,92,145,24,18,116,9,31,34,42,108,8
67020,687,506,96,242,139,29,207,244,27,28,181,41,44,71,25,156,25
67021,39,33,2,11,16,4,11,16,4,2,6,0,0,3,3,6,0
67022,779,455,73,208,115,59,187,224,32,12,324,43,67,109,105,310,14
67023,99,74,11,43,14,6,17,47,6,4,25,2,4,11,8,21,4
67024,430,302,46,118,100,38,104,150,28,20,128,4,10,49,65,127,1
67025,1271,990,157,592,181,60,474,403,80,33,281,39,77,72,93,259,22
67026,1600,1260,249,717,241,53,614,450,129,67,340,16,94,106,124,315,25
67028,107,80,14,35,20,11,31,47,2,0,27,0,4,12,11,27,0
67029,466,285,52,91,96,46,82,172,24,7,181,11,32,61,77,175,6
67030,678,587,110,318,124,35,297,202,52,36,91,7,31,29,24,88,3
67031,800,591,107,304,136,44,250,276,49,16,209,22,54,63,70,196,13
67035,436,314,54,141,77,42,110,165,31,8,122,5,28,47,42,115,7
67036,66,39,2,21,7,9,12,25,2,0,27,3,11,2,11,27,0
67037,7793,6238,1057,3664,1317,200,2820,2497,630,291,1555,280,535,471,269,1358,197
67038,233,166,22,92,45,7,81,63,15,7,67,20,25,10,12,58,9
67039,1272,979,162,525,230,62,389,414,107,69,293,33,126,68,66,232,61
67041,82,69,14,29,17,9,36,28,5,0,13,0,5,5,3,11,2
67042,6546,4384,923,2032,1081,348,1554,1988,549,293,2162,505,600,533,524,1876,286
67045,1734,1132,206,468,341,117,372,618,129,13,602,82,144,184,192,560,42
67047,380,238,25,65,104,44,59,161,11,7,142,4,58,53,27,138,4
67049,38,27,0,7,20,0,5,20,2,0,11,6,0,3,2,11,0
67050,593,457,68,246,120,23,245,173,16,23,136,17,33,58,28,115,21
67051,190,141,41,62,34,4,50,73,11,7,49,14,12,13,10,47,2
67052,1838,1516,294,906,273,43,753,574,158,31,322,85,119,78,40,262,60
67053,207,142,34,52,31,25,55,73,9,5,65,10,9,14,32,61,4
67054,896,582,100,250,164,68,173,350,48,11,314,42,71,81,120,289,25
67056,1020,745,137,318,216,74,287,394,28,36,275,66,58,64,87,241,34
67057,112,80,3,36,27,14,15,54,6,5,32,4,3,11,14,32,0
67058,942,612,95,287,159,71,210,320,50,32,330,45,86,105,94,300,30
67059,326,223,43,100,60,20,88,109,16,10,103,18,30,40,15,100,3
67060,4182,3272,708,1666,768,130,1281,1394,411,186,910,111,318,299,182,787,123
67061,93,70,6,26,26,12,26,38,0,6,23,0,6,13,4,21,2
67062,1381,1024,204,469,242,109,409,498,83,34,357,69,98,68,122,317,40
67063,1422,999,160,416,276,147,372,543,52,32,423,82,110,102,129,383,40
67065,95,78,5,40,22,11,32,46,0,0,17,0,0,4,13,17,0
67066,126,93,20,39,30,4,25,60,5,3,33,7,2,12,12,33,0
67067,413,374,100,201,62,11,173,169,19,13,39,7,22,6,4,35,4
67068,1875,1302,190,640,355,117,420,642,154,86,573,84,110,175,204,538,35
67070,512,349,49,175,89,36,147,168,17,17,163,17,33,39,74,155,8
67071,57,36,12,20,4,0,12,23,0,1,21,2,9,8,2,21,0
67072,163,114,9,82,15,8,53,37,15,9,49,11,20,12,6,48,1
67073,119,98,18,54,20,6,40,49,5,4,21,2,5,10,4,21,0
67074,573,456,65,254,131,6,152,239,45,20,117,42,21,23,31,105,12
67101,832,706,140,400,141,25,334,267,64,41,126,23,26,43,34,107,19
67102,18,14,6,1,5,2,5,9,0,0,4,2,0,0,2,4,0
67103,131,112,5,64,39,4,29,71,6,6,19,4,2,7,6,17,2
67104,1161,805,135,351,241,78,274,422,68,41,356,38,94,116,108,329,27
67105,85,71,10,34,20,7,20,42,7,2,14,3,1,6,4,11,3
67106,133,116,17,57,25,17,40,62,12,2,17,10,7,0,0,17,0
67107,1069,788,115,360,224,89,291,423,32,42,281,35,91,87,68,249,32
67108,713,560,93,291,122,54,231,278,19,32,153,15,42,42,54,143,10
67109,165,126,21,67,30,8,54,60,9,3,39,0,8,9,22,39,0
67110,2860,2246,492,1061,595,98,891,1025,252,78,614,131,141,175,167,573,41
67111,138,91,18,14,38,21,28,59,4,0,47,6,7,17,17,41,6
67112,137,111,6,62,26,17,47,51,2,11,26,4,11,4,7,26,0
67114,8156,5744,1211,2715,1306,512,2128,2628,614,374,2412,442,691,702,577,2141,271
67117,566,307,30,97,106,74,76,218,4,9,259,24,24,62,149,248,11
67118,335,261,33,148,57,23,133,109,14,5,74,4,21,23,26,72,2
67119,658,492,74,232,124,62,195,235,42,20,166,26,50,39,51,160,6
67120,431,368,52,229,80,7,177,163,16,12,63,6,27,6,24,63,0
67122,104,85,7,14,64,0,14,64,0,7,19,0,11,8,0,19,0
67123,295,216,33,110,45,28,75,103,6,32,79,19,30,17,13,59,20
67124,3320,2146,338,1005,570,233,706,1106,267,67,1174,209,298,354,313,1058,116
67127,335,229,24,95,94,16,76,128,10,15,106,13,47,23,23,103,3
67128,41,38,10,23,0,5,33,5,0,0,3,0,0,3,0,3,0
67131,34,20,6,8,6,0,8,8,4,0,14,0,0,5,9,11,3
67132,131,108,14,68,21,5,43,45,14,6,23,4,10,3,6,23,0
67133,1940,1643,301,1008,284,50,784,621,186,52,297,30,131,86,50,279,18
67134,135,110,23,46,33,8,45,65,0,0,25,2,8,9,6,23,2
67135,1153,914,189,459,208,58,395,383,85,51,239,21,85,61,72,210,29
67137,322,235,38,101,69,27,73,133,20,9,87,2,30,23,32,66,21
67138,205,121,14,54,35,18,38,72,5,6,84,2,14,33,35,80,4
67140,335,262,41,106,92,23,93,133,12,24,73,19,16,22,16,68,5
67142,149,97,7,45,31,14,35,52,2,8,52,7,20,8,17,50,2
67143,42,25,1,13,11,0,5,13,0,7,17,0,3,8,6,17,0
67144,1025,836,124,460,220,32,357,404,44,31,189,26,68,57,38,182,7
67146,662,508,107,269,104,28,230,221,38,19,154,19,62,35,38,141,13
67147,2842,2268,404,1146,600,118,950,1045,181,92,574,114,156,166,138,521,53
67149,327,253,44,125,82,2,75,149,15,14,74,11,19,37,7,57,17
67150,10,6,0,0,4,2,0,6,0,0,4,0,0,0,4,4,0
67151,232,169,27,77,50,15,72,77,14,6,63,14,25,24,0,60,3
67152,3938,2743,542,1248,720,233,996,1209,313,225,1195,202,316,352,325,1074,121
67154,507,421,43,227,94,57,183,202,12,24,86,23,32,17,14,71,15
67155,99,61,11,31,10,9,28,29,4,0,38,2,17,2,17,38,0
67156,5731,3892,864,1737,1031,260,1477,1740,454,221,1839,319,479,426,615,1670,169
67159,61,43,6,13,18,6,17,22,0,4,18,1,3,5,9,15,3
67202,464,67,39,21,0,7,5,41,0,21,397,154,186,45,12,391,6
67203,13446,7202,2278,2884,1347,693,2233,3052,1220,697,6244,1671,2165,1308,1100,5379,865
67204,7969,5514,1073,2542,1354,545,1889,2609,638,378,2455,334,742,800,579,2154,301
67205,2770,2403,448,1478,408,69,1318,942,81,62,367,119,111,113,24,315,52
67206,5561,3736,455,1818,1119,344,1461,1868,172,235,1825,663,457,353,352,1573,252
67207,10082,5868,1782,2616,1167,303,2085,2481,882,420,4214,1588,1512,727,387,3557,657
67208,8161,4733,1276,2286,816,355,1490,1725,973,545,3428,1265,991,603,569,2784,644
67209,4749,3606,972,1656,788,190,1476,1635,296,199,1143,268,389,299,187,1008,135
67210,3463,2747,1234,1250,198,65,1475,616,472,184,716,210,239,189,78,611,105
67211,9146,5050,1555,2148,882,465,1606,1865,1019,560,4096,951,1637,849,659,3492,604
67212,17594,12551,2686,6563,2771,531,5242,5251,1381,677,5043,1716,1658,1068,601,4351,692
67213,9318,5184,1626,2155,976,427,1718,1849,975,642,4134,979,1490,790,875,3596,538
67214,6864,3988,1252,1666,751,319,1031,888,1210,859,2876,531,1045,896,404,2572,304
67215,1435,1220,254,688,248,30,556,539,84,41,215,37,138,40,0,185,30
67216,9481,6589,2221,2801,1289,278,2302,2318,1330,639,2892,687,1121,732,352,2356,536
67217,11730,8234,2219,3709,1841,465,2812,3337,1320,765,3496,857,1160,1051,428,2896,600
67218,10638,5731,1945,2114,1132,540,1781,2181,1137,632,4907,1168,1806,1012,921,4249,658
67219,3783,2868,743,1244,723,158,929,1053,477,409,915,176,295,315,129,822,93
67220,4537,3187,703,1683,688,113,1339,1319,309,220,1350,552,336,208,254,1099,251
67226,5827,4095,863,2229,825,178,1839,1900,197,159,1732,649,613,216,254,1431,301
67230,2167,1887,127,1128,518,114,835,932,78,42,280,0,140,61,79,228,52
67233,0,0,0,0,0,0,0,0,0,0,0,0,0,0,0,0,0
67235,1910,1755,190,1182,365,18,924,715,91,25,155,25,28,80,22,140,15
67301,5584,3777,777,1678,939,383,1263,1730,529,255,1807,355,510,448,494,1649,158
67330,600,444,106,205,96,37,183,203,42,16,156,21,35,53,47,145,11
67332,92,73,12,28,31,2,33,36,2,2,19,4,4,3,8,15,4
67333,1192,855,178,394,253,30,343,375,86,51,337,53,72,79,133,316,21
67334,35,23,2,5,14,2,2,14,5,2,12,3,0,5,4,12,0
67335,1482,1007,200,427,293,87,353,502,81,71,475,83,139,130,123,420,55
67336,738,472,85,189,141,57,117,234,64,57,266,23,77,89,77,239,27
67337,5966,3885,840,1558,1086,401,1161,1886,551,287,2081,290,475,589,727,1907,174
67340,178,120,29,51,27,13,36,64,10,10,58,13,16,21,8,47,11
67341,140,113,21,40,38,14,26,64,19,4,27,0,22,0,5,27,0
67342,399,309,28,158,101,22,106,166,19,18,90,3,12,25,50,88,2
67344,364,288,35,132,91,30,107,158,12,11,76,6,19,13,38,74,2
67345,80,53,5,27,19,2,14,31,4,4,27,0,13,12,2,27,0
67346,191,124,17,51,35,21,45,65,11,3,67,4,22,14,27,61,6
67347,196,147,19,57,60,11,29,96,8,14,49,3,14,15,17,47,2
67349,513,338,46,135,115,42,92,201,25,20,175,20,29,75,51,172,3
67351,155,131,18,59,39,15,48,76,2,5,24,2,6,8,8,24,0
67352,279,183,37,70,57,19,64,91,19,9,96,5,24,30,37,96,0
67353,298,204,29,58,76,41,50,131,10,13,94,11,18,25,40,86,8
67354,277,198,56,76,41,25,74,77,16,31,79,9,2,22,46,70,9
67355,119,77,13,19,43,2,20,51,4,2,42,0,7,27,8,42,0
67356,1151,778,138,351,226,63,302,366,69,41,373,42,59,147,125,365,8
67357,5756,3787,788,1754,912,333,1204,1649,602,332,1969,349,624,495,501,1763,206
67360,169,120,14,47,37,22,39,55,6,20,49,3,15,19,12,43,6
67361,905,603,99,236,170,98,171,351,46,35,302,39,70,86,107,288,14
67363,26,21,0,9,12,0,9,12,0,0,5,0,0,0,5,5,0
67364,85,67,13,36,14,4,27,32,6,2,18,0,2,11,5,18,0
67401,19863,13087,2925,6157,3088,917,4773,5780,1626,908,6776,1765,1946,1673,1392,5752,1024
67410,4126,2806,489,1332,761,224,1040,1413,225,128,1320,178,319,384,439,1179,141
67416,420,352,68,172,94,18,158,162,27,5,68,6,26,19,17,57,11
67417,89,56,0,36,15,5,17,37,0,2,33,12,13,0,8,33,0
67418,112,77,14,26,29,8,22,46,5,4,35,8,8,14,5,35,0
67420,2042,1317,190,591,388,148,469,693,117,38,725,150,159,169,247,658,67
67422,424,348,56,178,85,29,134,178,32,4,76,10,20,26,20,67,9
67423,144,99,24,49,18,8,42,46,8,3,45,7,13,10,15,39,6
67425,313,207,24,120,55,8,86,104,8,9,106,4,24,29,49,101,5
67427,191,143,7,78,36,22,45,70,14,14,48,11,7,14,16,48,0
67428,588,474,92,209,140,33,184,250,20,20,114,17,32,34,31,110,4
67430,343,228,22,110,55,41,75,113,20,20,115,11,35,46,23,102,13
67431,874,669,99,326,186,58,226,355,60,28,205,38,62,53,52,178,27
67432,2660,1782,357,732,527,166,593,971,175,43,878,142,159,200,377,780,98
67436,303,230,29,137,42,22,109,100,17,4,73,7,23,25,18,58,15
67437,591,358,46,152,89,71,110,192,27,29,233,30,75,65,63,204,29
67438,108,88,18,30,37,3,32,46,7,3,20,0,2,11,7,20,0
67439,1244,836,140,327,292,77,256,470,77,33,408,61,114,91,142,390,18
67441,414,303,45,156,79,23,113,143,32,15,111,10,25,40,36,111,0
67442,108,58,0,45,5,8,18,40,0,0,50,9,19,7,15,41,9
67443,554,464,94,219,116,35,198,215,28,23,90,10,31,21,28,75,15
67444,262,179,18,67,77,17,37,115,16,11,83,12,24,24,23,79,4
67445,290,204,37,61,79,27,55,122,16,11,86,11,17,27,31,77,9
67446,324,237,22,113,80,22,70,143,19,5,87,13,14,40,20,76,11
67447,133,108,8,53,35,12,27,67,10,4,25,2,3,8,12,25,0
67448,531,411,74,214,109,14,188,199,22,2,120,11,27,23,59,105,15
67449,1418,884,143,411,248,82,293,464,92,35,534,53,116,173,192,487,47
67450,275,176,23,87,53,13,70,89,9,8,99,16,24,26,33,86,13
67451,424,306,27,141,105,33,116,152,19,19,118,13,14,28,63,113,5
67452,103,74,11,33,23,7,27,35,3,9,29,5,3,8,13,28,1
67454,289,196,28,74,72,22,54,118,20,4,93,8,29,18,38,84,9
67455,930,619,91,252,194,82,169,355,60,35,311,30,88,79,114,292,19
67456,1703,1159,187,518,336,118,415,605,103,36,544,110,130,96,208,495,49
67457,329,231,47,110,46,28,61,126,36,8,98,9,19,34,36,94,4
67458,103,73,13,33,14,13,19,52,2,0,30,6,11,4,9,30,0
67459,94,73,7,40,21,5,31,32,2,8,21,2,4,6,9,19,2
67460,6163,4308,875,2038,1057,338,1763,2071,337,137,1855,463,549,370,473,1632,223
67464,379,252,43,114,71,24,91,123,22,16,127,12,33,36,46,119,8
67466,364,240,37,88,76,39,73,148,11,8,124,6,20,48,50,115,9
67467,1201,812,117,419,241,35,255,420,108,29,389,45,70,113,161,352,37
67468,116,85,14,50,12,9,46,33,4,2,31,0,19,8,4,31,0
67470,240,187,18,117,36,16,44,92,47,4,53,7,12,20,14,51,2
67473,824,528,75,216,167,70,205,267,34,22,296,30,74,78,114,291,5
67474,104,72,3,36,21,12,21,49,2,0,32,3,9,8,12,31,1
67475,76,65,13,16,17,19,17,38,0,10,11,0,0,6,5,8,3
67478,38,27,3,15,7,2,10,12,3,2,11,5,4,0,2,9,2
67480,680,487,86,236,152,13,167,249,55,16,193,43,62,55,33,152,41
67481,293,207,32,102,52,21,87,105,11,4,86,5,18,38,25,77,9
67482,43,25,5,20,0,0,5,6,14,0,18,0,8,10,0,18,0
67483,161,110,21,57,18,14,46,57,3,4,51,3,15,10,23,47,4
67484,374,265,69,114,72,10,81,150,32,2,109,15,30,22,42,100,9
67485,167,114,16,51,34,13,62,43,0,9,53,10,10,9,24,50,3
67487,500,384,85,177,90,32,164,173,41,6,116,14,22,49,31,107,9
67490,436,278,48,126,76,28,124,120,15,19,158,19,26,35,78,147,11
67491,154,128,27,54,32,15,40,75,0,13,26,3,8,10,5,23,3
67492,124,92,22,43,25,2,41,46,5,0,32,8,15,7,2,19,13
67501,10675,6805,1856,2896,1516,537,2050,2976,1231,548,3870,940,1341,1068,521,3316,554
67502,9388,6683,1143,2968,1908,664,2233,3631,553,266,2705,465,616,781,843,2418,287
67505,1136,661,175,280,128,78,200,320,103,38,475,40,120,161,154,430,45
67510,149,114,7,50,41,16,41,70,0,3,35,0,14,21,0,29,6
67511,157,115,4,68,30,13,42,66,5,2,42,4,9,11,18,37,5
67512,106,80,12,31,26,11,17,58,1,4,26,3,3,8,12,26,0
67513,38,20,2,16,2,0,11,5,4,0,18,0,3,6,9,15,3
67514,311,226,41,81,70,34,77,129,17,3,85,5,23,25,32,80,5
67515,56,35,4,18,3,10,18,13,4,0,21,0,6,8,7,21,0
67516,210,129,18,51,42,18,33,83,6,7,81,10,14,23,34,76,5
67518,49,34,9,14,7,4,11,19,4,0,15,0,0,6,9,15,0
67519,87,59,15,23,13,8,23,31,3,2,28,3,0,14,11,28,0
67520,142,103,11,50,24,18,39,58,0,6,39,11,11,6,11,38,1
67521,87,66,4,36,19,7,31,33,2,0,21,2,11,6,2,16,5
67522,721,594,65,301,160,68,245,304,29,16,127,12,26,54,35,126,1
67523,157,107,15,55,25,12,41,54,8,4,50,7,12,16,15,48,2
67524,259,198,45,81,57,15,84,87,12,15,61,13,14,23,11,58,3
67525,454,331,40,158,78,55,165,144,13,9,123,16,16,33,58,118,5
67526,1161,790,96,379,246,69,260,417,86,27,371,46,98,97,130,357,14
67529,175,143,19,84,26,14,74,48,14,7,32,7,12,13,0,30,2
67530,7809,5121,1034,2392,1304,391,1866,2347,611,297,2688,438,792,764,694,2383,305
67543,756,562,104,251,164,43,221,284,34,23,194,51,23,64,56,169,25
67544,1537,1010,167,477,292,74,358,451,135,66,527,59,151,127,190,497,30
67545,116,70,9,33,24,4,24,43,3,0,46,0,7,20,19,44,2
67546,971,762,118,346,186,112,298,396,43,25,209,16,47,54,92,192,17
67547,929,560,103,213,175,69,196,290,38,36,369,51,92,114,112,345,24
67548,659,426,73,148,132,73,120,252,39,15,233,28,63,76,66,210,23
67550,2248,1462,222,670,436,134,518,728,162,54,786,72,259,255,200,749,37
67552,290,220,31,101,71,17,88,94,19,19,70,3,14,32,21,68,2
67553,43,19,1,10,8,0,6,10,0,3,24,4,5,10,5,22,2
67554,1800,1227,229,535,354,109,478,585,110,54,573,74,133,152,214,522,51
67556,179,122,17,43,51,11,40,64,12,6,57,1,19,17,20,47,10
67557,287,209,39,95,51,24,96,87,15,11,78,11,21,15,31,75,3
67559,36,20,0,11,9,0,6,14,0,0,16,0,2,6,8,16,0
67560,814,511,60,241,144,66,174,276,39,22,303,47,62,84,110,288,15
67561,611,485,114,227,115,29,173,232,62,18,126,22,42,38,24,105,21
67563,154,117,30,58,20,9,49,62,4,2,37,11,6,12,8,32,5
67564,152,112,15,51,22,24,29,63,14,6,40,2,6,20,12,40,0
67565,227,159,15,82,53,9,49,75,21,14,68,15,5,23,25,60,8
67566,198,144,17,57,53,17,50,64,11,19,54,4,14,20,16,54,0
67567,264,202,39,110,42,11,95,69,26,12,62,0,20,30,12,48,14
67568,115,92,22,42,22,6,38,38,9,7,23,5,5,7,6,21,2
67570,505,388,63,165,113,47,139,208,35,6,117,20,33,30,34,106,11
67572,245,152,13,73,50,16,51,81,13,7,93,9,19,33,32,90,3
67573,78,58,6,24,26,2,12,36,4,6,20,1,4,7,8,20,0
67574,114,78,13,40,17,8,34,36,3,5,36,2,9,15,10,36,0
67575,242,148,15,52,60,21,44,88,9,7,94,12,15,41,26,86,8
67576,824,523,70,247,159,47,185,272,54,12,301,30,79,93,99,277,24
67578,702,445,57,232,113,43,157,214,60,14,257,21,56,82,98,238,19
67579,1137,781,149,356,208,68,279,420,63,19,356,64,75,105,112,336,20
67581,211,163,32,60,50,21,59,81,14,9,48,7,9,20,12,44,4
67583,507,341,62,137,75,67,110,182,34,15,166,19,76,44,27,149,17
67584,150,111,11,46,48,6,38,63,10,0,39,8,6,11,14,37,2
67601,9390,5597,1258,2634,1282,423,2108,2383,691,415,3793,1755,783,694,561,2865,928
67621,199,134,32,52,44,6,46,75,11,2,65,6,17,22,20,61,4
67622,268,184,33,79,58,14,69,83,15,17,84,13,15,30,26,77,7
67623,145,97,12,30,40,15,14,73,7,3,48,5,14,10,19,44,4
67625,147,95,10,39,35,11,30,57,2,6,52,2,6,13,31,52,0
67626,87,57,6,26,7,18,2,50,3,2,30,2,10,15,3,28,2
67628,42,33,2,20,9,2,18,13,2,0,9,3,0,2,4,9,0
67629,62,39,4,18,9,8,19,20,0,0,23,4,9,5,5,20,3
67631,123,68,12,27,14,15,25,33,0,10,55,4,9,23,19,55,0
67632,96,67,7,24,30,6,20,40,5,2,29,0,7,3,19,26,3
67634,155,93,5,40,38,10,26,50,9,8,62,2,10,26,24,51,11
67635,83,59,6,24,16,13,20,35,0,4,24,2,18,4,0,24,0
67637,1023,715,138,334,150,93,247,371,69,28,308,49,102,79,78,271,37
67638,118,73,11,32,23,7,21,48,0,4,45,1,8,10,26,43,2
67639,75,63,7,29,25,2,22,40,1,0,12,3,3,0,6,11,1
67640,214,136,20,52,49,15,48,65,13,10,78,19,12,21,26,71,7
67642,824,532,57,231,176,68,186,273,48,25,292,40,75,106,71,267,25
67643,149,83,4,42,29,8,31,41,4,7,66,12,20,11,23,58,8
67644,123,87,16,37,28,6,34,45,3,5,36,4,14,6,12,32,4
67645,284,197,19,90,64,24,67,104,11,15,87,17,27,20,23,80,7
67646,307,215,28,88,69,30,69,117,11,18,92,21,30,15,26,88,4
67647,126,99,14,48,20,17,41,53,0,5,27,6,7,7,7,25,2
67648,270,178,21,63,67,27,56,106,3,13,92,6,19,37,30,84,8
67649,178,95,2,47,28,18,20,63,8,4,83,6,34,14,29,80,3
67650,143,104,14,46,35,9,29,58,13,4,39,9,10,12,8,35,4
67651,267,170,36,64,43,27,76,76,13,5,97,16,45,9,27,92,5
67653,158,101,7,36,47,11,27,73,0,1,57,5,4,24,24,55,2
67654,1645,1047,142,483,295,127,364,534,101,48,598,70,134,172,222,550,48
67656,88,83,13,31,39,0,22,55,6,0,5,0,0,5,0,5,0
67657,182,125,28,46,31,20,42,61,17,5,57,4,19,17,17,56,1
67658,60,42,11,14,13,4,25,17,0,0,18,2,2,13,1,18,0
67659,61,41,2,18,19,2,11,30,0,0,20,3,3,8,6,17,3
67660,29,9,2,6,0,1,8,1,0,0,20,0,7,7,6,20,0
67661,1525,1019,141,438,292,148,322,589,71,37,506,97,107,140,162,469,37
67663,1178,793,145,330,235,83,262,397,60,74,385,68,91,102,124,343,42
67664,115,83,7,39,29,8,40,42,0,1,32,10,4,4,14,26,6
67665,2307,1484,239,563,441,241,425,819,173,67,823,87,260,253,223,734,89
67667,79,59,9,31,15,4,31,20,2,6,20,3,6,9,2,17,3
67669,811,521,97,232,142,50,179,263,54,25,290,16,75,72,127,282,8
67670,20,20,0,14,0,6,4,16,0,0,0,0,0,0,0,0,0
67671,657,456,77,202,139,38,157,241,28,30,201,40,40,54,67,175,26
67672,1072,681,92,305,204,80,242,377,37,25,391,32,72,131,156,359,32
67673,49,36,4,15,13,4,13,19,4,0,13,2,0,4,7,13,0
67674,24,20,0,15,3,2,8,9,0,3,4,0,1,0,3,3,1
67675,113,65,5,29,24,7,28,33,2,2,48,8,10,15,15,45,3
67701,2637,1748,320,823,494,111,735,763,146,104,889,388,185,132,184,768,121
67730,812,525,54,216,169,86,162,289,36,38,287,29,55,102,101,268,19
67731,354,221,41,85,66,29,75,123,18,5,133,8,32,21,72,128,5
67732,214,154,21,73,50,10,60,76,10,8,60,8,24,8,20,53,7
67733,80,53,11,26,14,2,21,32,0,0,27,15,0,12,0,17,10
67734,80,51,13,18,20,0,35,14,0,2,29,7,6,4,12,29,0
67735,2498,1590,290,712,462,126,587,758,154,91,908,267,176,210,255,747,161
67736,108,67,11,33,14,9,22,38,5,2,41,5,9,10,17,39,2
67737,213,156,20,73,49,14,50,92,10,4,57,11,11,18,17,56,1
67738,262,184,8,81,78,17,63,104,8,9,78,10,18,31,19,73,5
67739,161,103,10,54,26,13,51,40,4,8,58,0,16,21,21,58,0
67740,768,540,66,267,166,41,201,281,38,20,228,32,48,63,85,217,11
67741,164,123,17,55,40,11,43,60,13,7,41,8,16,10,7,37,4
67743,70,54,20,16,18,0,30,24,0,0,16,1,9,6,0,13,3
67744,117,84,10,37,34,3,20,35,16,13,33,4,10,5,14,33,0
67745,150,103,7,56,26,14,34,65,2,2,47,9,12,12,14,43,4
67747,82,60,12,41,4,3,22,28,5,5,22,0,4,10,8,15,7
67748,1101,751,102,353,198,98,286,366,39,60,350,58,76,111,105,322,28
67749,1122,741,109,316,236,80,244,394,79,24,381,29,115,113,124,356,25
67751,128,82,11,34,31,6,27,44,5,6,46,8,17,10,11,42,4
67752,588,430,67,182,123,58,178,217,25,10,158,14,27,43,74,156,2
67753,199,141,25,77,33,6,73,56,2,10,58,8,10,20,20,56,2
67756,1008,716,115,292,202,107,220,397,69,30,292,34,70,98,90,283,9
67757,213,142,13,52,60,17,40,88,0,14,71,9,17,16,29,69,2
67758,492,356,54,167,102,33,145,183,20,8,136,21,37,29,49,125,11
67761,100,69,8,23,25,13,17,47,1,4,31,3,6,10,12,30,1
67762,122,88,18,42,22,6,43,33,10,2,34,3,16,4,11,32,2
67764,172,128,29,56,33,10,48,61,7,12,44,6,15,13,10,44,0
67801,9653,7050,2257,3053,1278,462,3066,2445,920,619,2603,637,800,585,581,2176,427
67831,509,343,59,145,88,51,118,186,20,19,166,27,35,42,62,161,5
67834,377,263,38,137,70,18,104,132,25,2,114,13,27,31,43,107,7
67835,983,723,176,375,131,41,311,299,74,39,260,51,56,70,83,231,29
67836,57,36,4,7,11,14,5,20,4,7,21,0,11,8,2,21,0
67837,316,262,70,126,59,7,143,97,18,4,54,14,17,15,8,50,4
67838,409,336,106,132,76,22,151,137,32,16,73,18,32,13,10,58,15
67839,756,496,84,217,151,44,180,263,37,16,260,24,69,61,106,241,19
67840,59,39,2,17,15,5,13,24,2,0,20,0,10,8,2,17,3
67841,115,98,31,46,17,4,39,46,8,5,17,6,4,5,2,11,6
67842,199,148,28,70,40,10,41,82,17,8,51,11,9,16,15,45,6
67844,366,243,51,91,63,38,106,123,10,4,123,16,24,36,47,119,4
67846,12098,9133,3025,4338,1381,389,4322,3014,1287,510,2965,720,1013,735,497,2388,577
67849,168,126,14,65,34,13,41,71,6,8,42,1,11,13,17,36,6
67850,158,124,17,59,37,11,49,66,9,0,34,4,11,2,17,34,0
67851,785,666,173,397,87,9,368,160,113,25,119,53,44,15,7,91,28
67853,313,254,69,124,53,8,156,87,9,2,59,27,18,10,4,51,8
67854,538,380,49,184,112,35,150,176,36,18,158,17,28,63,50,147,11
67855,746,558,151,224,136,47,253,224,52,29,188,42,62,56,28,169,19
67857,95,66,8,36,17,5,26,40,0,0,29,0,5,20,4,29,0
67859,254,205,70,87,42,6,110,73,12,10,49,11,10,18,10,44,5
67860,1077,815,186,429,152,48,401,291,79,44,262,57,54,68,83,244,18
67861,841,628,142,273,162,51,234,296,73,25,213,40,50,49,74,207,6
67862,131,103,22,53,28,0,47,40,11,5,28,7,6,6,9,24,4
67863,131,115,33,36,34,12,44,58,3,10,16,0,12,4,0,12,4
67864,858,623,115,261,186,61,260,293,32,38,235,29,38,81,87,227,8
67865,426,308,49,154,73,32,130,132,28,18,118,11,24,34,49,114,4
67867,547,421,106,173,94,48,207,178,27,9,126,11,29,55,31,124,2
67868,31,24,13,0,11,0,13,11,0,0,7,0,7,0,0,0,7
67869,520,403,137,170,82,14,215,146,33,9,117,22,45,18,32,100,17
67870,658,517,132,258,107,20,261,207,34,15,141,32,22,44,43,130,11
67871,2077,1476,243,777,345,111,542,707,158,69,601,97,134,184,186,555,46
67876,440,317,61,157,81,18,161,142,7,7,123,18,25,34,46,107,16
67877,755,588,141,286,122,39,275,249,45,19,167,26,37,57,47,155,12
67878,928,630,129,289,163,49,259,265,78,28,298,65,58,81,94,271,27
67879,569,384,63,186,105,30,162,185,27,10,185,26,69,52,38,172,13
67880,2744,2126,556,1109,386,75,986,868,214,58,618,92,188,226,112,574,44
67882,144,111,12,66,31,2,59,48,4,0,33,6,6,15,6,33,0
67901,7148,5336,1690,2538,886,222,2392,1851,754,339,1812,380,603,494,335,1461,351
67950,989,732,147,346,201,38,285,344,73,30,257,62,58,76,61,238,19
67951,1700,1242,255,595,286,106,497,562,100,83,458,85,128,107,138,436,22
67952,230,185,53,94,36,2,109,45,20,11,45,6,9,22,8,42,3
67953,52,34,12,8,7,7,11,22,0,1,18,6,3,4,5,16,2
67954,261,198,25,111,45,17,79,91,14,14,63,8,23,21,11,58,5
68001,67,48,14,15,15,4,18,23,7,0,19,7,2,6,4,17,2
68002,797,617,87,296,189,45,261,281,38,37,180,37,41,39,63,158,22
68003,1574,1106,186,566,288,66,374,576,121,35,468,89,149,121,109,379,89
68004,405,273,52,124,77,20,105,135,19,14,132,6,23,41,62,131,1
68005,9456,6431,1545,2933,1653,300,2208,2814,988,421,3025,1026,797,767,435,2432,593
68007,789,637,88,342,183,24,263,300,43,31,152,35,28,49,40,134,18
68008,4116,2985,627,1542,642,174,1211,1292,344,138,1131,275,210,329,317,977,154
68010,41,34,26,8,0,0,26,4,4,0,7,4,0,0,3,7,0
68014,115,79,14,27,34,4,19,42,11,7,36,0,16,13,7,36,0
68015,480,343,40,172,98,33,128,167,22,26,137,22,33,47,35,123,14
68016,153,120,7,42,65,6,18,88,4,10,33,5,7,16,5,23,10
68017,612,502,124,257,100,21,214,230,40,18,110,21,27,26,36,105,5
68018,206,167,22,67,61,17,58,91,5,13,39,1,19,5,14,30,9
68019,248,185,31,78,62,14,66,98,14,7,63,9,29,18,7,58,5
68020,382,265,40,102,102,21,63,155,33,14,117,8,22,42,45,115,2
68022,3016,2576,392,1520,563,101,1204,1054,203,115,440,75,219,102,44,346,94
68023,851,655,82,412,130,31,280,289,56,30,196,25,72,32,67,174,22
68025,11774,7925,1608,3536,2137,644,2674,3823,929,499,3849,770,1045,1025,1009,3252,597
68028,1772,1451,311,773,327,40,609,628,136,78,321,26,126,95,74,287,34
68029,415,312,55,168,79,10,124,151,24,13,103,12,39,31,21,87,16
68030,324,247,36,136,55,20,82,121,30,14,77,13,19,27,18,65,12
68031,753,571,100,268,157,46,220,269,43,39,182,24,52,47,59,156,26
68033,135,112,26,48,29,9,44,51,8,9,23,0,9,6,8,20,3
68034,260,201,40,105,40,16,84,100,9,8,59,11,11,19,18,49,10
68035,55,33,4,17,12,0,9,20,4,0,22,2,8,10,2,21,1
68036,160,111,17,66,22,6,49,52,6,4,49,2,18,21,8,44,5
68037,804,582,93,302,138,49,247,251,51,33,222,62,80,37,43,189,33
68038,649,457,46,230,123,58,158,225,44,30,192,27,38,49,78,173,19
68039,309,249,72,108,54,15,85,27,83,54,60,11,14,31,4,48,12
68040,125,92,15,28,37,12,22,62,3,5,33,8,4,7,14,32,1
68041,320,271,44,133,79,15,110,123,19,19,49,11,17,16,5,27,22
68042,52,29,8,11,8,2,15,12,0,2,23,3,10,6,4,19,4
68044,263,183,39,97,43,4,81,68,20,14,80,15,16,37,12,64,16
68045,809,594,112,235,164,83,208,328,33,25,215,18,56,55,86,204,11
68046,6496,5191,950,3206,912,123,2562,2052,418,159,1305,369,376,269,291,1058,247
68047,774,567,82,237,205,43,199,293,40,35,207,43,48,45,71,195,12
68048,4479,3293,632,1719,794,148,1189,1501,443,160,1186,272,339,348,227,1004,182
68050,265,202,28,106,52,16,86,89,15,12,63,1,12,27,23,62,1
68054,23,18,4,8,6,0,8,10,0,0,5,0,0,0,5,5,0
68055,138,91,8,52,20,11,34,41,6,10,47,12,3,23,9,39,8
68057,656,429,68,209,114,38,170,220,35,4,227,41,70,53,63,205,22
68058,36,31,2,13,14,2,0,25,6,0,5,0,0,5,0,2,3
68059,1038,862,127,473,233,29,334,441,55,32,176,32,67,39,38,136,40
68061,1143,811,114,384,238,75,283,428,81,19,332,42,74,90,126,298,34
68062,106,75,15,35,15,10,27,45,2,1,31,9,4,9,9,25,6
68063,136,85,10,32,32,11,26,44,4,11,51,6,16,11,18,46,5
68064,1257,864,141,441,242,40,301,404,98,61,393,54,119,141,79,337,56
68065,512,374,53,181,113,27,142,183,24,25,138,30,34,33,41,129,9
68066,1988,1316,230,652,302,132,512,580,154,70,672,85,151,185,251,615,57
68067,438,342,87,141,87,27,117,100,73,52,96,9,25,32,30,88,8
68068,62,54,13,12,24,5,15,34,0,5,8,0,1,7,0,8,0
68069,883,601,83,290,197,31,181,342,59,19,282,27,127,97,31,246,36
68070,314,223,35,115,58,15,105,96,9,13,91,6,35,19,31,76,15
68071,445,363,81,156,104,22,96,80,104,83,82,20,18,34,10,70,12
68073,606,493,89,281,105,18,220,211,37,25,113,17,36,34,26,95,18
68102,2393,394,240,127,14,13,115,170,69,40,1999,910,708,308,73,1736,263
68104,14134,9071,2576,4345,1608,542,2986,2848,2156,1081,5063,1072,1855,1309,827,4275,788
68105,10113,5140,1734,2129,864,413,1749,1815,899,677,4973,1469,1924,934,646,4057,916
68106,9353,5031,1247,2088,1192,504,1518,2194,654,665,4322,1150,1343,915,914,3557,765
68107,9549,6268,1994,2547,1124,603,2243,1972,1101,952,3281,568,1110,799,804,2735,546
68108,5171,3057,1016,1308,540,193,1083,929,617,428,2114,561,683,529,341,1672,442
68110,3035,1907,532,795,453,127,369,433,661,444,1128,138,404,421,165,918,210
68111,9149,6445,1973,2812,1341,319,1098,1309,2533,1505,2704,405,1011,848,440,2346,358
68112,4600,3122,698,1442,753,229,858,1212,637,415,1478,179,449,525,325,1215,263
68113,316,297,282,15,0,0,118,154,25,0,19,8,11,0,0,19,0
68114,8391,4301,707,1724,1243,627,1249,2274,397,381,4090,1042,971,917,1160,3514,576
68116,3137,2362,641,1333,345,43,1286,945,45,86,775,389,315,64,7,540,235
68117,3166,2156,514,955,615,72,746,916,270,224,1010,164,326,286,234,787,223
68118,2589,2254,263,1624,343,24,1337,747,115,55,335,94,131,87,23,273,62
68122,1901,1495,454,759,256,26,622,660,153,60,406,120,164,90,32,302,104
68123,8214,6673,2167,3719,744,43,3790,2028,676,179,1541,727,518,217,79,1168,373
68124,6469,4147,608,1859,1303,377,1349,2014,473,311,2322,519,543,667,593,1974,348
68127,10051,5666,1428,2780,1233,225,2130,2396,703,437,4385,2258,1409,521,197,3377,1008
68128,4465,3207,1005,1681,505,16,1332,1117,548,210,1258,510,440,252,56,943,315
68130,3687,3119,400,1949,656,114,1502,1334,163,120,568,104,259,117,88,446,122
68131,5761,2237,858,960,318,101,691,586,582,378,3524,1632,1227,401,264,2745,779
68132,6061,2966,794,1417,567,188,1102,1210,373,281,3095,1421,1035,392,247,2404,691
68133,1298,1213,247,764,198,4,670,454,77,12,85,10,58,17,0,45,40
68134,12042,7183,1790,3240,1757,396,2418,3329,871,565,4859,1632,1458,1000,769,3873,986
68135,3903,3674,644,2528,489,13,2461,1023,169,21,229,36,136,49,8,178,51
68136,831,683,183,356,132,12,405,236,31,11,148,14,58,69,7,136,12
68137,9367,6978,1586,3625,1560,207,2807,2990,782,399,2389,762,951,483,193,1924,465
68138,4156,3267,1079,1833,326,29,1700,1013,350,204,889,452,331,100,6,666,223
68142,611,489,130,242,113,4,169,197,93,30,122,31,63,6,22,99,23
68144,10097,7187,1249,3267,2273,398,2538,3441,644,564,2910,858,968,709,375,2438,472
68147,3657,2712,607,1220,740,145,965,1178,324,245,945,178,366,275,126,773,172
68152,2454,1920,317,968,501,134,585,934,253,148,534,91,79,187,177,493,41
68154,9880,6220,1094,3297,1513,316,2542,2830,500,348,3660,1638,965,612,445,3052,608
68157,1849,1464,251,761,421,31,573,653,133,105,385,105,147,114,19,331,54
68164,9791,6823,2014,3685,952,172,3144,2587,656,436,2968,1097,1123,545,203,2239,729
68301,451,347,69,176,81,21,166,158,17,6,104,18,14,24,48,93,11
68303,146,89,11,35,35,8,23,59,5,2,57,14,11,16,16,53,4
68304,117,87,11,39,35,2,35,50,2,0,30,4,6,7,13,30,0
68305,1840,1215,190,641,284,100,472,551,126,66,625,107,122,174,222,555,70
68307,255,173,27,75,56,15,55,107,4,7,82,15,31,9,27,68,14
68309,48,29,2,20,5,2,13,12,4,0,19,2,9,5,3,12,7
68310,6128,3870,710,1776,1033,351,1318,1933,451,168,2258,528,501,537,692,1980,278
68313,361,264,53,109,88,14,103,138,14,9,97,17,32,23,25,89,8
68314,133,95,21,38,21,15,36,57,2,0,38,7,6,16,9,28,10
68315,69,42,4,22,16,0,12,20,8,2,27,2,6,9,10,25,2
68316,189,165,25,102,25,13,83,69,11,2,24,7,3,2,12,23,1
68317,517,429,68,240,111,10,166,210,35,18,88,3,17,41,27,76,12
68318,255,158,27,81,43,7,56,85,14,3,97,10,27,41,19,84,13
68319,259,203,51,96,45,11,98,89,8,8,56,8,20,17,11,51,5
68320,214,144,24,59,48,13,41,90,8,5,70,12,17,19,22,61,9
68321,181,124,8,64,40,12,45,62,7,10,57,4,19,20,14,50,7
68322,222,147,22,66,36,23,56,79,7,5,75,11,8,12,44,70,5
68323,138,94,11,37,25,21,29,60,5,0,44,6,10,15,13,32,12
68324,98,46,7,19,13,7,14,30,0,2,52,10,2,9,31,47,5
68325,116,97,9,42,21,25,29,54,8,6,19,3,7,4,5,19,0
68326,129,99,17,44,26,12,46,47,4,2,30,9,3,9,9,27,3
68327,170,100,8,37,47,8,26,70,2,2,70,4,18,15,33,65,5
68328,205,159,19,87,37,16,63,87,6,3,46,4,11,13,18,44,2
68329,335,236,32,109,61,34,91,130,9,6,99,12,25,14,48,95,4
68330,52,36,4,16,15,1,11,25,0,0,16,2,9,1,4,14,2
68331,332,261,52,95,83,31,106,136,17,2,71,27,18,20,6,65,6
68332,70,49,7,14,20,8,13,33,1,2,21,0,7,2,12,20,1
68333,2594,1730,327,924,402,77,686,678,257,109,864,223,166,165,310,689,175
68335,267,203,16,102,61,24,69,112,15,7,64,8,12,24,20,59,5
68336,226,185,34,99,50,2,98,80,7,0,41,11,19,9,2,28,13
68337,190,137,25,63,42,7,61,55,17,4,53,8,15,19,11,49,4
68338,164,105,5,52,29,19,38,62,0,5,59,15,7,11,26,59,0
68339,361,279,41,167,58,13,105,147,10,17,82,14,29,18,21,70,12
68340,486,318,55,135,89,39,96,176,37,9,168,18,26,43,81,159,9
68341,442,336,49,157,105,25,109,192,23,12,106,18,21,26,41,93,13
68342,250,180,30,99,40,11,78,83,12,7,70,10,15,17,28,67,3
68343,451,335,56,168,80,31,102,181,25,27,116,29,26,32,29,93,23
68344,157,121,11,66,41,3,50,54,10,7,36,7,13,2,14,30,6
68345,94,61,4,23,29,5,21,38,0,2,33,6,7,14,6,27,6
68346,229,171,58,75,32,6,99,50,15,7,58,13,2,33,10,51,7
68347,759,653,156,369,109,19,317,250,53,33,106,12,43,28,23,93,13
68348,138,101,13,42,33,13,27,64,9,1,37,8,6,9,14,32,5
68349,414,310,60,144,78,28,138,141,11,20,104,14,24,27,39,93,11
68350,99,84,10,33,37,4,23,54,4,3,15,0,7,8,0,15,0
68351,406,288,36,128,91,33,116,148,12,12,118,16,21,30,51,112,6
68352,2435,1566,231,706,390,239,442,849,163,112,869,120,156,265,328,792,77
68354,424,273,31,142,91,9,109,136,19,9,151,19,36,47,49,134,17
68355,2391,1507,290,660,388,169,549,679,173,106,884,74,233,230,347,801,83
68357,186,142,17,72,37,16,55,79,6,2,44,8,13,14,9,41,3
68358,475,400,89,216,75,20,206,165,27,2,75,9,22,19,25,65,10
68359,656,477,77,198,136,66,192,237,29,19,179,19,49,41,70,170,9
68360,192,147,28,86,30,3,74,55,15,3,45,5,17,18,5,33,12
68361,1108,747,132,318,188,109,268,357,67,55,361,53,61,119,128,343,18
68362,30,20,6,7,5,2,9,9,0,2,10,2,3,3,2,10,0
68364,82,50,4,22,21,3,16,30,2,2,32,7,16,5,4,27,5
68365,104,73,8,37,21,7,32,35,4,2,31,0,20,6,5,31,0
68366,396,293,51,152,76,14,128,137,19,9,103,12,33,37,21,85,18
68367,236,176,33,93,35,15,84,79,6,7,60,7,14,20,19,56,4
68368,211,159,34,76,49,0,57,78,10,14,52,16,17,5,14,34,18
68370,912,594,89,262,153,90,218,302,52,22,318,39,53,116,110,308,10
68371,620,451,59,208,119,65,183,247,12,9,169,10,39,60,60,169,0
68372,678,564,120,314,108,22,287,218,52,7,114,21,35,41,17,109,5
68374,85,75,12,38,17,8,23,40,5,7,10,0,5,5,0,10,0
68375,69,61,5,29,21,6,24,37,0,0,8,2,2,2,2,6,2
68376,717,466,70,205,139,52,145,254,47,20,251,32,47,78,94,230,21
68377,205,165,19,87,41,18,65,75,11,14,40,6,6,15,13,32,8
68378,311,195,34,92,43,26,75,108,8,4,116,24,20,27,45,105,11
68380,35,31,7,10,9,5,13,15,1,2,4,2,0,2,0,2,2
68381,104,80,5,39,27,9,26,49,3,2,24,2,2,13,7,24,0
68401,276,186,40,83,58,5,98,73,8,7,90,26,17,30,17,74,16
68402,392,344,52,195,84,13,142,169,24,9,48,16,18,8,6,41,7
68403,78,56,7,36,13,0,18,27,9,2,22,9,3,4,6,16,6
68404,384,310,46,172,84,8,99,176,28,7,74,14,27,11,22,62,12
68405,1168,803,154,339,261,49,293,443,37,30,365,152,74,71,68,275,90
68406,221,128,23,56,33,16,49,54,19,6,93,6,26,29,32,89,4
68407,304,228,23,127,60,18,71,130,14,13,76,10,26,23,17,66,10
68409,266,211,34,115,41,21,69,117,17,8,55,17,14,22,2,43,12
68410,3364,2262,428,1068,539,227,849,1043,263,107,1102,175,257,358,312,960,142
68413,220,175,42,93,38,2,74,78,14,9,45,2,12,22,9,41,4
68414,127,89,14,41,24,10,39,40,5,5,38,2,5,20,11,36,2
68415,264,214,32,98,60,24,85,103,13,13,50,9,12,16,13,48,2
68416,120,69,10,31,15,13,30,32,7,0,51,5,12,21,13,49,2
68417,113,80,5,33,36,6,30,37,4,9,33,9,8,14,2,31,2
68418,338,250,35,143,54,18,105,107,28,10,88,24,27,15,22,79,9
68419,140,111,22,67,16,6,56,47,6,2,29,0,19,8,2,27,2
68420,676,414,48,174,113,79,133,215,41,25,262,13,53,96,100,251,11
68421,313,178,36,81,45,16,62,81,21,14,135,59,31,30,15,103,32
68422,191,142,17,74,33,18,62,76,2,2,49,6,16,13,14,38,11
68423,315,241,33,130,69,9,87,143,7,4,74,6,38,19,11,60,14
68424,324,246,43,117,58,28,99,113,24,10,78,11,16,17,34,68,10
68428,404,324,39,178,105,2,130,161,12,21,80,18,33,28,1,67,13
68430,401,335,27,164,101,43,98,204,24,9,66,13,28,23,2,43,23
68431,173,97,19,35,41,2,28,54,7,8,76,14,16,24,22,61,15
68433,126,82,7,31,30,14,13,60,4,5,44,6,21,5,12,40,4
68434,2924,2015,409,981,491,134,865,928,155,67,909,230,133,185,361,794,115
68436,252,195,26,92,60,17,82,97,11,5,57,11,9,14,23,47,10
68437,154,103,18,50,23,12,39,43,18,3,51,8,14,15,14,43,8
68439,201,151,39,76,18,18,63,68,17,3,50,16,10,8,16,45,5
68440,64,36,4,9,15,8,7,26,2,1,28,1,13,4,10,27,1
68441,115,86,6,40,16,24,24,50,2,10,29,2,5,13,9,27,2
68442,145,104,17,47,31,9,30,53,12,9,41,4,10,9,18,38,3
68443,401,285,57,124,75,29,107,141,13,24,116,16,34,24,42,106,10
68444,45,33,1,23,8,1,7,24,2,0,12,7,5,0,0,9,3
68445,76,42,9,16,16,1,16,19,5,2,34,4,9,4,17,31,3
68446,1005,705,123,278,210,94,250,404,33,18,300,40,58,67,135,266,34
68447,236,146,19,52,46,29,36,88,13,9,90,12,14,38,26,84,6
68448,168,119,24,49,37,9,45,56,10,8,49,8,7,23,11,44,5
68450,1001,641,99,275,203,64,240,314,65,22,360,28,90,113,129,326,34
68452,53,38,4,19,8,7,12,21,2,3,15,3,4,2,6,14,1
68453,141,95,13,38,30,14,42,45,8,0,46,15,12,5,14,40,6
68454,260,194,34,87,55,18,60,121,11,2,66,14,13,17,22,58,8
68455,273,235,35,111,74,15,98,117,12,8,38,4,16,16,2,36,2
68456,432,314,49,150,78,37,121,163,21,9,118,8,15,43,52,112,6
68457,166,120,19,47,37,17,42,45,22,11,46,2,21,14,9,42,4
68458,71,55,8,28,15,4,16,35,2,2,16,6,4,2,4,12,4
68460,350,268,20,165,64,19,100,133,25,10,82,13,41,14,14,77,5
68461,218,175,8,99,51,17,41,119,0,15,43,7,4,24,8,39,4
68462,1008,831,193,429,190,19,398,318,91,24,177,37,62,38,40,160,17
68463,625,438,81,216,112,29,159,212,48,19,187,17,49,68,53,169,18
68464,234,173,18,69,52,34,62,106,1,4,61,13,23,13,12,53,8
68465,936,598,137,244,149,68,218,275,78,27,338,46,85,104,103,300,38
68466,895,595,109,240,176,70,202,294,58,41,300,32,59,92,117,274,26
68467,3809,2544,451,1125,744,224,803,1379,254,108,1265,281,316,274,394,1125,140
68502,11728,6231,1903,2819,1091,418,2226,2515,987,503,5497,2496,1803,658,540,4192,1305
68503,6246,3124,1132,1324,478,190,1063,914,759,388,3122,1592,985,347,198,2126,996
68504,6530,3028,1108,1136,628,156,780,1285,618,345,3502,1775,992,442,293,2441,1061
68505,5698,3704,803,1596,1043,262,1270,1727,343,364,1994,775,428,497,294,1512,482
68506,11564,7443,1233,3324,2093,793,2416,3844,666,517,4121,1153,1114,936,918,3425,696
68507,5401,3556,713,1771,800,272,1258,1582,432,284,1845,492,486,385,482,1511,334
68508,4636,1158,497,391,223,47,278,506,229,145,3478,1859,920,406,293,2820,658
68510,9543,5454,1313,2380,1156,605,1791,2514,668,481,4089,1239,1085,733,1032,3340,749
68512,2788,1930,451,1040,383,56,695,868,276,91,858,359,263,182,54,638,220
68516,11940,8889,1670,5309,1683,227,4405,3562,531,391,3051,1331,934,554,232,2169,882
68517,189,163,6,80,52,25,19,124,15,5,26,7,6,0,13,20,6
68520,437,397,17,163,177,40,93,287,10,7,40,0,27,5,8,36,4
68521,9780,6451,2318,2981,1012,140,2635,2286,965,565,3329,1510,879,668,272,2305,1024
68522,2671,1914,624,935,304,51,847,720,197,150,757,350,217,141,49,491,266
68523,410,349,35,246,66,2,167,169,11,2,61,15,10,22,14,44,17
68524,1472,1241,540,541,151,9,564,349,273,55,231,67,105,41,18,151,80
68526,383,326,61,203,47,15,166,146,9,5,57,12,16,23,6,50,7
68527,289,222,28,106,70,18,81,128,6,7,67,0,37,22,8,59,8
68528,1688,971,315,445,178,33,288,422,144,117,717,239,225,242,11,536,181
68532,154,135,11,90,25,9,56,72,4,3,19,4,8,1,6,19,0
68601,10545,7335,1562,3561,1658,554,3170,3110,672,383,3210,856,819,823,712,2751,459
68620,1294,898,138,404,260,96,398,411,59,30,396,53,78,111,154,365,31
68621,179,140,25,56,51,8,48,69,21,2,39,5,31,3,0,37,2
68622,113,81,9,50,18,4,26,39,11,5,32,4,12,6,10,28,4
68623,125,78,4,33,34,7,26,41,7,4,47,10,20,7,10,41,6
68624,414,304,45,140,95,24,123,151,12,18,110,19,34,36,21,101,9
68626,281,207,20,106,60,21,91,88,17,11,74,12,15,20,27,68,6
68627,327,228,24,104,68,32,93,106,6,23,99,16,13,27,43,97,2
68628,351,241,23,124,80,14,93,122,18,8,110,9,35,27,39,101,9
68629,572,406,66,184,118,38,174,199,19,14,166,22,22,41,81,164,2
68631,225,163,22,80,46,15,71,73,14,5,62,17,12,17,16,62,0
68632,1502,989,128,474,248,139,394,485,65,45,513,88,87,111,227,476,37
68633,516,391,42,184,128,37,171,199,8,13,125,25,28,30,42,117,8
68634,128,89,14,39,30,6,30,47,6,6,39,3,12,6,18,36,3
68635,229,151,15,67,51,18,61,81,3,6,78,11,32,24,11,76,2
68636,612,418,45,182,146,45,169,213,21,15,194,26,38,47,83,179,15
68637,156,103,20,38,40,5,41,52,8,2,53,3,12,22,16,51,2
68638,757,532,88,250,130,64,190,262,55,25,225,39,53,59,74,214,11
68640,669,459,78,214,117,50,186,227,24,22,210,30,51,46,83,193,17
68641,461,331,35,146,114,36,139,160,16,16,130,13,22,32,63,121,9
68642,653,497,80,254,124,39,234,195,39,29,156,38,25,46,47,145,11
68643,418,295,37,152,78,28,143,117,15,20,123,8,22,41,52,116,7
68644,328,257,26,138,60,33,135,108,2,12,71,22,14,21,14,69,2
68647,271,209,47,88,56,18,82,99,15,13,62,12,15,20,15,52,10
68648,161,120,19,48,42,11,53,63,4,0,41,9,15,8,9,38,3
68649,731,526,73,232,177,44,205,257,39,25,205,25,32,67,81,187,18
68651,615,415,66,204,96,49,157,218,26,14,200,38,35,41,86,187,13
68652,316,220,32,112,58,18,107,85,16,12,96,14,18,21,43,95,1
68653,300,210,27,108,54,21,91,97,9,13,90,10,31,22,27,88,2
68654,262,180,26,85,47,22,65,105,8,2,82,10,23,18,31,78,4
68655,79,55,8,25,14,8,20,27,4,4,24,6,4,4,10,23,1
68658,288,209,34,81,69,25,84,108,7,10,79,13,14,23,29,64,15
68659,83,66,17,34,14,1,31,27,6,2,17,0,5,7,5,10,7
68660,505,351,53,143,120,35,121,188,28,14,154,17,42,44,51,147,7
68661,2243,1621,427,744,314,136,744,630,162,85,622,117,157,148,200,537,85
68662,474,345,75,153,88,29,145,176,17,7,129,19,21,48,41,110,19
68663,349,254,39,121,76,18,85,135,20,14,95,18,18,28,31,84,11
68664,136,84,21,34,15,14,30,33,21,0,52,10,9,15,18,49,3
68665,398,283,33,127,90,33,108,134,26,15,115,20,25,22,48,112,3
68666,654,448,80,188,110,70,154,256,27,11,206,33,26,68,79,185,21
68667,46,32,6,19,7,0,18,9,0,5,14,2,0,9,3,10,4
68669,196,140,41,43,45,11,61,60,6,13,56,18,6,18,14,51,5
68701,11730,7847,1885,3687,1794,481,3011,3463,965,408,3883,1223,926,812,922,3180,703
68710,318,245,40,109,64,32,81,135,13,16,73,18,10,18,27,61,12
68711,97,74,5,37,23,9,24,44,2,4,23,4,14,5,0,20,3
68713,972,655,95,301,205,54,270,342,19,24,317,34,96,79,108,294,23
68714,611,404,47,187,126,44,126,209,39,30,207,41,58,38,70,189,18
68715,560,430,82,218,108,22,188,176,38,28,130,18,30,28,54,124,6
68716,467,325,67,111,95,52,112,180,22,11,142,22,43,45,32,121,21
68717,103,77,13,36,17,11,31,40,2,4,26,0,5,10,11,26,0
68718,847,579,79,240,170,90,188,343,30,18,268,36,57,65,110,241,27
68719,73,48,2,28,11,7,15,23,8,2,25,7,8,4,6,23,2
68720,165,136,22,70,32,12,68,62,4,2,29,2,9,7,11,24,5
68722,252,152,20,77,38,17,76,72,2,2,100,12,16,41,31,92,8
68723,267,186,25,98,60,3,77,87,15,7,81,4,37,9,31,77,4
68724,83,65,4,37,20,4,35,26,4,0,18,0,3,11,4,18,0
68725,248,180,35,67,57,21,55,100,13,12,68,14,15,22,17,63,5
68726,351,263,52,116,67,28,92,132,26,13,88,9,18,24,37,88,0
68727,344,204,16,103,71,14,98,95,8,3,140,24,24,29,63,131,9
68728,111,75,17,29,15,14,25,41,7,2,36,5,11,8,12,36,0
68729,791,540,84,226,143,87,198,288,27,27,251,35,42,92,82,236,15
68730,814,599,94,286,150,69,276,272,37,14,215,38,62,52,63,202,13
68731,831,641,123,334,160,24,245,271,90,35,190,56,49,63,22,128,62
68732,120,90,17,38,26,9,38,41,0,11,30,7,15,4,4,30,0
68733,533,400,97,173,87,43,170,176,42,12,133,23,27,47,36,119,14
68734,73,68,7,36,18,7,33,33,2,0,5,0,2,1,2,5,0
68735,431,321,30,175,87,29,143,138,18,22,110,24,17,35,34,108,2
68736,258,220,37,106,57,20,121,83,0,16,38,4,8,13,13,33,5
68737,43,31,2,14,11,4,16,13,0,2,12,1,8,2,1,12,0
68739,1174,853,134,380,241,98,403,396,34,20,321,75,63,72,111,299,22
68740,301,242,32,135,55,20,109,118,9,6,59,9,10,22,18,59,0
68741,264,212,31,106,57,18,93,97,12,10,52,9,17,15,11,45,7
68742,129,82,6,53,15,8,37,32,7,6,47,15,7,14,11,37,10
68743,248,175,25,97,38,15,56,90,18,11,73,14,22,11,26,63,10
68745,664,450,76,212,107,55,178,202,49,21,214,54,30,49,81,195,19
68746,225,153,15,56,59,23,46,99,8,0,72,4,22,20,26,67,5
68747,117,86,7,47,24,8,41,30,5,10,31,7,12,11,1,24,7
68748,1077,811,146,428,158,79,373,353,44,41,266,35,76,79,76,244,22
68752,344,241,38,125,62,16,105,117,12,7,103,17,37,19,30,94,9
68753,49,35,7,17,6,5,14,16,2,3,14,3,3,2,6,13,1
68755,137,95,11,36,35,13,28,58,6,3,42,6,10,7,19,38,4
68756,911,618,74,288,186,70,216,317,51,34,293,57,43,81,112,283,10
68757,340,221,37,95,70,19,83,120,12,6,119,14,29,28,48,113,6
68758,509,336,52,152,92,40,135,162,23,16,173,18,37,49,69,161,12
68759,143,106,10,46,26,24,30,56,10,10,37,12,2,14,9,35,2
68760,443,295,88,98,81,28,89,114,58,34,148,16,57,44,31,138,10
68761,193,138,20,52,53,13,42,81,10,5,55,10,8,16,21,49,6
68763,2038,1362,255,626,332,149,544,619,104,95,676,98,151,198,229,623,53
68764,326,229,32,108,72,17,85,119,15,10,97,10,27,27,33,92,5
68765,519,373,57,171,117,28,158,161,31,23,146,29,22,36,59,130,16
68766,199,140,17,63,48,12,52,83,0,5,59,12,17,9,21,57,2
68767,1171,860,189,411,183,77,388,381,59,32,311,43,83,89,96,274,37
68768,327,231,47,96,77,11,89,109,21,12,96,12,20,33,31,81,15
68769,850,563,67,267,158,71,212,289,37,25,287,49,50,62,126,278,9
68770,646,488,76,249,118,45,192,234,40,22,158,23,35,44,56,146,12
68771,648,478,77,222,133,46,187,233,44,14,170,36,20,49,65,160,10
68772,28,19,3,11,5,0,7,9,1,2,9,4,0,5,0,9,0
68773,80,60,6,31,17,6,27,31,2,0,20,1,8,9,2,20,0
68774,108,74,10,28,31,5,32,35,4,3,34,5,6,15,8,34,0
68776,5179,3697,1134,1707,662,194,1524,1230,652,291,1482,314,478,402,288,1256,226
68777,391,263,27,128,77,31,114,125,21,3,128,12,26,35,55,124,4
68778,322,222,32,93,66,31,67,132,15,8,100,9,19,36,36,93,7
68779,917,672,113,330,157,72,302,278,61,31,245,48,59,64,74,222,23
68780,417,291,36,133,88,34,118,140,21,12,126,14,33,28,51,116,10
68781,629,450,55,213,124,58,173,220,34,23,179,18,36,44,81,164,15
68783,525,342,36,148,107,51,107,195,27,13,183,10,34,70,69,171,12
68784,848,612,102,279,166,65,219,308,53,32,236,39,59,51,87,208,28
68785,101,68,24,31,10,3,40,13,9,6,33,9,9,10,5,29,4
68786,460,306,53,114,114,25,114,174,14,4,154,12,28,49,65,151,3
68787,2231,1270,223,552,352,143,481,605,110,74,961,505,140,169,147,603,358
68788,2073,1447,285,606,408,148,602,680,111,54,626,120,150,181,175,554,72
68789,92,67,2,33,19,13,24,35,2,6,25,0,7,9,9,21,4
68790,328,227,41,105,70,11,95,105,17,10,101,25,14,38,24,92,9
68791,783,527,97,220,144,66,195,269,40,23,256,62,39,54,101,231,25
68792,191,127,12,52,45,18,52,57,4,14,64,14,24,9,17,59,5
68801,10334,7017,1899,3098,1503,517,2607,2826,1075,509,3317,855,1082,755,625,2723,594
68803,7941,5576,1095,2740,1334,407,2105,2579,661,231,2365,532,603,684,546,2051,314
68810,327,229,39,123,57,10,86,100,32,11,98,16,35,38,9,79,19
68812,314,248,50,116,51,31,123,104,13,8,66,6,23,27,10,50,16
68813,264,194,31,90,46,27,69,113,8,4,70,12,15,16,27,67,3
68814,329,238,40,98,76,24,71,131,24,12,91,16,22,22,31,87,4
68815,300,211,39,83,61,28,85,112,10,4,89,9,17,27,36,82,7
68816,88,70,5,26,19,20,12,39,5,14,18,5,8,0,5,13,5
68817,176,127,29,61,30,7,68,40,11,8,49,11,11,15,12,44,5
68818,2072,1531,276,716,401,138,583,745,151,52,541,73,126,152,190,494,47
68819,100,78,17,39,20,2,43,30,5,0,22,4,9,4,5,22,0
68820,187,129,26,53,36,14,54,59,13,3,58,10,19,6,23,51,7
68821,78,61,13,24,24,0,26,29,0,6,17,2,6,2,7,15,2
68822,2017,1347,217,569,413,148,502,703,89,53,670,91,182,155,242,622,48
68823,947,643,98,250,221,74,222,374,30,17,304,23,55,103,123,286,18
68824,499,394,74,184,97,39,167,196,20,11,105,12,28,39,26,90,15
68825,439,310,37,154,88,31,128,150,17,15,129,15,25,36,53,115,14
68826,1534,1103,218,489,297,99,412,518,128,45,431,77,82,101,171,400,31
68827,304,237,45,128,58,6,114,100,14,9,67,19,21,15,12,55,12
68828,157,107,5,46,42,14,37,60,10,0,50,1,17,9,23,50,0
68831,312,231,23,115,66,27,75,131,14,11,81,16,18,30,17,71,10
68832,691,564,100,312,125,27,210,254,77,23,127,31,36,37,23,116,11
68833,145,101,11,45,36,9,35,59,3,4,44,6,8,17,13,40,4
68834,105,83,12,38,27,6,28,48,4,3,22,0,8,6,8,20,2
68835,136,107,19,52,22,14,48,47,6,6,29,2,6,11,10,27,2
68836,676,478,122,235,104,17,202,210,43,23,198,31,56,61,50,177,21
68837,55,42,8,15,17,2,14,26,0,2,13,4,0,5,4,13,0
68838,157,119,21,55,43,0,52,61,6,0,38,13,6,7,12,36,2
68840,1040,777,174,377,178,48,345,342,75,15,263,54,70,70,69,223,40
68841,240,201,48,94,49,10,92,77,18,14,39,6,11,12,10,33,6
68842,289,190,26,84,57,23,73,86,10,21,99,13,19,19,48,99,0
68843,325,264,33,131,84,16,117,138,9,0,61,11,25,12,13,53,8
68844,97,64,18,14,30,2,23,38,2,1,33,0,6,10,17,31,2
68845,6061,3718,918,1951,705,144,1620,1468,423,207,2343,1333,422,333,255,1525,818
68846,120,101,6,54,28,13,44,44,8,5,19,5,5,9,0,19,0
68847,5948,3717,1067,1623,789,238,1363,1538,532,284,2231,855,504,376,496,1682,549
68850,3804,2790,781,1323,489,197,1282,1024,307,177,1014,236,258,310,210,823,191
68852,233,179,27,65,63,24,53,104,14,8,54,6,10,15,23,47,7
68853,696,438,56,158,163,61,117,270,24,27,258,16,70,98,74,252,6
68854,299,236,31,118,64,23,88,133,12,3,63,13,25,18,7,58,5
68855,177,129,9,71,43,6,49,66,8,6,48,13,4,7,24,44,4
68856,240,181,31,83,42,25,69,94,6,12,59,9,9,23,18,53,6
68858,124,89,9,45,18,17,36,49,0,4,35,12,10,9,4,31,4
68859,254,173,28,61,60,24,56,99,9,9,81,10,17,33,21,71,10
68860,159,103,10,47,35,11,30,59,4,10,56,8,8,30,10,56,0
68861,53,40,7,15,16,2,13,25,0,2,13,2,4,2,5,11,2
68862,1349,882,107,408,254,113,288,457,96,41,467,61,117,110,179,430,37
68863,441,328,72,153,80,23,134,156,23,15,113,27,21,28,37,103,10
68864,476,349,41,172,100,36,143,165,30,11,127,17,31,41,38,108,19
68865,345,298,59,169,59,11,120,134,35,9,47,9,13,9,16,43,4
68866,347,264,56,126,72,10,119,132,7,6,83,19,23,20,21,71,12
68869,905,607,116,278,152,61,264,276,43,24,298,30,55,82,131,273,25
68870,191,164,26,83,34,21,53,89,11,11,27,6,8,9,4,21,6
68871,105,83,6,33,19,25,12,66,2,3,22,2,4,6,10,18,4
68872,321,263,58,123,57,25,124,115,19,5,58,13,16,18,11,47,11
68873,1380,928,205,387,263,73,353,438,100,37,452,64,74,157,157,425,27
68874,441,304,50,125,86,43,88,175,32,9,137,10,30,49,48,133,4
68875,258,187,22,70,68,27,72,98,10,7,71,5,13,24,29,67,4
68876,645,479,80,239,129,31,199,216,38,26,166,29,44,46,47,145,21
68878,167,111,30,48,23,10,55,39,13,4,56,21,5,11,19,47,9
68879,180,115,9,62,34,10,46,60,1,8,65,2,16,19,28,61,4
68881,29,26,3,11,8,4,12,14,0,0,3,1,2,0,0,2,1
68882,194,120,16,60,40,4,41,61,12,6,74,8,11,25,30,69,5
68883,837,614,130,259,170,55,244,300,47,23,223,48,61,62,52,198,25
68901,10420,6686,1457,3006,1596,627,2364,3134,723,465,3734,862,875,896,1101,3135,599
68920,609,396,36,189,117,54,130,227,27,12,213,31,46,65,71,196,17
68922,624,421,65,188,112,56,153,227,26,15,203,29,30,58,86,192,11
68923,75,49,6,28,13,2,24,19,6,0,26,5,5,8,8,21,5
68924,597,447,88,241,96,22,197,198,48,4,150,48,32,36,34,124,26
68925,186,158,17,84,45,12,59,83,12,4,28,8,11,3,6,23,5
68926,345,221,36,102,61,22,76,111,31,3,124,12,36,40,36,123,1
68927,515,373,44,203,101,25,160,187,19,7,142,19,33,46,44,128,14
68928,172,125,17,66,32,10,55,61,2,7,47,4,10,21,12,45,2
68929,110,75,8,33,25,9,20,49,4,2,35,3,13,14,5,32,3
68930,569,405,51,175,124,55,150,224,18,13,164,22,36,43,63,155,9
68932,221,143,29,51,40,23,51,67,9,16,78,9,13,27,29,70,8
68933,429,324,49,166,87,22,136,144,32,12,105,19,30,40,16,97,8
68934,114,69,13,36,11,9,25,31,9,4,45,14,14,9,8,36,9
68935,348,225,29,89,74,33,80,112,15,18,123,12,26,44,41,114,9
68936,111,79,13,31,20,15,25,47,2,5,32,7,8,11,6,26,6
68937,801,602,59,248,229,66,157,369,45,31,199,29,46,64,60,184,15
68938,248,181,16,92,51,22,71,99,9,2,67,9,20,10,28,59,8
68939,536,356,49,149,100,58,116,195,29,16,180,27,35,41,77,176,4
68940,180,150,16,64,60,10,63,80,3,4,30,5,8,7,10,27,3
68941,348,274,57,128,73,16,104,140,11,19,74,16,23,20,15,65,9
68942,250,149,16,60,57,16,40,83,20,6,101,17,26,30,28,92,9
68943,132,108,18,45,37,8,50,52,6,0,24,9,1,5,9,22,2
68944,512,354,64,161,94,35,137,171,29,17,158,14,54,49,41,150,8
68945,94,64,15,20,21,8,22,32,7,3,30,6,16,0,8,25,5
68946,54,44,5,32,0,7,28,14,2,0,10,0,3,6,1,9,1
68947,245,171,22,86,46,17,58,88,21,4,74,12,20,19,23,66,8
68948,137,86,9,33,37,7,24,47,7,8,51,12,13,22,4,43,8
68949,2709,1832,348,841,462,181,709,899,167,57,877,200,212,253,212,780,97
68950,145,115,17,51,30,17,35,69,9,2,30,3,13,8,6,24,6
68952,74,42,2,23,11,6,16,24,2,0,32,3,13,9,7,29,3
68954,45,35,3,20,10,2,9,24,0,2,10,0,0,5,5,10,0
68955,558,459,77,250,99,33,197,195,47,20,99,13,51,24,11,88,11
68956,471,342,76,149,91,26,147,169,24,2,129,25,29,36,39,109,20
68957,254,174,27,83,54,10,78,85,6,5,80,13,24,19,24,76,4
68958,283,213,35,110,50,18,80,105,16,12,70,22,11,19,18,64,6
68959,1653,1178,232,547,296,103,425,599,123,31,475,69,137,133,136,428,47
68960,102,70,7,29,30,4,26,39,5,0,32,5,3,15,9,32,0
68961,395,242,26,100,84,32,76,141,18,7,153,23,22,42,66,142,11
68964,54,38,4,20,5,9,17,18,3,0,16,2,2,6,6,16,0
68966,336,205,37,87,46,35,93,92,11,9,131,13,25,56,37,114,17
68967,544,356,45,151,130,30,113,191,30,22,188,24,56,52,56,174,14
68970,694,436,45,188,140,63,124,264,32,16,258,16,41,104,97,245,13
68971,264,176,5,57,93,21,36,134,3,3,88,6,31,27,24,83,5
68972,118,75,7,32,36,0,19,46,2,8,43,3,12,22,6,37,6
68973,197,139,31,72,30,6,60,63,8,8,58,9,14,20,15,56,2
68974,119,87,9,43,29,6,27,57,0,3,32,10,6,8,8,32,0
68975,59,48,12,23,6,7,18,28,2,0,11,0,0,11,0,11,0
68976,111,83,11,43,19,10,28,47,3,5,28,8,2,11,7,28,0
68977,152,109,11,46,27,25,36,64,6,3,43,2,9,13,19,41,2
68978,1135,698,113,251,202,132,220,409,44,25,437,39,78,166,154,402,35
68979,761,549,90,236,163,60,219,289,27,14,212,32,60,53,67,202,10
68980,170,133,23,60,45,5,51,67,11,4,37,10,14,2,11,35,2
68981,157,123,20,50,39,14,44,57,14,8,34,8,13,8,5,32,2
68982,306,239,31,123,63,22,95,115,27,2,67,14,18,10,25,65,2
69001,3986,2658,473,1178,750,257,982,1282,272,122,1328,282,307,343,396,1161,167
69020,207,157,27,67,42,21,56,87,11,3,50,13,4,17,16,50,0
69021,623,408,58,167,122,61,134,250,20,4,215,36,65,52,62,198,17
69022,688,464,92,192,138,42,158,251,44,11,224,26,31,56,111,213,11
69023,198,146,22,54,56,14,45,82,10,9,52,7,11,14,20,42,10
69024,462,372,36,181,122,33,128,197,25,22,90,12,19,18,41,83,7
69025,495,307,50,138,83,36,119,154,30,4,188,59,41,45,43,154,34
69026,89,64,11,32,17,4,19,39,4,2,25,5,10,6,4,25,0
69027,60,45,6,30,9,0,22,22,1,0,15,0,7,0,8,15,0
69028,360,263,35,122,79,27,100,139,22,2,97,27,33,11,26,97,0
69029,137,94,15,41,29,9,34,49,5,6,43,3,7,13,20,41,2
69030,146,94,6,46,26,16,29,59,5,1,52,10,14,8,20,48,4
69031,25,11,3,4,2,2,5,6,0,0,14,1,4,2,7,14,0
69032,251,189,18,85,74,12,72,97,0,20,62,9,17,14,22,60,2
69033,1047,718,100,354,204,60,282,355,54,27,329,56,80,83,110,301,28
69034,435,302,43,137,101,21,111,150,27,14,133,25,34,53,21,114,19
69036,75,56,9,25,18,4,14,34,8,0,19,0,7,6,6,19,0
69037,53,42,9,8,25,0,14,28,0,0,11,0,0,2,9,11,0
69038,187,138,30,78,30,0,70,58,6,4,49,7,11,19,12,42,7
69039,65,52,10,23,13,6,30,18,0,4,13,4,2,5,2,9,4
69040,257,171,25,81,48,17,58,91,14,8,86,11,18,29,28,80,6
69041,91,66,10,41,11,4,34,32,0,0,25,9,9,6,1,25,0
69042,24,19,5,8,6,0,7,10,2,0,5,0,5,0,0,5,0
69043,282,190,21,86,67,16,65,96,12,17,92,10,9,38,35,87,5
69044,391,256,26,120,88,22,64,146,27,19,135,20,32,39,44,120,15
69045,461,331,50,137,98,46,113,189,21,8,130,15,30,48,37,123,7
69046,106,72,7,36,21,8,26,38,5,3,34,4,8,13,9,32,2
69101,11686,7613,1739,3461,1930,483,2811,3561,832,409,4073,917,1169,1034,953,3460,613
69120,443,292,50,110,94,38,100,158,23,11,151,11,40,51,49,143,8
69121,148,107,9,54,33,11,25,58,10,14,41,8,5,17,11,39,2
69122,320,209,9,106,70,24,60,119,18,12,111,17,23,35,36,106,5
69123,371,287,47,112,92,36,88,175,14,10,84,16,27,29,12,76,8
69125,187,129,15,68,38,8,48,69,6,6,58,15,10,16,17,49,9
69127,332,219,22,114,51,32,74,122,11,12,113,4,40,36,33,91,22
69128,175,113,24,49,32,8,42,57,2,12,62,14,19,24,5,56,6
69129,621,419,60,181,106,72,143,220,38,18,202,31,58,54,59,185,17
69130,2274,1550,330,684,377,159,573,733,167,77,724,134,200,213,177,643,81
69131,258,150,22,70,45,13,48,86,16,0,108,10,39,29,30,102,6
69132,19,12,0,6,6,0,4,8,0,0,7,3,0,1,3,7,0
69133,164,117,20,62,27,8,63,51,0,3,47,7,10,18,12,43,4
69134,149,119,18,48,33,20,38,74,0,7,30,13,5,4,8,28,2
69135,22,20,9,9,2,0,13,5,0,2,2,0,2,0,0,2,0
69138,1781,1245,252,556,330,107,414,645,131,55,536,115,92,141,188,486,50
69140,745,501,64,261,121,55,199,251,44,7,244,28,38,57,121,236,8
69141,167,107,29,54,17,7,45,46,12,4,60,8,18,7,27,54,6
69142,54,35,1,21,10,3,15,17,3,0,19,0,2,10,7,19,0
69143,548,427,86,197,121,23,176,196,33,22,121,22,55,14,30,105,16
69144,102,73,13,33,19,8,25,38,10,0,29,0,11,16,2,29,0
69145,1399,919,160,348,300,111,293,488,77,61,480,52,119,155,154,421,59
69146,187,128,7,37,66,18,22,100,4,2,59,10,21,20,8,52,7
69147,378,220,7,90,99,24,38,153,15,14,158,15,38,75,30,140,18
69148,111,81,11,43,27,0,37,36,5,3,30,3,9,4,14,28,2
69149,359,243,25,109,89,20,71,131,26,15,116,11,33,29,43,109,7
69150,202,149,33,71,41,4,74,57,15,3,53,18,4,17,14,41,12
69151,309,234,37,101,73,23,86,118,23,7,75,31,10,14,20,69,6
69152,376,252,32,120,72,28,101,136,8,7,124,9,32,36,47,120,4
69153,2549,1735,300,803,521,111,593,854,195,93,814,125,170,280,239,723,91
69154,620,410,52,181,128,49,110,233,39,28,210,18,35,93,64,197,13
69155,413,308,79,144,73,12,151,115,35,7,105,14,29,20,42,95,10
69156,273,204,31,97,60,16,72,99,24,9,69,16,14,23,16,61,8
69157,37,27,12,11,4,0,14,11,0,2,10,2,2,4,2,10,0
69161,103,68,10,35,18,5,27,36,3,2,35,2,10,14,9,33,2
69162,3057,2009,404,915,497,193,778,883,214,134,1048,221,318,279,230,916,132
69163,340,256,33,131,78,14,81,143,23,9,84,12,11,24,37,78,6
69165,632,457,83,213,122,39,175,221,41,20,175,23,48,53,51,159,16
69166,204,138,25,59,43,11,48,78,8,4,66,17,9,16,24,62,4
69167,190,153,32,64,48,9,71,70,6,6,37,0,4,8,25,37,0
69168,111,77,19,30,26,2,32,39,4,2,34,7,11,6,10,31,3
69169,280,216,35,114,50,17,90,108,7,11,64,12,19,12,21,62,2
69170,115,92,10,59,18,5,50,38,4,0,23,6,6,1,10,17,6
69201,1690,1121,218,488,304,111,372,557,149,43,569,106,122,177,164,522,47
69210,1254,818,136,330,245,107,267,433,76,42,436,68,99,115,154,404,32
69211,154,117,14,59,37,7,55,46,12,4,37,8,9,7,13,33,4
69212,79,53,9,20,17,7,12,22,7,12,26,3,15,3,5,21,5
69214,81,57,1,28,16,12,11,42,2,2,24,10,7,4,3,19,5
69216,74,59,6,29,22,2,20,30,5,4,15,11,2,2,0,15,0
69217,207,131,10,62,49,10,38,74,12,7,76,14,18,19,25,63,13
69218,109,68,9,35,20,4,31,30,5,2,41,6,4,21,10,38,3
69219,1,1,0,1,0,0,0,1,0,0,0,0,0,0,0,0,0
69220,20,18,0,13,5,0,6,10,0,2,2,0,2,0,0,2,0
69221,91,64,16,13,35,0,13,40,7,4,27,4,9,6,8,27,0
69301,4233,2928,602,1495,634,197,1145,1280,413,90,1305,273,426,287,319,1172,133
69331,54,45,7,18,18,2,19,21,2,3,9,6,0,2,1,9,0
69333,63,51,2,24,21,4,15,34,0,2,12,5,0,0,7,12,0
69334,961,673,121,329,183,40,266,311,67,29,288,46,76,85,81,245,43
69335,48,36,8,22,6,0,18,18,0,0,12,2,0,10,0,10,2
69336,1039,716,125,309,216,66,286,331,58,41,323,48,84,98,93,294,29
69337,2696,1541,367,631,400,143,526,807,133,75,1155,522,220,183,230,855,300
69339,664,449,62,197,157,33,150,226,46,27,215,23,42,66,84,198,17
69340,47,38,7,19,8,4,16,17,2,3,9,2,1,6,0,5,4
69341,4243,2984,602,1338,747,297,1108,1359,334,183,1259,124,419,359,357,1128,131
69343,1267,867,150,386,230,101,298,428,90,51,400,66,85,120,129,367,33
69345,262,203,20,88,83,12,65,125,8,5,59,10,16,10,23,52,7
69346,275,194,17,102,56,19,60,113,10,11,81,2,24,39,16,77,4
69347,620,446,48,204,132,62,159,242,21,24,174,18,37,56,63,159,15
69348,691,504,82,256,131,35,208,231,34,31,187,24,49,47,67,174,13
69349,65,49,9,20,16,4,22,16,4,7,16,0,0,6,10,16,0
69350,180,132,17,65,41,9,55,64,9,4,48,7,20,17,4,46,2
69351,99,68,7,28,27,6,23,43,0,2,31,14,3,7,7,28,3
69352,285,192,60,64,60,8,73,71,35,13,93,8,33,34,18,81,12
69354,27,23,2,10,9,2,11,12,0,0,4,4,0,0,0,4,0
69355,61,49,6,20,18,5,6,41,2,0,12,2,3,0,7,12,0
69356,853,647,137,297,169,44,217,314,70,46,206,34,56,78,38,186,20
69357,1523,1133,215,528,314,76,402,549,116,66,390,64,114,113,99,359,31
69358,800,546,79,235,172,60,161,328,43,14,254,31,73,75,75,219,35
69360,629,413,79,184,110,40,137,196,50,30,216,34,54,56,72,205,11
69361,7216,4774,1091,2029,1210,444,1473,2148,832,321,2442,474,726,591,651,2159,283
69365,31,21,2,10,9,0,10,9,2,0,10,0,1,7,2,10,0
69366,71,57,9,37,11,0,23,22,9,3,14,0,6,8,0,14,0
69367,123,89,10,25,44,10,23,62,4,0,34,7,14,10,3,31,3
70001,18489,10029,2129,4445,2493,962,2926,4426,1275,1402,8460,2533,2829,1807,1291,7233,1227
70002,8843,5205,1050,2222,1488,445,1745,2414,560,486,3638,954,1110,995,579,3107,531
70003,16815,12267,1825,5784,3705,953,3973,5401,1445,1448,4548,709,1373,1611,855,3908,640
70005,12142,6709,861,2974,1986,888,2000,3282,610,817,5433,1479,1630,1297,1027,4702,731
70006,7028,4692,854,2005,1345,488,1352,2174,569,597,2336,624,670,634,408,1984,352
70030,1474,1165,247,547,308,63,395,557,139,74,309,67,90,83,69,247,62
70031,473,347,33,196,108,10,111,168,36,32,126,42,30,24,30,113,13
70032,3486,2236,320,907,675,334,600,1119,192,325,1250,173,255,495,327,1096,154
70036,511,389,67,176,106,40,136,161,22,70,122,6,35,46,35,105,17
70037,4153,3332,758,1676,790,108,1389,1289,418,236,821,145,254,307,115,671,150
70038,78,67,35,20,6,6,39,17,5,6,11,0,0,11,0,11,0
70039,758,577,161,259,131,26,182,163,106,126,181,42,54,43,42,153,28
70040,673,505,89,257,140,19,155,210,43,97,168,6,69,73,20,141,27
70041,2222,1633,372,779,394,88,646,660,187,140,589,89,134,257,109,483,106
70043,12252,8904,1787,4108,2339,670,2741,3789,1104,1270,3348,562,1068,1005,713,2868,480
70047,4113,3482,598,2241,552,91,1757,1135,378,212,631,123,265,193,50,548,83
70049,872,712,96,340,226,50,182,219,140,171,160,13,69,46,32,155,5
70050,196,130,35,77,18,0,61,45,14,10,66,20,28,18,0,31,35
70051,773,597,99,303,143,52,174,181,92,150,176,25,67,38,46,155,21
70052,1099,840,166,367,247,60,271,337,119,113,259,42,84,105,28,224,35
70053,6678,4110,1009,1767,944,390,1126,1476,860,648,2568,525,970,664,409,2186,382
70056,14592,10913,2418,5551,2578,366,3680,3856,2054,1323,3679,1279,1227,893,280,3099,580
70057,980,761,189,374,142,56,215,277,153,116,219,43,68,59,49,207,12
70058,13970,11095,2591,6243,1994,267,3914,3298,2508,1375,2875,647,1427,605,196,2313,562
70062,6585,4622,985,2336,1048,253,1148,1397,1153,924,1963,278,704,644,337,1606,357
70065,19583,14278,2702,7707,3373,496,5583,5389,1701,1605,5305,1522,2083,1207,493,4467,838
70066,236,194,64,84,30,16,13,38,106,37,42,3,22,13,4,42,0
70067,1293,1015,208,542,216,49,409,441,86,79,278,30,46,167,35,203,75
70068,10023,8046,1859,4571,1403,213,3284,2766,1373,623,1977,418,767,464,328,1648,329
70070,3899,3282,642,1882,660,98,1432,1184,410,256,617,49,277,179,112,533,84
70071,1319,1050,178,521,292,59,344,424,161,121,269,32,70,111,56,246,23
70072,19295,15345,3355,7764,3546,680,4979,5710,2584,2072,3950,720,1193,1298,739,3376,574
70075,3030,2322,445,1338,438,101,981,844,249,248,708,110,207,261,130,617,91
70076,140,105,25,38,34,8,13,28,31,33,35,0,15,15,5,28,7
70079,1351,991,133,429,323,106,254,477,98,162,360,73,64,125,98,294,66
70080,524,425,97,233,74,21,202,141,36,46,99,14,41,27,17,76,23
70082,236,200,20,126,54,0,26,61,83,30,36,0,7,18,11,36,0
70083,1281,993,150,550,210,83,354,357,125,157,288,30,98,107,53,259,29
70084,2585,1974,405,885,531,153,621,661,361,331,611,69,185,213,144,561,50
70085,2631,2066,486,1090,408,82,774,737,329,226,565,77,233,167,88,463,102
70086,665,576,74,284,158,60,176,158,95,147,89,16,14,34,25,83,6
70087,2279,1740,415,938,320,67,614,515,413,198,539,137,249,123,30,436,103
70090,2401,1936,391,915,548,82,675,727,294,240,465,69,113,136,147,424,41
70091,162,126,4,64,38,20,52,68,0,6,36,0,18,12,6,36,0
70092,3666,2835,646,1450,599,140,932,1009,496,398,831,117,260,327,127,699,132
70094,11872,9004,1978,4234,2374,418,2563,3083,1866,1492,2868,493,1074,917,384,2387,481
70112,2516,1271,701,378,119,73,102,151,782,236,1245,554,386,211,94,1050,195
70113,3975,2079,470,876,579,154,215,364,760,740,1896,273,676,623,324,1639,257
70114,10384,6800,2001,3187,1215,397,1653,1673,2206,1268,3584,812,1417,846,509,3112,472
70115,18222,8734,2164,3965,1915,690,1808,2823,2145,1958,9488,3467,3005,1965,1051,7558,1930
70116,8010,3326,882,1385,857,202,374,1012,1089,851,4684,1073,1889,1205,517,3886,798
70117,18773,12094,2668,5454,3080,892,1909,2853,3991,3341,6679,1160,2574,2092,853,5619,1060
70118,15072,7980,1703,3657,1945,675,1771,2676,1641,1892,7092,2815,1958,1447,872,5434,1658
70119,18540,10086,2482,4679,2047,878,1956,2399,3121,2610,8454,1957,3199,2022,1276,7191,1263
70121,5865,3222,683,1560,651,328,795,1318,514,595,2643,441,1021,638,543,2206,437
70122,17882,12100,2124,5833,2879,1264,2579,3859,3043,2619,5782,1077,1902,1741,1062,5020,762
70123,12251,7516,1327,3537,1929,723,2304,3695,731,786,4735,1439,1643,981,672,3982,753
70124,10695,6234,940,2905,1357,1032,1991,2832,631,780,4461,1009,1606,941,905,3790,671
70125,8977,5350,1506,2343,1160,341,937,1313,1846,1254,3627,1049,1105,889,584,2931,696
70126,14406,10658,2464,4806,2681,707,2553,3052,2758,2295,3748,802,1206,1139,601,3290,458
70127,11693,8120,2286,3922,1610,302,2190,2090,2382,1458,3573,807,1234,1034,498,3294,279
70128,6769,5375,1163,3137,968,107,1890,1622,1225,638,1394,475,590,279,50,1161,233
70129,4728,3672,1049,1742,708,173,1212,1108,984,368,1056,187,477,348,44,932,124
70130,7421,2670,730,1123,667,150,327,964,795,584,4751,1931,1482,874,464,4005,746
70131,10302,7399,1484,3783,1728,404,2567,2809,1213,810,2903,773,1102,740,288,2433,470
70163,0,0,0,0,0,0,0,0,0,0,0,0,0,0,0,0,0
70301,14347,10435,2471,5145,2362,457,3726,4110,1645,954,3912,995,1059,1113,745,3171,741
70339,2562,1982,440,976,481,85,797,865,205,115,580,137,158,167,118,506,74
70341,1554,1202,209,604,288,101,416,431,180,175,352,79,79,91,103,316,36
70342,1668,1202,308,574,281,39,473,420,231,78,466,48,151,158,109,389,77
70343,1542,1302,294,690,291,27,561,538,122,81,240,27,93,47,73,209,31
70344,2401,1876,392,862,554,68,736,882,127,131,525,76,171,173,105,426,99
70345,4540,3641,799,1722,932,188,1464,1549,331,297,899,121,216,311,251,784,115
70346,3684,2734,600,1308,602,224,723,830,704,477,950,134,311,290,215,869,81
70353,731,620,78,315,177,50,253,168,93,106,111,0,23,43,45,93,18
70354,1771,1365,254,672,351,88,508,652,110,95,406,81,61,176,88,309,97
70355,358,279,63,109,107,0,92,128,44,15,79,22,19,14,24,67,12
70356,897,723,133,360,184,46,232,288,119,84,174,30,38,80,26,158,16
70357,1166,849,226,332,209,82,365,289,86,109,317,53,104,99,61,236,81
70358,612,430,85,168,160,17,130,218,54,28,182,24,64,68,26,146,36
70359,2104,1584,434,837,275,38,690,539,286,69,520,154,200,122,44,407,113
70360,7636,5757,974,3232,1210,341,2275,2257,715,510,1879,301,580,604,394,1594,285
70363,8415,6699,1663,3155,1594,287,2158,2491,1235,815,1716,385,537,566,228,1269,447
70364,10084,7209,1933,3324,1645,307,2702,2739,1065,703,2875,656,855,926,438,2299,576
70372,985,736,249,289,171,27,282,277,81,96,249,44,64,104,37,206,43
70373,15,15,0,6,9,0,6,9,0,0,0,0,0,0,0,0,0
70374,3668,2747,570,1374,631,172,1118,1107,252,270,921,186,232,291,212,788,133
70375,30,30,6,18,6,0,7,12,0,11,0,0,0,0,0,0,0
70377,1492,1156,215,633,267,41,500,461,109,86,336,78,96,90,72,262,74
70380,8190,5748,1366,2642,1382,358,2022,2183,906,637,2442,362,883,772,425,2068,374
70390,2601,1978,433,937,490,118,580,755,391,252,623,68,177,220,158,547,76
70391,50,35,0,14,0,21,8,14,6,7,15,0,0,8,7,15,0
70392,2591,1911,445,997,379,90,782,643,316,170,680,107,336,170,67,570,110
70393,140,111,35,54,16,6,47,28,25,11,29,0,4,18,7,25,4
70394,4934,3913,825,1807,1101,180,1352,1608,554,399,1021,178,257,313,273,844,177
70395,1458,1246,313,651,258,24,592,484,104,66,212,52,42,76,42,186,26
70397,553,460,56,238,135,31,182,207,27,44,93,7,14,60,12,93,0
70401,6799,4115,1293,1727,860,235,1223,1609,861,422,2684,1415,550,484,235,1848,836
70403,7508,5263,1227,2658,1055,323,1752,1907,907,697,2245,665,544,674,362,1855,390
70420,1813,1424,373,765,239,47,663,537,142,82,389,32,182,126,49,330,59
70422,4283,3135,633,1418,919,165,1093,1106,511,425,1148,117,405,392,234,1034,114
70426,1858,1436,226,774,342,94,471,565,185,215,422,49,127,186,60,395,27
70427,8362,5658,1219,2526,1485,428,1558,2235,1025,840,2704,190,847,937,730,2456,248
70431,1703,1321,193,661,395,72,496,603,128,94,382,45,137,126,74,348,34
70433,8963,6534,1362,3186,1542,444,2584,2573,792,585,2429,419,822,717,471,2056,373
70435,3802,3071,506,1651,755,159,1231,1238,308,294,731,98,280,230,123,618,113
70436,156,82,16,58,0,8,37,0,7,38,74,7,20,39,8,68,6
70437,2161,1733,302,796,545,90,618,765,174,176,428,111,106,168,43,375,53
70438,5608,4107,894,1696,1172,345,1350,1600,564,593,1501,166,518,496,321,1395,106
70441,1768,1219,258,559,349,53,349,458,190,222,549,77,198,160,114,489,60
70442,132,112,24,59,24,5,43,47,22,0,20,7,7,6,0,20,0
70443,3442,2599,631,1120,692,156,879,1041,330,349,843,215,195,302,131,702,141
70444,3620,2647,660,1059,729,199,813,1077,430,327,973,122,265,363,223,862,111
70445,3350,2524,352,1387,667,118,843,1076,365,240,826,126,380,263,57,660,166
70446,1646,1276,293,662,293,28,582,477,120,97,370,56,92,157,65,319,51
70447,1476,1063,154,651,234,24,437,463,87,76,413,110,131,111,61,348,65
70448,7100,5479,1013,3286,1001,179,2763,1868,548,300,1621,298,743,407,173,1345,276
70449,1136,809,159,353,252,45,204,483,101,21,327,24,174,92,37,288,39
70450,857,637,109,292,197,39,159,295,110,73,220,20,97,85,18,186,34
70451,48,48,19,14,15,0,22,15,11,0,0,0,0,0,0,0,0
70452,4112,3174,586,1638,835,115,1088,1428,357,301,938,111,306,339,182,794,144
70453,364,305,64,121,106,14,100,150,19,36,59,0,41,10,8,51,8
70454,7180,5431,1227,2704,1248,252,2073,2084,738,536,1749,272,552,644,281,1578,171
70455,481,329,91,148,77,13,132,146,38,13,152,33,52,45,22,140,12
70456,1086,824,172,422,177,53,232,290,167,135,262,28,78,122,34,239,23
70458,12513,9241,1674,4454,2529,584,3151,4272,1112,706,3272,576,1149,1050,497,2731,541
70460,7147,5488,1213,2886,1181,208,2001,2231,797,459,1659,388,581,489,201,1335,324
70461,7897,6221,973,3824,1238,186,2990,2229,593,409,1676,294,701,494,187,1374,302
70462,1670,1282,293,609,331,49,476,531,155,120,388,26,139,162,61,355,33
70463,54,34,6,13,12,3,3,14,7,10,20,3,15,0,2,8,12
70464,62,56,0,35,21,0,26,30,0,0,6,0,6,0,0,6,0
70465,173,123,42,56,12,13,20,22,63,18,50,8,28,14,0,40,10
70466,2440,1767,460,855,382,70,761,639,234,133,673,120,256,150,147,602,71
70471,6910,5449,700,3487,1068,194,2661,2118,486,184,1461,293,547,352,269,1256,205
70501,11239,7149,1706,3053,1920,470,1612,2258,1945,1334,4090,1010,1225,1098,757,3355,735
70503,9011,6022,914,3213,1420,475,2411,2476,632,503,2989,1120,728,779,362,2328,661
70506,15349,8946,2440,4359,1747,400,3006,3377,1585,978,6403,2768,1879,1045,711,4783,1620
70507,5698,4213,1123,2122,857,111,1530,1446,871,366,1485,393,580,366,146,1193,292
70508,10728,7155,1695,3910,1359,191,3127,2794,812,422,3573,1403,1340,544,286,2848,725
70510,9126,6582,1406,3229,1534,413,2404,2352,1062,764,2544,374,657,888,625,2219,325
70512,3317,2547,571,1210,633,133,1014,984,354,195,770,78,239,285,168,668,102
70513,45,45,10,21,0,14,31,14,0,0,0,0,0,0,0,0,0
70514,980,747,165,345,210,27,225,258,163,101,233,38,79,76,40,203,30
70515,1162,839,216,393,184,46,364,285,111,79,323,30,115,132,46,298,25
70516,447,313,84,168,52,9,135,120,34,24,134,23,42,48,21,109,25
70517,8112,6081,1371,2972,1464,274,1993,2326,1189,573,2031,377,697,641,316,1714,317
70518,3998,3064,858,1632,484,90,1397,956,470,241,934,228,385,243,78,700,234
70520,5108,3987,973,2183,682,149,1646,1345,698,298,1121,249,388,357,127,941,180
70521,12,6,0,0,0,6,0,6,0,0,6,0,0,6,0,6,0
70523,231,175,44,76,48,7,33,60,49,33,56,18,20,13,5,36,20
70524,133,118,22,59,28,9,28,42,28,20,15,5,9,1,0,15,0
70525,4253,3213,808,1511,718,176,1254,1202,514,243,1040,136,298,362,244,976,64
70526,7332,5345,1383,2343,1321,298,1761,2082,976,526,1987,244,525,801,417,1721,266
70528,1024,756,211,331,173,41,265,295,123,73,268,59,67,78,64,199,69
70529,3486,2624,715,1310,474,125,982,904,519,219,862,218,310,232,102,677,185
70531,377,301,61,130,86,24,129,123,26,23,76,7,9,34,26,69,7
70532,1050,743,216,303,180,44,299,258,129,57,307,53,58,121,75,270,37
70533,2552,1997,489,948,449,111,830,775,235,157,555,104,124,195,132,492,63
70534,330,235,51,109,65,10,84,105,23,23,95,4,9,64,18,87,8
70535,6819,4925,1022,2257,1333,313,1852,1916,629,528,1894,282,545,658,409,1673,221
70537,260,204,64,83,57,0,78,89,26,11,56,9,6,37,4,50,6
70538,5497,4256,819,1921,1295,221,1242,1547,825,642,1241,122,391,399,329,1138,103
70540,9,9,0,0,9,0,0,9,0,0,0,0,0,0,0,0,0
70541,175,119,20,48,41,10,26,37,28,28,56,4,24,18,10,49,7
70542,1462,1061,164,527,298,72,337,511,118,95,401,55,104,144,98,337,64
70543,1238,922,238,475,182,27,432,297,131,62,316,23,73,124,96,300,16
70544,4046,3094,610,1478,764,242,1011,1025,584,474,952,94,307,395,156,883,69
70546,5890,4408,1027,1910,1147,324,1689,1612,624,483,1482,218,372,501,391,1295,187
70548,3892,2725,612,1210,697,206,1011,1128,327,259,1167,205,285,357,320,1000,167
70549,1665,1190,232,558,299,101,440,469,170,111,475,36,152,178,109,440,35
70550,111,69,0,30,32,7,16,39,7,7,42,7,0,8,27,42,0
70552,483,355,89,123,101,42,104,176,56,19,128,27,36,37,28,115,13
70554,2281,1557,344,736,387,90,532,582,267,176,724,112,184,278,150,653,71
70555,2501,2050,427,1107,412,104,921,817,207,105,451,125,123,129,74,376,75
70556,278,206,55,81,54,16,55,89,36,26,72,8,24,23,17,56,16
70558,95,59,11,28,13,7,33,26,0,0,36,9,5,9,13,27,9
70559,760,602,134,308,128,32,222,226,81,73,158,21,51,62,24,137,21
70560,14259,10495,2612,4952,2351,580,3596,3592,1974,1333,3764,784,1158,1148,674,3167,597
70563,6286,4938,846,2559,1183,350,2026,1890,594,428,1348,142,380,451,375,1229,119
70570,15832,11220,2474,5243,2856,647,3523,3687,2355,1655,4612,592,1319,1621,1080,4289,323
70576,261,206,61,91,44,10,85,62,47,12,55,4,11,16,24,55,0
70577,1678,1238,215,636,320,67,445,516,165,112,440,80,102,171,87,378,62
70578,5464,4042,1057,1821,1000,164,1477,1492,577,496,1422,230,444,424,324,1239,183
70580,78,50,20,30,0,0,36,7,7,0,28,6,0,0,22,28,0
70581,287,216,31,118,50,17,103,87,6,20,71,8,23,22,18,66,5
70582,6962,5273,1191,2590,1230,262,2025,1751,966,531,1689,338,440,471,440,1485,204
70583,3849,2849,881,1358,507,103,1136,946,547,220,1000,274,374,226,126,833,167
70584,2263,1714,365,833,418,98,535,659,299,221,549,92,203,169,85,480,69
70585,58,41,12,16,11,2,18,14,5,4,17,0,6,6,5,17,0
70586,7882,5707,1507,2470,1408,322,2019,2094,1024,570,2175,218,548,848,561,2071,104
70589,1379,1072,254,420,305,93,356,449,134,133,307,29,71,124,83,292,15
70591,1877,1468,324,692,340,112,619,548,170,131,409,51,111,129,118,375,34
70592,3973,3057,863,1686,422,86,1430,1022,396,209,916,321,311,223,61,693,223
70601,14117,8714,1968,3638,2308,800,2081,2924,1964,1745,5403,1052,1781,1471,1099,4624,779
70605,11117,8027,1459,4062,2063,443,3133,3477,884,533,3090,785,947,763,595,2562,528
70607,8731,6204,1918,2656,1345,285,2268,2232,1139,565,2527,888,830,575,234,2047,480
70611,5820,4813,1143,2566,926,178,2153,1823,545,292,1007,205,374,289,139,858,149
70615,4755,3387,929,1585,758,115,1151,1223,568,445,1368,273,576,398,121,1133,235
70630,350,314,109,100,105,0,134,151,21,8,36,0,16,7,13,36,0
70631,1174,908,201,464,193,50,372,337,106,93,266,24,62,137,43,221,45
70632,491,343,18,195,118,12,117,157,31,38,148,7,35,79,27,119,29
70633,2858,2119,477,910,578,154,847,842,222,208,739,66,202,310,161,676,63
70634,8916,6549,1395,3071,1714,369,2427,2756,758,608,2367,339,665,828,535,2092,275
70637,240,165,41,74,41,9,84,68,13,0,75,0,0,50,25,75,0
70638,341,305,74,143,71,17,131,119,36,19,36,0,3,21,12,35,1
70639,229,194,46,53,78,17,75,87,14,18,35,7,7,21,0,28,7
70640,164,118,29,59,25,5,40,40,29,9,46,14,6,14,12,43,3
70643,257,188,28,78,68,14,46,75,38,29,69,23,21,15,10,60,9
70644,56,50,12,31,7,0,30,20,0,0,6,0,0,0,6,6,0
70645,619,415,64,220,120,11,186,167,20,42,204,35,71,66,32,182,22
70646,131,79,17,39,23,0,40,17,10,12,52,0,10,26,16,52,0
70647,2542,1960,430,1006,416,108,792,792,240,136,582,126,197,151,108,488,94
70648,2192,1654,314,804,413,123,595,662,230,167,538,30,171,216,121,506,32
70650,140,103,6,44,48,5,25,50,28,0,37,0,7,24,6,37,0
70651,71,63,0,37,23,3,13,36,14,0,8,0,8,0,0,8,0
70652,700,627,163,277,166,21,206,274,82,65,73,16,14,15,28,61,12
70653,1314,952,202,421,283,46,323,460,93,76,362,56,112,106,88,334,28
70654,99,65,20,27,18,0,39,23,0,3,34,0,8,14,12,34,0
70655,1187,841,164,366,266,45,288,385,107,61,346,66,85,132,63,320,26
70656,1494,1149,254,557,297,41,506,478,66,99,345,29,86,136,94,316,29
70657,1339,1102,319,445,306,32,495,490,72,45,237,31,111,66,29,181,56
70658,274,199,58,103,31,7,89,59,30,21,75,19,15,20,21,65,10
70659,262,175,44,86,39,6,53,66,42,14,87,17,31,19,20,75,12
70660,597,453,107,262,58,26,198,183,37,35,144,18,40,68,18,126,18
70661,994,726,164,311,219,32,220,336,81,89,268,29,49,117,73,264,4
70662,147,121,25,54,42,0,46,38,21,16,26,0,4,6,16,26,0
70663,10105,7408,1718,3488,1829,373,2698,3173,913,624,2697,501,765,874,557,2324,373
70665,3289,2581,575,1300,559,147,1114,1037,273,157,708,186,237,162,123,568,140
70668,2371,1800,348,810,542,100,596,780,230,194,571,103,162,180,126,452,119
70669,3740,2852,709,1249,716,178,974,1190,425,263,888,188,349,212,139,767,121
70706,4508,3736,974,2004,652,106,1814,1345,388,189,772,173,206,263,130,669,103
70710,1077,836,212,435,168,21,329,267,171,69,241,54,93,69,25,205,36
70711,1412,1094,275,447,315,57,406,447,150,91,318,54,114,91,59,286,32
70712,171,145,67,66,12,0,91,36,13,5,26,7,19,0,0,23,3
70714,6960,5433,1073,2787,1356,217,1794,1992,1004,643,1527,402,414,488,223,1350,177
70715,427,359,66,137,79,77,91,149,44,75,68,0,26,26,16,42,26
70717,23,23,7,10,6,0,17,6,0,0,0,0,0,0,0,0,0
70719,1290,983,177,494,262,50,333,364,147,139,307,35,122,80,70,268,39
70720,192,153,51,73,22,7,55,51,29,18,39,9,14,16,0,39,0
70721,142,101,24,39,35,3,22,28,29,22,41,15,9,11,6,41,0
70722,2015,1579,213,804,480,82,474,584,251,270,436,59,152,123,102,405,31
70723,650,468,82,242,131,13,95,161,116,96,182,10,73,62,37,158,24
70725,352,270,17,174,56,23,109,64,40,57,82,0,24,35,23,82,0
70726,13012,10049,2542,5042,1973,492,4075,3843,1400,731,2963,627,1029,805,502,2489,474
70729,42,23,9,14,0,0,9,0,9,5,19,0,0,19,0,19,0
70730,1363,1019,182,559,178,100,293,438,131,157,344,54,95,141,54,307,37
70732,399,317,43,165,96,13,118,148,22,29,82,11,28,34,9,65,17
70733,565,447,88,212,108,39,160,216,41,30,118,18,37,50,13,94,24
70734,1063,818,238,385,145,50,321,279,115,103,245,124,77,31,13,207,38
70736,187,164,22,77,49,16,25,108,22,9,23,0,17,6,0,17,6
70737,10015,7818,2005,3941,1613,259,3108,2843,1070,797,2197,621,820,544,212,1795,402
70739,3678,3124,652,1606,758,108,1268,1383,334,139,554,111,206,162,75,468,86
70740,520,407,70,216,100,21,136,136,48,87,113,32,48,16,17,92,21
70743,102,81,16,36,23,6,27,48,0,6,21,0,13,8,0,21,0
70744,1737,1348,314,707,278,49,535,578,153,82,389,34,186,122,47,323,66
70747,31,25,14,0,11,0,14,5,0,6,6,0,6,0,0,6,0
70748,2011,1541,378,649,421,93,458,577,314,192,470,35,164,167,104,441,29
70749,627,419,57,234,110,18,191,162,26,40,208,30,77,62,39,167,41
70750,661,485,115,196,133,41,176,218,47,44,176,37,47,50,42,159,17
70752,306,214,35,101,67,11,65,108,7,34,92,9,41,28,14,92,0
70753,443,345,65,136,109,35,78,111,60,96,98,14,44,33,7,98,0
70754,2498,1989,499,970,461,59,792,841,204,152,509,60,138,209,102,445,64
70755,867,701,199,318,140,44,303,303,48,47,166,36,43,52,35,142,24
70756,132,96,24,47,13,12,48,29,13,6,36,0,4,26,6,36,0
70757,1112,848,148,424,207,69,300,237,172,139,264,20,74,108,62,229,35
70759,567,399,80,202,94,23,146,149,57,47,168,16,40,61,51,144,24
70760,2717,1859,310,898,476,175,565,623,408,263,858,94,193,356,215,776,82
70761,460,323,44,187,53,39,82,116,78,47,137,6,51,50,30,127,10
70762,244,192,17,132,43,0,64,110,13,5,52,15,20,12,5,35,17
70763,1018,824,162,441,203,18,355,308,75,86,194,39,77,50,28,174,20
70764,6271,4664,990,2153,1159,362,1476,1656,764,768,1607,257,568,498,284,1422,185
70767,5085,3770,716,1870,964,220,1177,1421,657,515,1315,258,486,357,214,1128,187
70769,8366,6806,1905,3677,1096,128,3128,2615,654,409,1560,321,585,443,211,1309,251
70770,1294,1082,195,657,203,27,491,470,68,53,212,44,43,98,27,188,24
70772,254,196,28,109,41,18,70,52,28,46,58,7,29,11,11,48,10
70773,82,68,28,6,19,15,26,19,8,15,14,8,0,6,0,14,0
70774,2704,2132,554,1090,428,60,976,790,246,120,572,139,204,142,87,502,70
70775,2907,2150,379,1130,482,159,787,803,351,209,757,115,307,262,73,709,48
70776,830,601,104,318,147,32,200,194,104,103,229,63,91,58,17,186,43
70777,1405,1107,256,531,293,27,411,515,112,69,298,74,90,92,42,259,39
70778,594,434,90,220,110,14,181,158,61,34,160,23,60,48,29,126,34
70780,362,271,68,116,80,7,88,93,42,48,91,26,20,32,13,80,11
70781,105,73,14,31,17,11,30,26,10,7,32,7,20,5,0,32,0
70782,99,67,31,29,7,0,42,16,9,0,32,7,14,0,11,25,7
70783,904,670,111,383,164,12,246,334,68,22,234,23,63,115,33,200,34
70785,5353,4274,1178,2063,897,136,1921,1683,397,273,1079,240,366,324,149,873,206
70787,67,48,0,30,10,8,12,6,12,18,19,0,0,9,10,19,0
70788,1531,1208,213,540,351,104,340,417,252,199,323,46,124,78,75,311,12
70789,261,184,37,77,47,23,54,43,42,45,77,3,21,38,15,71,6
70791,6747,5434,1047,2860,1282,245,2213,2117,616,488,1313,266,399,375,273,1138,175
70801,8,8,0,8,0,0,0,8,0,0,0,0,0,0,0,0,0
70802,11877,6572,1667,2671,1657,577,1063,1624,2030,1855,5305,1926,1566,1171,642,4381,924
70805,10903,7573,1937,3925,1317,394,1918,1646,2507,1502,3330,599,1247,1088,396,2859,471
70806,12373,6481,1834,2793,1270,584,1569,2260,1718,934,5892,1925,1794,1037,1136,4863,1029
70807,6437,4663,1199,1781,1268,415,689,1341,1512,1121,1774,287,617,616,254,1562,212
70808,13672,7504,1503,3364,1895,742,2444,3567,628,865,6168,3175,1221,919,853,4542,1626
70809,8910,4867,1138,2333,1068,328,1685,2235,454,493,4043,1653,1023,720,647,3323,720
70810,11221,8059,1683,4548,1620,208,3383,2915,1049,712,3162,1255,1135,605,167,2366,796
70811,4285,3323,592,1632,899,200,993,1129,631,570,962,109,314,392,147,881,81
70812,3742,3100,719,1642,644,95,877,796,895,532,642,92,251,184,115,609,33
70814,5112,3851,945,1921,763,222,1458,1332,717,344,1261,276,521,279,185,1092,169
70815,11288,7849,1615,3360,2087,787,2328,3418,1265,838,3439,750,1086,882,721,2883,556
70816,16045,9575,2822,4628,1794,331,3401,3619,1670,885,6470,3088,2095,926,361,5056,1414
70817,9636,7934,1456,4843,1436,199,3713,3220,647,354,1702,458,707,424,113,1360,342
70818,3642,2939,559,1547,729,104,1087,1191,420,241,703,151,201,212,139,608,95
70819,1880,1357,343,602,359,53,405,537,182,233,523,85,277,111,50,475,48
70820,6361,2250,1051,977,216,6,727,594,434,495,4111,3449,441,169,52,1947,2164
70836,0,0,0,0,0,0,0,0,0,0,0,0,0,0,0,0,0
71001,1696,1192,226,493,376,97,292,448,251,201,504,78,133,155,138,473,31
71002,60,42,16,8,15,3,16,15,5,6,18,0,8,3,7,18,0
71003,444,322,51,146,98,27,112,138,24,48,122,7,43,42,30,99,23
71004,255,193,26,78,62,27,55,102,23,13,62,11,13,19,19,52,10
71006,3552,2910,462,1471,833,144,1011,1342,276,281,642,68,228,228,118,593,49
71007,493,353,85,172,93,3,145,134,36,38,140,9,73,8,50,117,23
71008,392,272,36,130,78,28,62,112,51,47,120,9,28,49,34,118,2
71009,165,132,52,55,17,8,49,32,36,15,33,7,3,17,6,25,8
71016,787,593,143,249,145,56,239,210,76,68,194,17,53,73,51,179,15
71018,669,466,85,194,154,33,105,220,70,71,203,23,59,70,51,194,9
71019,3191,2351,578,992,602,179,771,909,389,282,840,105,176,333,226,759,81
71021,347,212,36,87,69,20,26,45,73,68,135,17,51,48,19,123,12
71023,1437,1060,203,449,333,75,310,571,114,65,377,27,162,103,85,343,34
71024,467,343,60,153,102,28,119,164,37,23,124,12,36,55,21,104,20
71027,626,437,82,198,120,37,131,129,90,87,189,0,107,48,34,165,24
71028,841,547,88,246,161,52,134,203,101,109,294,30,84,85,95,280,14
71029,94,61,10,37,14,0,12,31,10,8,33,3,13,9,8,30,3
71030,415,330,77,173,73,7,104,115,78,33,85,14,20,35,16,80,5
71031,480,343,95,125,106,17,127,168,25,23,137,6,30,56,45,134,3
71032,618,450,66,211,141,32,156,226,53,15,168,15,42,51,60,144,24
71033,1013,738,106,366,241,25,226,363,91,58,275,47,88,101,39,222,53
71034,65,50,9,26,8,7,9,17,7,17,15,0,7,8,0,12,3
71037,6569,5219,1182,2670,1167,200,2183,2056,570,410,1350,250,544,370,186,1128,222
71038,1927,1341,283,552,372,134,369,500,271,201,586,65,145,191,185,553,33
71039,886,651,95,303,205,48,207,302,73,69,235,39,52,71,73,215,20
71040,3154,2206,357,939,679,231,533,887,388,398,948,123,222,325,278,901,47
71043,278,205,31,99,51,24,42,90,42,31,73,2,26,25,20,63,10
71044,292,214,37,55,88,34,61,131,9,13,78,9,15,29,25,78,0
71045,256,194,41,70,65,18,62,107,14,11,62,11,13,16,22,58,4
71046,435,309,47,141,98,23,86,174,20,29,126,12,35,42,37,109,17
71047,3872,3016,618,1328,958,112,1001,1267,400,348,856,140,284,315,117,764,92
71048,33,12,1,7,0,4,0,8,4,0,21,4,0,9,8,21,0
71049,1409,1013,207,459,288,59,318,405,162,128,396,41,85,159,111,375,21
71051,784,556,104,237,190,25,153,273,59,71,228,15,97,93,23,170,58
71052,4240,2970,758,1241,759,212,779,1035,697,459,1270,121,390,421,338,1162,108
71055,7974,5507,1239,2372,1466,430,1531,2312,943,721,2467,290,701,906,570,2260,207
71060,1068,802,108,409,257,28,243,379,106,74,266,37,101,80,48,238,28
71061,794,547,129,224,155,39,162,224,81,80,247,20,84,84,59,237,10
71063,333,229,23,105,57,44,65,124,16,24,104,0,54,36,14,84,20
71064,1595,1105,226,497,299,83,281,451,203,170,490,66,164,167,93,447,43
71065,472,285,67,124,67,27,95,129,45,16,187,32,30,88,37,167,20
71066,14,11,0,9,0,2,0,4,2,5,3,0,0,3,0,3,0
71067,626,475,79,255,107,34,136,124,96,119,151,20,53,46,32,133,18
71068,1622,1110,207,448,365,90,295,478,194,143,512,51,156,160,145,478,34
71069,342,205,51,89,46,19,78,77,23,27,137,4,27,73,33,121,16
71070,634,452,82,185,146,39,154,212,29,57,182,8,48,56,70,174,8
71071,1247,931,205,403,234,89,328,428,97,78,316,29,86,91,110,296,20
71072,612,489,113,206,109,61,177,209,44,59,123,19,14,39,51,123,0
71073,798,566,117,199,222,28,138,293,54,81,232,20,64,68,80,218,14
71075,2612,1772,369,638,589,176,455,847,246,224,840,97,178,358,207,763,77
71078,1596,1226,264,584,335,43,439,586,130,71,370,50,153,128,39,311,59
71079,116,91,8,24,33,26,8,55,10,18,25,0,12,8,5,18,7
71082,2207,1473,355,649,366,103,448,636,273,116,734,79,173,229,253,660,74
71101,3851,1897,593,734,416,154,227,349,817,504,1954,386,697,534,337,1719,235
71103,3744,2248,503,861,688,196,271,524,678,775,1496,158,442,533,363,1364,132
71104,6848,3572,956,1746,542,328,961,1199,831,581,3276,1110,989,609,568,2714,562
71105,9371,5461,1259,2359,1212,631,1643,2535,728,555,3910,1229,1096,778,807,3304,606
71106,12061,8898,1865,3995,2413,625,2433,3368,1820,1277,3163,559,985,940,679,2865,298
71107,10615,7945,1683,3655,2116,491,2162,3030,1611,1142,2670,420,993,736,521,2299,371
71108,7543,5435,1516,2498,1119,302,1369,1321,1534,1211,2108,415,694,548,451,1843,265
71109,9326,6394,1363,2839,1723,469,1161,1805,1748,1680,2932,535,986,938,473,2548,384
71110,745,729,413,316,0,0,526,124,79,0,16,7,9,0,0,16,0
71111,11899,8248,2269,3833,1710,436,2707,3079,1718,744,3651,875,1352,942,482,3157,494
71112,10369,7406,1860,3209,1929,408,2683,2961,1009,753,2963,634,1107,714,508,2452,511
71115,5308,2734,691,1223,621,199,750,1196,416,372,2574,1050,543,564,417,2233,341
71118,9598,6715,1454,3035,1844,382,2173,3115,854,573,2883,634,820,797,632,2467,416
71119,4424,3216,508,1632,836,240,874,1546,474,322,1208,260,450,352,146,1045,163
71129,4976,3279,842,1653,670,114,1025,1237,731,286,1697,546,579,410,162,1459,238
71201,9731,5534,1364,2429,1262,479,1727,2184,936,687,4197,1369,905,1054,869,3556,641
71202,9680,7304,2000,3380,1618,306,1527,1769,2411,1597,2376,319,919,727,411,2119,257
71203,12457,8532,2293,3803,1948,488,2807,3302,1488,935,3925,1508,1114,778,525,3163,762
71218,36,23,7,10,0,6,6,10,7,0,13,0,0,0,13,13,0
71219,415,345,50,168,107,20,138,133,32,42,70,2,14,22,32,68,2
71220,9728,7198,1700,3138,1751,609,2046,2906,1282,964,2530,304,764,798,664,2321,209
71222,1420,946,249,356,268,73,272,388,135,151,474,89,144,110,131,444,30
71223,240,175,32,90,32,21,52,58,44,21,65,2,9,35,19,62,3
71225,1873,1473,270,666,427,110,494,692,156,131,400,70,134,122,74,370,30
71226,707,495,93,240,128,34,122,211,83,79,212,31,66,76,39,204,8
71227,1173,882,209,420,204,49,351,402,50,79,291,47,88,87,69,278,13
71229,537,378,75,161,119,23,103,162,44,69,159,5,74,56,24,142,17
71232,2583,1861,412,806,472,171,585,760,299,217,722,76,181,298,167,679,43
71234,1618,1226,327,555,302,42,482,514,97,133,392,80,100,154,58,348,44
71235,1605,1191,282,504,314,91,423,508,123,137,414,62,103,97,152,355,59
71237,520,403,91,203,97,12,145,178,50,30,117,8,10,38,61,103,14
71238,867,721,149,367,176,29,272,342,62,45,146,35,45,24,42,125,21
71241,3585,2672,615,1161,719,177,821,1324,333,194,913,166,231,337,179,810,103
71243,130,97,11,44,12,30,25,47,21,4,33,0,13,13,7,33,0
71245,1136,621,159,213,180,69,97,216,178,130,515,265,116,71,63,368,147
71247,438,259,46,101,84,28,68,113,33,45,179,24,27,69,59,171,8
71250,117,95,13,56,26,0,22,32,20,21,22,0,8,9,5,22,0
71251,3274,2314,432,968,686,228,702,975,352,285,960,98,263,282,317,901,59
71253,76,54,11,20,22,1,16,23,8,7,22,3,4,5,10,18,4
71254,2549,1832,467,728,481,156,403,573,550,306,717,85,183,269,180,671,46
71256,185,126,36,28,53,9,35,50,15,26,59,10,11,30,8,57,2
71259,675,528,114,206,151,57,142,256,87,43,147,6,22,75,44,142,5
71260,1259,889,185,390,258,56,283,394,102,110,370,25,111,104,130,332,38
71261,607,435,87,193,122,33,101,153,121,60,172,20,39,56,57,164,8
71263,3274,2372,502,1035,672,163,842,1094,254,182,902,72,239,288,303,825,77
71264,435,302,40,132,111,19,102,144,28,28,133,12,18,43,60,121,12
71266,682,505,91,211,151,52,176,238,37,54,177,20,42,53,62,160,17
71268,1152,918,179,446,256,37,358,369,98,93,234,30,50,91,63,224,10
71269,4379,3211,722,1375,847,267,1044,1244,513,410,1168,131,339,399,299,1041,127
71270,10844,6681,1765,3020,1472,424,2155,2533,1208,785,4163,2017,729,759,658,3022,1141
71275,926,674,129,314,179,52,201,297,77,99,252,64,60,47,81,210,42
71276,98,71,10,32,7,22,29,14,4,24,27,4,3,9,11,24,3
71277,817,650,161,244,206,39,268,258,69,55,167,12,67,32,56,167,0
71280,1046,746,194,324,189,39,256,305,102,83,300,51,63,94,92,274,26
71282,3933,2803,733,1232,651,187,685,886,760,472,1130,161,411,354,204,1011,119
71286,291,225,37,87,70,31,60,146,19,0,66,4,4,38,20,66,0
71291,12306,8588,1981,4037,2075,495,3188,3451,1283,666,3718,963,1107,984,664,3241,477
71292,7499,5689,1275,2723,1456,235,1882,2659,591,557,1810,294,519,685,312,1508,302
71295,5235,3831,856,1644,1032,299,1142,1479,604,606,1404,138,338,532,396,1281,123
71301,8874,5671,1251,2796,1134,490,1448,1840,1372,1011,3203,560,987,931,725,2825,378
71302,5490,3950,826,1665,1185,274,867,1352,939,792,1540,266,420,571,283,1389,151
71303,7463,5089,1087,2379,1337,286,1638,1929,1017,505,2374,507,660,685,522,2102,272
71316,25,15,0,3,6,6,3,12,0,0,10,0,0,0,10,10,0
71320,0,0,0,0,0,0,0,0,0,0,0,0,0,0,0,0,0
71322,2696,1931,456,830,465,180,624,648,302,357,765,80,234,243,208,672,93
71323,366,311,90,124,86,11,135,147,16,13,55,23,0,26,6,43,12
71325,570,415,102,155,135,23,90,134,98,93,155,6,33,60,56,144,11
71326,426,320,71,102,109,38,90,136,38,56,106,2,34,44,26,97,9
71327,1552,1119,277,518,254,70,386,404,221,108,433,41,83,194,115,397,36
71328,2300,1907,429,918,487,73,843,773,183,108,393,41,106,143,103,348,45
71330,27,21,8,7,6,0,0,0,15,6,6,0,0,6,0,0,6
71331,339,213,67,83,58,5,93,101,11,8,126,31,19,39,37,115,11
71333,289,205,18,107,73,7,58,94,29,24,84,15,30,26,13,76,8
71334,3452,2432,520,945,736,231,485,986,587,374,1020,149,393,270,208,925,95
71336,696,529,79,268,149,33,184,242,59,44,167,14,50,72,31,158,9
71339,61,38,6,22,0,10,22,6,0,10,23,0,4,8,11,23,0
71340,372,282,51,133,62,36,100,119,27,36,90,9,31,33,17,81,9
71341,1043,744,214,290,219,21,278,332,83,51,299,42,57,102,98,279,20
71342,2809,1978,414,910,557,97,717,869,216,176,831,57,237,309,228,769,62
71343,3119,2364,475,1080,668,141,768,1008,347,241,755,110,176,277,192,731,24
71345,29,24,0,15,9,0,4,0,11,9,5,0,5,0,0,5,0
71346,1200,839,145,384,227,83,275,328,107,129,361,32,119,137,73,332,29
71350,1626,1179,202,549,327,101,387,492,175,125,447,86,152,113,96,376,71
71351,4068,2935,649,1387,719,180,932,1103,614,286,1133,195,278,407,253,1002,131
71353,834,648,156,281,148,63,175,256,120,97,186,18,46,73,49,184,2
71354,611,455,72,203,154,26,177,210,14,54,156,47,24,49,36,150,6
71355,952,664,161,284,162,57,221,309,79,55,288,29,64,101,94,275,13
71356,246,160,18,68,56,18,40,83,12,25,86,30,8,30,18,86,0
71357,911,645,143,270,153,79,186,228,138,93,266,18,66,110,72,247,19
71358,444,324,37,136,99,52,120,112,24,68,120,3,25,66,26,115,5
71360,14202,10207,2393,4747,2449,618,3684,4218,1440,865,3995,699,1302,1319,675,3555,440
71362,671,470,129,198,109,34,194,219,39,18,201,21,26,98,56,183,18
71366,877,611,112,271,172,56,170,258,99,84,266,27,68,91,80,236,30
71367,535,422,142,174,78,28,202,140,44,36,113,8,30,34,41,99,14
71368,583,383,84,176,98,25,116,141,82,44,200,11,74,61,54,183,17
71369,1142,815,204,371,188,52,277,248,177,113,327,42,85,131,69,299,28
71371,722,516,90,255,128,43,208,223,48,37,206,39,47,72,48,185,21
71373,2740,2034,424,892,602,116,612,852,332,238,706,44,283,236,143,662,44
71375,607,365,36,172,129,28,89,133,69,74,242,25,79,60,78,227,15
71377,102,80,4,60,16,0,26,0,26,28,22,0,15,7,0,15,7
71378,1035,764,186,278,220,80,255,290,108,111,271,18,87,113,53,248,23
71401,37,29,7,16,0,6,19,6,0,4,8,0,0,8,0,8,0
71403,1575,1171,235,582,303,51,444,539,109,79,404,80,120,132,72,357,47
71404,352,249,62,127,47,13,102,90,43,14,103,22,23,37,21,80,23
71406,59,48,21,15,12,0,23,20,5,0,11,0,0,0,11,11,0
71407,218,178,46,67,64,1,67,77,18,16,40,8,7,17,8,40,0
71409,2533,1842,393,906,450,93,765,668,188,221,691,105,245,268,73,589,102
71410,43,34,3,13,16,2,6,16,8,4,9,0,4,5,0,9,0
71411,1199,850,232,359,218,41,295,274,191,90,349,67,72,128,82,308,41
71414,82,60,15,30,3,12,11,17,17,15,22,0,0,8,14,20,2
71415,244,164,40,73,41,10,53,65,25,21,80,12,21,29,18,69,11
71416,303,225,79,73,37,36,77,107,14,27,78,6,20,41,11,78,0
71417,1956,1373,308,593,355,117,368,514,278,213,583,83,146,252,102,532,51
71418,2574,1813,354,834,501,124,577,789,215,232,761,85,191,297,188,677,84
71419,846,607,81,245,226,55,215,291,55,46,239,25,54,84,76,226,13
71422,637,463,119,194,130,20,209,160,46,48,174,15,35,75,49,161,13
71423,1626,1332,313,687,265,67,585,510,171,66,294,93,64,94,43,222,72
71424,367,304,117,127,50,10,156,107,18,23,63,6,13,38,6,54,9
71425,106,69,13,23,28,5,19,50,0,0,37,8,7,22,0,37,0
71426,72,51,8,34,8,1,26,21,0,4,21,3,2,9,7,21,0
71427,128,99,19,56,24,0,48,27,5,19,29,0,0,29,0,29,0
71429,1207,902,178,364,268,92,311,428,71,92,305,16,92,119,78,284,21
71430,787,614,132,258,187,37,251,260,30,73,173,23,58,44,48,144,29
71432,422,287,65,129,80,13,98,141,24,24,135,15,29,66,25,131,4
71433,1590,1138,224,560,261,93,440,456,128,114,452,56,112,169,115,395,57
71434,20,9,0,3,6,0,0,9,0,0,11,5,0,6,0,11,0
71435,1132,861,199,422,185,55,303,405,86,67,271,24,100,94,53,240,31
71438,480,319,75,121,93,30,140,147,7,25,161,20,35,72,34,154,7
71439,736,547,104,264,136,43,167,267,59,54,189,30,27,72,60,186,3
71441,267,202,63,76,50,13,92,70,15,25,65,8,6,42,9,54,11
71446,8568,5986,1577,2725,1430,254,2073,2491,948,474,2582,560,792,890,340,2340,242
71447,614,475,109,226,113,27,187,191,50,47,139,4,33,76,26,130,9
71449,3733,2645,568,1093,794,190,738,1308,374,225,1088,136,276,445,231,997,91
71450,442,315,97,141,77,0,128,112,33,42,127,5,31,43,48,123,4
71452,25,25,6,0,15,4,0,21,0,4,0,0,0,0,0,0,0
71454,921,670,157,301,181,31,219,325,88,38,251,26,50,104,71,225,26
71455,113,73,31,15,27,0,27,34,12,0,40,0,28,0,12,25,15
71456,411,253,36,133,54,30,86,81,48,38,158,27,44,53,34,154,4
71457,9575,6284,1538,2850,1448,448,1909,2218,1283,874,3291,1163,744,871,513,2562,729
71459,3484,3277,2373,904,0,0,2258,759,236,24,207,185,16,6,0,193,14
71461,956,684,230,299,138,17,216,243,160,65,272,106,83,68,15,193,79
71462,586,379,67,197,109,6,193,148,23,15,207,47,47,57,56,187,20
71463,3568,2607,567,1101,771,168,820,1001,407,379,961,109,190,383,279,905,56
71465,1187,873,174,399,233,67,343,410,49,71,314,48,63,119,84,276,38
71466,199,129,32,76,15,6,56,61,7,5,70,0,22,48,0,51,19
71467,1775,1345,302,583,369,91,458,619,168,100,430,36,185,107,102,362,68
71468,353,260,64,104,71,21,108,117,17,18,93,7,15,43,28,90,3
71469,1111,761,133,362,195,71,235,401,61,64,350,41,78,139,92,320,30
71472,68,36,5,12,19,0,10,13,0,13,32,0,6,0,26,26,6
71473,231,148,20,86,31,11,44,77,12,15,83,6,13,27,37,77,6
71474,248,184,40,76,54,14,68,91,15,10,64,2,18,33,11,64,0
71479,358,263,59,108,79,17,74,152,12,25,95,16,19,32,28,86,9
71480,303,217,67,74,64,12,81,96,18,22,86,8,22,30,26,73,13
71483,4182,2998,586,1333,837,242,959,1155,434,450,1184,141,341,404,298,1104,80
71485,569,469,88,262,110,9,198,179,61,31,100,23,46,24,7,73,27
71486,1888,1430,284,582,441,123,389,655,216,170,458,35,93,222,108,428,30
71601,7257,4914,1276,2108,1111,419,1105,1503,1451,855,2343,436,768,621,518,2057,286
71602,6892,5095,1159,2319,1283,334,1796,2164,703,432,1797,363,499,557,378,1580,217
71603,13803,9751,2108,4312,2690,641,2775,4144,1624,1208,4052,705,1204,1120,1023,3649,403
71630,271,191,39,83,58,11,50,83,31,27,80,7,23,27,23,69,11
71631,337,216,29,93,77,17,64,88,21,43,121,5,41,52,23,110,11
71635,5342,3963,977,1601,1141,244,1236,1849,514,364,1379,217,375,387,400,1250,129
71638,1691,1183,230,433,385,135,234,461,235,253,508,55,134,180,139,459,49
71639,2787,1999,424,967,475,133,632,726,395,246,788,102,264,245,177,735,53
71640,1509,1074,203,441,354,76,270,338,247,219,435,30,126,148,131,397,38
71642,237,156,28,62,55,11,41,78,16,21,81,5,29,27,20,77,4
71643,677,469,93,188,139,49,94,178,115,82,208,17,73,56,62,183,25
71644,395,298,43,153,79,23,103,110,51,34,97,13,37,35,12,84,13
71646,2679,2040,454,958,482,146,736,943,207,154,639,59,146,245,189,591,48
71647,808,615,142,255,174,44,196,288,79,52,193,25,40,71,57,186,7
71651,72,47,6,30,0,11,14,18,10,5,25,0,5,8,12,25,0
71652,488,355,67,147,112,29,113,181,26,35,133,17,44,43,29,121,12
71653,2222,1550,337,716,372,125,536,622,224,168,672,74,187,286,125,614,58
71654,2111,1499,340,675,350,134,384,559,310,246,612,89,146,257,120,571,41
71655,6030,4108,1077,1792,1042,197,1435,1630,558,485,1922,509,586,484,343,1580,342
71656,0,0,0,0,0,0,0,0,0,0,0,0,0,0,0,0,0
71658,349,258,78,114,62,4,97,91,37,33,91,16,34,13,28,86,5
71659,9,9,0,0,9,0,0,9,0,0,0,0,0,0,0,0,0
71660,397,313,51,139,104,19,100,177,17,19,84,9,26,30,19,75,9
71661,213,154,42,50,41,21,25,62,44,23,59,6,9,9,35,58,1
71663,354,263,63,104,79,17,96,116,19,32,91,6,27,29,29,77,14
71665,2199,1697,399,723,463,112,633,747,201,116,502,89,151,139,123,470,32
71666,29,19,4,9,6,0,5,9,3,2,10,0,0,10,0,10,0
71667,3005,2222,496,968,603,155,773,1013,260,176,783,112,229,236,206,691,92
71670,590,435,64,211,120,40,119,199,75,42,155,17,38,63,37,138,17
71671,3645,2556,515,1090,713,238,687,1202,391,276,1089,163,304,286,336,1032,57
71674,392,286,55,111,96,24,101,129,27,29,106,13,27,37,29,95,11
71675,774,558,122,246,164,26,199,254,65,40,216,49,55,69,43,188,28
71676,386,244,49,117,70,8,45,94,63,42,142,17,28,58,39,137,5
71677,78,49,11,28,9,1,15,16,11,7,29,2,10,9,8,29,0
71701,8973,6259,1327,2831,1599,502,1918,2664,1067,610,2714,365,762,832,755,2512,202
71720,1150,785,176,293,265,51,255,329,83,118,365,58,88,143,76,339,26
71722,52,34,2,23,6,3,13,12,0,9,18,0,6,5,7,15,3
71724,175,113,16,47,39,11,18,55,28,12,62,7,21,26,8,56,6
71725,231,146,32,69,43,2,45,49,23,29,85,1,28,31,25,85,0
71726,636,427,36,195,156,40,99,241,39,48,209,8,43,89,69,196,13
71730,13954,9921,2207,4306,2539,869,3137,3966,1580,1238,4033,676,1293,1109,955,3739,294
71740,676,483,108,211,138,26,171,200,53,59,193,20,40,61,72,172,21
71742,2483,1775,324,785,515,151,530,802,259,184,708,120,227,195,166,660,48
71743,1772,1210,286,453,358,113,356,546,184,124,562,60,142,192,168,515,47
71744,1461,1020,247,422,255,96,383,393,124,120,441,47,105,104,185,413,28
71745,118,89,16,42,22,9,27,35,13,14,29,2,9,4,14,24,5
71747,536,380,87,161,111,21,115,165,51,49,156,25,45,45,41,140,16
71749,1184,874,177,383,253,61,281,418,87,88,310,65,67,85,93,278,32
71751,393,275,30,122,96,27,91,157,21,6,118,7,55,36,20,100,18
71752,457,317,73,158,60,26,98,126,50,43,140,25,32,43,40,128,12
71753,6715,4417,1072,1789,1263,293,1373,1851,665,528,2298,488,540,663,607,2094,204
71758,220,153,20,77,43,13,53,74,10,16,67,2,13,32,20,62,5
71759,106,85,14,43,20,8,34,33,14,4,21,2,6,9,4,17,4
71762,1101,786,152,323,230,81,240,347,89,110,315,35,67,117,96,297,18
71763,728,513,57,256,150,50,137,271,45,60,215,23,41,68,83,204,11
71764,916,668,125,286,197,60,217,285,82,84,248,32,54,57,105,223,25
71765,945,636,109,281,180,66,156,285,99,96,309,25,105,86,93,293,16
71766,338,236,50,94,87,5,102,85,23,26,102,6,35,39,22,87,15
71770,1458,1022,231,399,298,94,247,456,172,147,436,70,107,146,113,380,56
71801,6538,4617,1220,1889,1142,366,1423,1884,797,513,1921,271,636,556,458,1710,211
71820,10,10,0,4,6,0,0,10,0,0,0,0,0,0,0,0,0
71822,3580,2582,636,1062,733,151,785,1171,389,237,998,66,356,362,214,911,87
71823,47,43,7,18,10,8,20,23,0,0,4,0,0,2,2,4,0
71825,220,175,31,88,46,10,75,68,8,24,45,6,13,7,19,39,6
71826,569,373,69,138,110,56,104,156,42,71,196,20,69,59,48,188,8
71827,227,183,30,95,41,17,53,92,20,18,44,13,13,14,4,44,0
71832,3330,2478,744,986,582,166,953,1045,348,132,852,147,245,233,227,737,115
71833,946,728,149,323,167,89,267,361,35,65,218,38,54,55,71,177,41
71834,606,438,75,148,166,49,114,231,32,61,168,27,46,39,56,162,6
71835,540,388,93,149,111,35,126,171,61,30,152,24,44,41,43,133,19
71836,1372,983,224,417,267,75,353,444,115,71,389,43,90,152,104,367,22
71837,1562,1251,397,565,255,34,572,490,104,85,311,34,64,142,71,284,27
71838,582,407,82,184,103,38,138,133,55,81,175,5,73,48,49,161,14
71839,161,111,14,58,34,5,23,53,22,13,50,1,20,20,9,48,2
71841,421,296,65,121,89,21,118,132,21,25,125,15,53,43,14,111,14
71842,869,674,143,314,172,45,249,293,81,51,195,31,43,77,44,182,13
71845,1018,717,113,319,208,77,225,304,82,106,301,28,102,69,102,281,20
71846,1068,775,184,331,204,56,274,372,78,51,293,29,69,126,69,263,30
71847,251,196,36,75,70,15,87,74,12,23,55,2,21,24,8,44,11
71851,986,698,143,281,202,72,214,259,117,108,288,32,96,94,66,272,16
71852,3825,2787,679,1290,620,198,1042,1167,369,209,1038,178,303,323,234,949,89
71853,204,134,28,50,46,10,48,52,14,20,70,5,44,3,18,67,3
71854,13362,9388,2529,4036,2268,555,2809,3871,1658,1050,3974,741,1140,1180,913,3514,460
71855,335,247,48,118,66,15,73,98,35,41,88,27,25,30,6,82,6
71857,2496,1772,448,746,476,102,535,816,248,173,724,29,154,235,306,703,21
71858,1031,729,137,331,194,67,234,328,81,86,302,42,71,105,84,273,29
71859,163,107,20,52,26,9,30,58,14,5,56,8,21,15,12,47,9
71860,1297,864,203,334,258,69,211,375,148,130,433,58,99,181,95,392,41
71861,865,652,105,274,222,51,177,406,27,42,213,20,47,86,60,210,3
71862,341,218,39,82,79,18,56,96,25,41,123,12,32,46,33,107,16
71865,47,36,9,10,14,3,5,19,6,6,11,0,3,4,4,11,0
71866,269,183,53,68,56,6,70,82,21,10,86,21,23,13,29,83,3
71901,11941,7582,1644,3429,1930,579,2333,3138,1242,869,4359,589,1416,1327,1027,3853,506
71909,6325,4959,186,712,2925,1136,446,4253,121,139,1366,52,142,632,540,1283,83
71913,16760,10765,2022,4095,3529,1119,2723,5907,1180,955,5995,866,1661,1870,1598,5152,843
71921,1298,978,239,372,297,70,361,456,81,80,320,42,66,110,102,280,40
71922,154,111,19,48,37,7,42,51,11,7,43,3,10,17,13,43,0
71923,6280,4088,967,1774,1043,304,1347,1810,574,357,2192,848,353,445,546,1717,475
71929,1563,1215,197,541,387,90,412,634,101,68,348,49,77,131,91,304,44
71933,611,448,90,202,109,47,176,234,3,35,163,23,47,63,30,158,5
71935,396,282,78,91,102,11,104,130,23,25,114,31,34,20,29,100,14
71937,819,590,140,250,164,36,225,277,50,38,229,18,65,89,57,205,24
71940,736,540,104,220,162,54,210,274,26,30,196,34,49,56,57,183,13
71941,748,585,134,247,158,46,216,289,36,44,163,42,21,52,48,151,12
71943,1530,1070,252,457,278,83,390,495,124,61,460,43,130,166,121,419,41
71944,306,241,62,103,66,10,102,96,21,22,65,18,17,21,9,59,6
71945,640,476,108,189,141,38,172,247,32,25,164,11,45,64,44,153,11
71949,253,202,25,112,52,13,92,98,12,0,51,0,6,34,11,36,15
71950,264,202,37,75,69,21,60,116,14,12,62,6,11,29,16,59,3
71952,65,57,11,9,31,6,16,34,0,7,8,0,0,5,3,8,0
71953,5854,4185,860,1583,1360,382,1461,2052,362,310,1669,185,400,643,441,1500,169
71956,1190,888,175,427,254,32,299,390,95,104,302,31,96,137,38,280,22
71957,1317,922,133,350,348,91,237,523,91,71,395,24,116,141,114,350,45
71958,1056,695,111,312,215,57,193,367,88,47,361,15,87,127,132,338,23
71959,346,261,65,100,76,20,130,122,9,0,85,15,32,20,18,75,10
71960,714,527,121,202,162,42,171,267,51,38,187,12,54,80,41,170,17
71961,335,254,49,109,79,17,100,139,9,6,81,7,17,32,25,71,10
71962,382,285,47,105,119,14,85,149,18,33,97,27,8,36,26,90,7
71964,1483,1240,221,637,338,44,432,566,140,102,243,38,102,69,34,196,47
71965,118,88,11,34,34,9,28,49,7,4,30,0,11,7,12,30,0
71968,1552,1217,251,570,333,63,488,601,93,35,335,36,124,74,101,305,30
71969,150,109,28,54,25,2,37,62,3,7,41,2,21,13,5,37,4
71970,320,237,29,94,59,55,40,164,4,29,83,0,17,48,18,83,0
71971,138,114,19,61,27,7,46,59,2,7,24,2,4,9,9,24,0
71972,81,62,18,20,19,5,31,20,4,7,19,3,4,8,4,19,0
71973,450,340,112,125,81,22,139,133,40,28,110,21,32,35,22,97,13
72001,214,171,32,52,69,18,52,99,10,10,43,5,14,16,8,39,4
72002,4965,3747,957,1749,894,147,1425,1712,422,188,1218,223,471,397,127,1008,210
72003,343,265,59,152,46,8,93,134,16,22,78,8,17,31,22,67,11
72004,574,434,81,207,90,56,124,164,77,69,140,3,26,52,59,133,7
72005,63,40,9,22,7,2,0,16,9,15,23,0,11,4,8,23,0
72006,1306,914,195,438,235,46,210,354,204,146,392,29,96,147,120,367,25
72007,1766,1454,339,727,347,41,604,605,101,144,312,53,141,103,15,254,58
72010,2448,1825,440,834,475,76,645,849,211,120,623,70,157,180,216,562,61
72011,1027,843,219,430,182,12,392,306,65,80,184,15,112,41,16,143,41
72012,3413,2617,590,1237,627,163,1023,1176,236,182,796,128,234,244,190,722,74
72013,652,525,98,241,147,39,188,262,41,34,127,43,26,48,10,107,20
72014,36,21,12,4,5,0,14,7,0,0,15,0,2,10,3,7,8
72015,15096,11293,2597,5343,2785,568,4255,5106,1149,783,3803,687,1032,1229,855,3289,514
72016,1058,838,170,467,167,34,329,385,82,42,220,54,63,78,25,164,56
72017,356,252,39,111,78,24,59,135,36,22,104,18,31,35,20,95,9
72020,1780,1315,333,595,311,76,460,659,108,88,465,26,109,207,123,413,52
72021,2153,1453,291,621,432,109,426,617,217,193,700,72,213,271,144,647,53
72022,2942,2354,562,1261,459,72,989,953,265,147,588,112,168,209,99,537,51
72023,8983,7214,1762,3729,1435,288,3275,2946,708,285,1769,396,648,516,209,1476,293
72024,1530,1098,212,545,245,96,450,476,115,57,432,32,111,196,93,402,30
72025,363,286,66,114,80,26,98,154,13,21,77,7,13,28,29,73,4
72026,150,125,16,63,46,0,26,69,11,19,25,0,11,7,7,18,7
72027,526,390,62,145,141,42,121,221,25,23,136,14,40,48,34,126,10
72029,911,605,131,279,146,49,153,244,111,97,306,15,63,140,88,289,17
72030,272,209,18,88,85,18,52,107,17,33,63,6,18,20,19,61,2
72031,2967,2053,353,821,664,215,625,1089,206,133,914,100,241,326,247,822,92
72032,21953,14905,4314,7061,2902,628,5691,5982,2014,1218,7048,3137,1710,1237,964,5244,1804
72036,512,348,64,133,98,53,76,124,69,79,164,12,42,62,48,148,16
72038,15,15,5,10,0,0,10,5,0,0,0,0,0,0,0,0,0
72039,718,511,132,192,133,54,155,274,49,33,207,28,39,73,67,197,10
72040,1262,876,207,349,269,51,262,397,110,107,386,33,121,127,105,354,32
72041,683,464,118,195,119,32,181,176,63,44,219,27,58,58,76,196,23
72042,2273,1655,369,719,435,132,538,757,229,131,618,105,149,181,183,524,94
72043,75,55,28,16,4,7,7,8,29,11,20,1,7,9,3,17,3
72044,362,267,8,78,149,32,50,179,17,21,95,2,26,57,10,93,2
72045,447,367,86,127,124,30,149,188,22,8,80,8,18,41,13,80,0
72046,1946,1414,309,626,371,108,390,576,228,220,532,27,179,193,133,501,31
72047,374,282,68,140,48,26,118,129,19,16,92,13,30,24,25,90,2
72048,66,38,3,16,19,0,19,14,0,5,28,0,6,16,6,28,0
72051,316,241,36,107,83,15,85,133,11,12,75,4,21,30,20,72,3
72053,96,56,35,8,9,4,11,8,24,13,40,0,40,0,0,31,9
72055,450,312,49,163,77,23,95,154,31,32,138,19,24,48,47,125,13
72057,370,284,65,125,73,21,89,148,19,28,86,29,32,7,18,68,18
72058,4353,3492,832,1711,749,200,1444,1500,363,185,861,198,332,206,125,757,104
72060,322,248,41,68,111,28,95,134,0,19,74,3,20,27,24,66,8
72061,42,36,6,17,8,5,17,14,3,2,6,0,4,0,2,6,0
72063,560,416,110,134,133,39,138,215,36,27,144,16,35,61,32,132,12
72064,1046,775,111,357,221,86,239,375,70,91,271,44,67,81,79,245,26
72065,1726,1373,256,703,365,49,429,725,136,83,353,75,121,128,29,291,62
72067,1144,824,133,338,269,84,281,468,41,34,320,20,75,139,86,289,31
72068,118,85,22,31,28,4,27,49,8,1,33,8,14,11,0,23,10
72069,770,506,84,196,148,78,97,213,99,97,264,13,46,144,61,224,40
72070,686,459,109,142,170,38,121,257,49,32,227,59,62,58,48,199,28
72072,242,163,35,89,26,13,66,62,15,20,79,9,5,33,32,76,3
72073,578,393,83,182,98,30,130,177,46,40,185,27,57,67,34,165,20
72074,107,76,22,26,17,11,5,56,11,4,31,0,4,27,0,26,5
72075,115,72,12,32,26,2,15,40,7,10,43,9,14,18,2,32,11
72076,14732,10910,3576,4874,2177,283,4064,4195,1844,807,3822,865,1450,1034,473,3253,569
72079,139,121,24,64,33,0,40,71,0,10,18,0,4,14,0,18,0
72080,69,47,3,24,16,4,8,33,6,0,22,0,8,12,2,18,4
72081,2788,2133,488,949,557,139,751,1021,191,170,655,97,147,245,166,589,66
72082,803,528,146,230,106,46,138,215,115,60,275,45,77,92,61,251,24
72083,103,83,18,33,26,6,19,48,10,6,20,6,6,3,5,18,2
72084,479,364,96,132,119,17,148,163,23,30,115,22,34,23,36,96,19
72085,47,38,9,10,17,2,15,11,1,11,9,0,0,4,5,7,2
72086,3673,2799,595,1371,710,123,1057,1223,284,235,874,174,169,332,199,763,111
72087,546,419,86,195,124,14,132,245,22,20,127,57,32,15,23,109,18
72088,1269,830,51,149,449,181,100,652,29,49,439,27,31,196,185,408,31
72099,114,57,7,45,5,0,25,32,0,0,57,32,18,7,0,57,0
72101,1500,1036,214,488,248,86,414,403,95,124,464,40,138,154,132,413,51
72102,901,675,145,321,160,49,250,331,56,38,226,36,56,72,62,191,35
72103,4334,3328,854,1633,645,196,1251,1425,384,268,1006,210,458,266,72,809,197
72104,8597,6279,1499,2649,1654,477,2063,3015,717,484,2318,294,654,754,616,2129,189
72105,23,19,0,11,8,0,3,16,0,0,4,0,4,0,0,4,0
72106,1696,1242,227,615,293,107,392,619,135,96,454,56,142,162,94,404,50
72107,136,101,10,47,29,15,34,23,10,34,35,2,7,9,17,33,2
72108,50,35,4,18,7,6,13,12,4,6,15,0,0,8,7,9,6
72110,4259,2957,645,1254,796,262,896,1414,438,209,1302,197,308,475,322,1213,89
72111,438,316,72,142,91,11,99,156,30,31,122,11,39,43,29,119,3
72112,3973,2682,509,1130,794,249,749,1254,353,326,1291,129,361,459,342,1194,97
72113,4866,3669,795,2132,674,68,1495,1642,352,180,1197,224,384,414,175,993,204
72114,5786,3331,1179,1404,492,256,523,731,1414,663,2455,348,802,761,544,2194,261
72116,9390,5888,967,2645,1615,661,1703,3304,510,371,3502,874,1171,774,683,3039,463
72117,4708,3303,653,1554,845,251,815,1230,644,614,1405,216,480,451,258,1229,176
72118,9228,6222,1621,2838,1404,359,1891,2640,1019,672,3006,619,1150,762,475,2613,393
72120,10982,8021,1836,3924,1915,346,2843,3665,863,650,2961,812,1090,682,377,2474,487
72121,983,744,172,310,218,44,249,386,75,34,239,13,63,104,59,217,22
72122,360,281,52,140,78,11,96,141,20,24,79,3,22,37,17,67,12
72123,233,159,24,63,38,34,42,82,11,24,74,0,20,27,27,72,2
72125,656,524,123,247,128,26,187,234,53,50,132,15,41,50,26,112,20
72126,1391,1017,163,464,312,78,339,519,90,69,374,50,79,132,113,352,22
72127,785,576,98,319,138,21,204,238,59,75,209,45,62,55,47,184,25
72128,274,212,73,83,46,10,90,85,22,15,62,9,10,19,24,53,9
72129,502,396,84,176,120,16,143,186,27,40,106,17,22,32,35,104,2
72130,188,144,39,57,40,8,43,75,26,0,44,0,0,17,27,44,0
72131,1604,1205,262,446,383,114,411,617,87,90,399,60,106,136,97,339,60
72132,1116,868,211,468,158,31,374,368,84,42,248,50,87,73,38,219,29
72133,10,10,0,0,10,0,0,10,0,0,0,0,0,0,0,0,0
72134,165,119,22,48,39,10,31,77,3,8,46,4,13,14,15,43,3
72135,1039,798,141,435,187,35,272,420,32,74,241,16,119,79,27,211,30
72136,626,481,113,215,147,6,170,216,47,48,145,45,43,42,15,129,16
72137,766,596,109,286,165,36,197,317,58,24,170,40,67,42,21,123,47
72139,93,47,17,20,10,0,13,17,12,5,46,6,18,14,8,44,2
72140,137,101,14,35,42,10,18,55,10,18,36,6,6,5,19,31,5
72141,218,154,19,70,53,12,47,72,19,16,64,6,29,10,19,54,10
72142,733,578,107,299,153,19,193,284,34,67,155,15,55,56,29,115,40
72143,10912,7838,1876,3473,1901,588,2720,3754,801,563,3074,707,736,850,781,2690,384
72150,4116,3132,653,1448,864,167,1242,1527,202,161,984,192,335,268,189,879,105
72152,289,196,22,61,81,32,45,103,21,27,93,0,11,43,39,82,11
72153,940,708,138,265,256,49,215,345,72,76,232,29,60,94,49,192,40
72156,211,162,37,64,40,21,64,63,10,25,49,13,20,11,5,46,3
72157,505,365,58,178,115,14,133,188,20,24,140,22,35,52,31,113,27
72160,4674,3281,722,1466,839,254,932,1426,589,334,1393,297,371,408,317,1308,85
72165,62,42,5,15,10,12,6,32,0,4,20,0,5,5,10,15,5
72166,129,98,14,43,41,0,26,70,0,2,31,0,12,6,13,23,8
72167,675,547,94,304,112,37,229,223,40,55,128,19,55,32,22,111,17
72168,153,113,14,68,16,15,47,35,0,31,40,6,0,26,8,40,0
72169,85,63,24,23,10,6,24,28,4,7,22,2,10,5,5,19,3
72170,85,64,7,30,17,10,19,25,3,17,21,0,3,11,7,20,1
72173,2183,1834,467,926,357,84,873,649,211,101,349,70,124,81,74,305,44
72175,181,118,8,47,50,13,9,76,8,25,63,5,6,35,17,63,0
72176,1838,1465,407,703,298,57,672,519,188,86,373,86,131,97,59,298,75
72179,188,146,21,72,42,11,58,71,12,5,42,2,11,21,8,38,4
72180,44,44,14,5,20,5,12,25,7,0,0,0,0,0,0,0,0
72181,8,8,0,0,8,0,0,0,0,8,0,0,0,0,0,0,0
72183,0,0,0,0,0,0,0,0,0,0,0,0,0,0,0,0,0
72201,275,38,15,23,0,0,5,10,5,18,237,72,123,12,30,205,32
72202,6360,2624,671,1111,640,202,492,855,660,617,3736,1223,1176,831,506,3348,388
72204,11929,7982,2023,3972,1507,480,1913,2598,1964,1507,3947,908,1604,860,575,3354,593
72205,11637,5765,1433,2528,1128,676,1520,2702,912,631,5872,1946,1987,1008,931,4970,902
72206,10177,6948,1541,3039,1865,503,1757,2834,1251,1106,3229,469,1210,1070,480,2837,392
72207,4816,2679,605,1195,617,262,812,1263,370,234,2137,618,706,441,372,1823,314
72209,14037,9749,3421,4354,1527,447,2791,3092,2781,1085,4288,1306,1604,907,471,3661,627
72210,2531,1847,281,998,480,88,608,927,187,125,684,86,311,192,95,576,108
72211,7383,4044,1466,1904,539,135,1545,1734,439,326,3339,1493,1160,413,273,2783,556
72212,4029,2955,356,1642,792,165,1167,1513,205,70,1074,439,275,247,113,917,157
72223,6291,4596,849,2727,818,202,2156,1892,372,176,1695,506,613,305,271,1521,174
72227,5710,3389,683,1408,1028,270,1010,1839,334,206,2321,687,692,537,405,1996,325
72301,10008,7173,2129,3048,1603,393,1844,2336,1848,1145,2835,485,1045,797,508,2469,366
72311,67,48,13,19,9,7,15,24,8,1,19,0,4,7,8,17,2
72315,10259,7334,1991,3257,1640,446,2289,2671,1394,980,2925,417,1014,872,622,2584,341
72320,77,64,7,48,0,9,29,31,4,0,13,5,8,0,0,8,5
72321,66,52,3,29,18,2,12,36,1,3,14,0,11,3,0,14,0
72322,71,59,9,36,14,0,32,14,10,3,12,3,5,0,4,9,3
72324,911,694,165,272,194,63,228,327,68,71,217,40,75,41,61,200,17
72326,813,598,136,237,197,28,203,268,64,63,215,36,70,71,38,193,22
72327,750,558,72,291,168,27,135,239,80,104,192,8,77,72,35,150,42
72328,19,15,1,10,4,0,0,0,7,8,4,0,0,4,0,2,2
72329,33,20,7,13,0,0,13,0,0,7,13,0,6,0,7,13,0
72330,291,240,67,110,51,12,112,83,32,13,51,5,13,24,9,46,5
72331,1449,1005,214,428,298,65,218,334,230,223,444,43,168,100,133,395,49
72332,59,49,15,17,14,3,13,16,15,5,10,4,0,2,4,10,0
72333,396,276,58,128,66,24,79,92,54,51,120,30,16,37,37,115,5
72335,6395,4614,1272,2028,1033,281,1258,1490,1134,732,1781,318,588,487,388,1642,139
72338,17,17,0,8,9,0,8,9,0,0,0,0,0,0,0,0,0
72339,115,87,23,47,10,7,34,19,15,19,28,3,10,8,7,28,0
72340,27,21,7,4,10,0,14,5,2,0,6,5,0,1,0,6,0
72341,113,77,7,19,49,2,7,47,18,5,36,1,13,14,8,34,2
72342,2643,1826,435,763,484,144,337,610,566,313,817,102,217,248,250,761,56
72346,366,267,69,115,73,10,114,109,21,23,99,7,42,31,19,79,20
72347,359,286,52,117,87,30,96,155,17,18,73,3,29,21,20,66,7
72348,1262,917,197,428,249,43,284,353,144,136,345,52,106,115,72,297,48
72350,538,364,83,138,108,35,114,145,58,47,174,21,41,61,51,156,18
72351,326,245,53,105,73,14,85,121,22,17,81,9,13,34,25,69,12
72353,37,31,3,23,3,2,8,16,3,4,6,2,0,0,4,6,0
72354,1050,757,214,307,179,57,223,283,171,80,293,37,74,112,70,271,22
72355,1143,857,110,421,278,48,283,324,124,126,286,32,86,93,75,275,11
72358,631,472,115,194,130,33,140,149,99,84,159,15,37,66,41,153,6
72359,252,153,30,75,45,3,18,47,48,40,99,14,28,31,26,81,18
72360,3067,2187,536,960,472,219,433,851,567,336,880,43,224,372,241,832,48
72364,4515,3416,959,1852,538,67,1439,1234,520,223,1099,362,354,291,92,961,138
72365,1391,917,152,366,335,64,207,428,165,117,474,60,131,149,134,425,49
72366,1163,803,140,375,234,54,208,315,188,92,360,15,76,164,105,340,20
72367,75,54,5,27,18,4,15,18,11,10,21,7,7,5,2,16,5
72368,582,401,89,135,137,40,103,191,53,54,181,21,23,84,53,176,5
72369,32,18,2,2,0,14,4,0,0,14,14,0,3,10,1,14,0
72370,3596,2634,819,1111,572,132,782,787,637,428,962,177,378,259,148,846,116
72372,911,692,103,299,213,77,227,303,69,93,219,30,62,70,57,201,18
72373,742,506,97,225,130,54,141,176,86,103,236,40,44,80,72,209,27
72374,340,254,45,104,89,16,55,121,39,39,86,9,17,27,33,81,5
72376,709,516,81,280,98,57,177,190,83,66,193,48,55,46,44,159,34
72377,36,31,0,17,14,0,12,11,0,8,5,0,0,0,5,5,0
72379,44,34,6,13,13,2,5,11,8,10,10,0,4,2,4,8,2
72383,43,27,0,6,12,9,0,9,6,12,16,0,0,0,16,16,0
72384,446,340,48,139,105,48,84,106,60,90,106,14,32,39,21,94,12
72386,816,628,195,283,119,31,257,217,86,68,188,18,42,83,45,172,16
72387,15,9,0,9,0,0,0,9,0,0,6,0,0,0,6,6,0
72389,138,97,27,33,31,6,28,39,20,10,41,3,18,11,9,38,3
72390,3876,2700,718,1184,651,147,634,868,824,374,1176,117,387,419,253,1067,109
72392,219,157,33,67,45,12,37,80,19,21,62,7,21,12,22,57,5
72394,287,202,51,76,50,25,41,63,42,56,85,5,20,45,15,71,14
72395,445,342,56,177,85,24,104,134,44,60,103,6,29,36,32,97,6
72396,5355,4004,1023,1890,880,211,1418,1632,619,335,1351,146,346,537,322,1246,105
72401,19085,12393,3600,5149,2912,732,4007,5193,1768,1425,6692,2289,1871,1470,1062,5380,1312
72404,6280,4691,1201,2400,945,145,1999,1890,378,424,1589,758,420,285,126,1186,403
72410,243,179,34,48,88,9,44,112,3,20,64,6,18,16,24,58,6
72411,897,705,176,298,167,64,245,312,95,53,192,20,46,71,55,181,11
72412,248,185,20,104,44,17,68,101,6,10,63,13,3,20,27,60,3
72413,225,163,39,66,42,16,48,87,15,13,62,4,15,13,30,55,7
72414,160,108,28,57,13,10,44,51,13,0,52,5,8,14,25,46,6
72415,661,507,83,230,171,23,168,249,51,39,154,36,26,45,47,134,20
72416,1978,1500,428,686,338,48,546,657,198,99,478,109,151,148,70,432,46
72417,992,776,222,302,198,54,286,359,79,52,216,43,59,58,56,183,33
72419,743,546,136,239,134,37,192,225,71,58,197,17,64,62,54,183,14
72421,238,167,62,33,57,15,40,80,22,25,71,10,17,22,22,63,8
72422,2294,1553,323,640,462,128,489,790,160,114,741,108,188,229,216,651,90
72424,42,20,3,5,10,2,4,14,1,1,22,2,11,3,6,22,0
72425,201,148,32,67,36,13,50,65,16,17,53,5,22,12,14,53,0
72426,84,52,14,14,15,9,12,26,4,10,32,4,14,4,10,32,0
72427,83,48,10,18,18,2,17,20,6,5,35,2,6,17,10,32,3
72428,51,32,7,11,11,3,8,20,0,4,19,6,8,2,3,11,8
72429,193,138,32,55,42,9,40,71,15,12,55,11,21,11,12,53,2
72430,179,130,23,63,32,12,48,71,2,9,49,12,12,5,20,49,0
72431,196,140,38,54,40,8,49,72,9,10,56,13,5,3,35,52,4
72432,2481,1853,481,793,443,136,583,894,219,157,628,84,129,288,127,550,78
72433,1414,1032,225,467,270,70,379,406,153,94,382,37,89,160,96,335,47
72434,775,566,137,194,199,36,182,314,52,18,209,26,38,91,54,194,15
72435,256,163,33,58,62,10,54,93,8,8,93,8,19,33,33,87,6
72436,396,319,62,147,97,13,99,180,12,28,77,0,43,28,6,71,6
72437,1240,964,240,383,286,55,337,434,130,63,276,28,64,90,94,232,44
72438,1002,721,155,317,208,41,273,334,58,56,281,14,60,103,104,263,18
72440,57,45,6,24,13,2,13,24,6,2,12,3,0,3,6,10,2
72441,59,43,6,10,26,1,9,27,2,5,16,0,14,2,0,8,8
72442,1806,1322,328,575,338,81,514,606,116,86,484,54,151,180,99,463,21
72443,1106,824,197,331,229,67,258,423,90,53,282,43,79,96,64,244,38
72444,875,650,137,248,223,42,192,349,63,46,225,20,41,128,36,196,29
72445,0,0,0,0,0,0,0,0,0,0,0,0,0,0,0,0,0
72447,863,568,131,207,197,33,187,300,34,47,295,51,54,85,105,282,13
72449,87,57,11,24,20,2,20,27,3,7,30,4,6,7,13,28,2
72450,12305,8814,2353,3718,2279,464,3063,4124,1004,623,3491,493,855,1213,930,3037,454
72453,114,78,12,28,24,14,29,31,4,14,36,6,0,14,16,30,6
72454,2256,1498,293,569,474,162,511,799,117,71,758,121,112,298,227,669,89
72455,5034,3678,793,1549,1053,283,1128,1812,438,300,1356,121,377,470,388,1271,85
72456,278,213,68,75,62,8,78,103,20,12,65,9,16,18,22,57,8
72457,105,71,14,35,15,7,24,40,1,6,34,0,2,14,18,32,2
72458,210,133,15,53,48,17,40,81,5,7,77,4,20,32,21,62,15
72459,423,304,49,159,77,19,103,160,33,8,119,7,41,38,33,109,10
72460,313,229,25,109,83,12,71,122,15,21,84,9,20,25,30,78,6
72461,1747,1208,239,453,381,135,428,596,109,75,539,61,112,202,164,492,47
72462,195,150,47,72,27,4,67,48,30,5,45,8,12,16,9,42,3
72464,103,63,20,30,9,4,30,26,6,1,40,4,7,19,10,38,2
72466,429,323,59,150,87,27,124,156,23,20,106,8,26,36,36,103,3
72467,41,32,0,26,6,0,18,0,0,14,9,0,9,0,0,9,0
72469,521,401,88,159,120,34,135,224,25,17,120,19,19,43,39,113,7
72470,148,126,27,56,38,5,49,55,9,13,22,0,0,6,16,22,0
72471,474,342,86,127,112,17,118,155,41,28,132,14,26,53,39,119,13
72472,3622,2592,624,1100,666,202,933,1135,265,259,1030,113,251,434,232,906,124
72473,1034,763,113,364,221,65,207,387,80,89,271,16,53,105,97,259,12
72475,40,24,3,10,8,3,6,11,4,3,16,3,11,0,2,14,2
72476,2822,1871,428,776,510,157,613,897,207,154,951,142,217,280,312,866,85
72478,122,61,18,24,13,6,17,28,0,16,61,12,12,28,9,61,0
72479,695,526,87,253,143,43,179,263,48,36,169,20,36,49,64,160,9
72482,699,466,71,185,171,39,114,279,36,37,233,21,38,104,70,205,28
72501,9469,6665,1495,2927,1829,414,2400,3073,595,597,2804,349,873,834,748,2571,233
72512,1149,731,86,133,329,183,94,550,44,43,418,6,56,150,206,390,28
72513,1152,799,123,314,308,54,280,364,93,62,353,15,94,121,123,302,51
72515,43,39,10,12,14,3,11,21,3,4,4,0,0,4,0,4,0
72517,113,86,0,47,35,4,24,60,2,0,27,0,6,13,8,27,0
72519,1086,767,214,288,212,53,293,318,101,55,319,78,71,131,39,287,32
72520,75,67,10,18,31,8,6,36,10,15,8,0,0,8,0,8,0
72521,1853,1436,383,546,382,125,504,685,155,92,417,34,118,182,83,360,57
72522,102,73,19,35,19,0,28,34,7,4,29,5,10,7,7,29,0
72523,479,372,91,156,93,32,138,171,34,29,107,7,34,47,19,104,3
72524,161,120,14,50,46,10,33,66,19,2,41,0,10,24,7,39,2
72525,101,86,0,6,71,9,6,80,0,0,15,0,6,9,0,15,0
72526,38,23,12,11,0,0,5,11,7,0,15,1,6,6,2,11,4
72527,196,129,21,70,38,0,37,69,18,5,67,9,31,7,20,67,0
72528,101,60,21,26,4,9,12,34,3,11,41,0,6,35,0,41,0
72529,2135,1528,212,347,642,327,288,1024,91,125,607,26,121,248,212,559,48
72530,765,582,103,298,165,16,191,308,55,28,183,18,52,80,33,155,28
72531,227,157,32,46,57,22,42,82,8,25,70,12,23,25,10,63,7
72532,512,362,65,174,101,22,115,168,48,31,150,22,38,59,31,135,15
72533,150,120,22,45,49,4,33,76,6,5,30,0,10,16,4,26,4
72534,389,319,40,145,114,20,97,184,23,15,70,6,25,26,13,65,5
72536,248,173,23,74,64,12,63,91,6,13,75,8,22,28,17,72,3
72537,387,249,37,79,109,24,70,164,7,8,138,6,63,40,29,121,17
72538,133,110,15,76,19,0,59,40,7,4,23,4,5,4,10,23,0
72539,95,67,0,40,27,0,20,47,0,0,28,7,11,0,10,28,0
72540,73,43,8,14,19,2,15,24,3,1,30,5,4,9,12,26,4
72542,1472,1080,165,401,422,92,308,606,74,92,392,27,117,158,90,357,35
72543,4954,3471,553,1292,1175,451,952,1996,294,229,1483,226,392,465,400,1350,133
72544,285,187,31,75,77,4,39,137,11,0,98,9,36,30,23,85,13
72550,286,221,33,89,99,0,80,117,0,24,65,9,9,47,0,40,25
72553,28,14,2,0,8,4,2,10,0,2,14,0,2,4,8,14,0
72554,1374,974,174,345,366,89,279,563,61,71,400,41,101,133,125,341,59
72555,71,48,0,15,33,0,6,42,0,0,23,0,14,9,0,17,6
72556,1420,951,231,382,271,67,291,483,111,66,469,83,117,157,112,425,44
72560,3204,2317,380,852,873,212,710,1327,115,165,887,87,293,309,198,828,59
72561,418,328,65,126,121,16,107,185,23,13,90,7,27,33,23,86,4
72562,818,598,139,306,108,45,254,253,58,33,220,31,34,73,82,203,17
72564,132,96,33,32,23,8,35,44,10,7,36,2,10,16,8,36,0
72565,465,356,83,141,100,32,133,183,27,13,109,14,29,33,33,91,18
72566,171,124,31,64,23,6,40,67,16,1,47,15,13,18,1,47,0
72567,101,58,20,0,38,0,29,22,0,7,43,13,9,13,8,43,0
72568,626,446,98,209,119,20,176,208,27,35,180,27,36,64,53,167,13
72569,222,170,20,93,53,4,65,85,14,6,52,2,12,30,8,50,2
72571,192,160,24,68,55,13,51,83,16,10,32,8,0,19,5,29,3
72572,81,66,13,25,28,0,26,38,2,0,15,4,4,4,3,15,0
72573,63,53,12,16,19,6,28,19,0,6,10,0,0,10,0,6,4
72576,1512,1059,213,358,368,120,306,607,86,60,453,47,104,164,138,418,35
72577,283,210,33,107,58,12,62,116,21,11,73,5,11,30,27,69,4
72578,40,31,13,18,0,0,24,0,0,7,9,0,0,9,0,9,0
72579,434,326,78,153,81,14,113,156,31,26,108,14,34,26,34,90,18
72581,453,340,19,153,138,30,68,246,17,9,113,15,0,55,43,103,10
72583,626,453,86,218,134,15,179,249,11,14,173,29,59,60,25,152,21
72584,152,100,8,48,44,0,38,62,0,0,52,4,20,21,7,52,0
72585,67,51,0,24,10,17,7,22,11,11,16,6,0,10,0,10,6
72587,56,56,0,24,21,11,6,41,4,5,0,0,0,0,0,0,0
72601,11374,8138,1912,3357,2208,661,2724,3979,830,605,3236,450,864,1109,813,2953,283
72610,63,45,8,27,10,0,14,29,0,2,18,2,3,10,3,12,6
72611,602,430,85,186,129,30,105,238,56,31,172,16,54,56,46,153,19
72616,3653,2656,519,1202,768,167,934,1248,290,184,997,145,250,280,322,868,129
72617,158,95,13,41,25,16,30,47,2,16,63,5,12,36,10,55,8
72619,991,649,33,183,328,105,70,520,39,20,342,27,48,140,127,323,19
72623,202,137,13,45,79,0,27,86,9,15,65,8,28,17,12,47,18
72624,322,205,46,86,64,9,62,123,13,7,117,0,40,71,6,108,9
72626,579,375,64,117,146,48,70,241,28,36,204,32,62,65,45,180,24
72628,386,281,47,120,85,29,101,147,13,20,105,7,37,32,29,88,17
72629,256,166,22,72,66,6,41,85,17,23,90,5,51,24,10,69,21
72630,168,114,12,25,59,18,17,91,4,2,54,5,18,10,21,49,5
72631,1508,1139,85,354,525,175,142,867,96,34,369,41,150,116,62,313,56
72632,2008,1135,136,516,416,67,307,591,134,103,873,141,364,274,94,721,152
72633,631,502,107,252,108,35,195,254,35,18,129,29,32,39,29,122,7
72634,1826,1320,236,607,382,95,435,708,120,57,506,66,164,170,106,448,58
72635,1280,913,221,339,276,77,254,460,134,65,367,36,114,156,61,315,52
72638,2518,1854,468,823,451,112,687,771,233,163,664,127,260,167,110,545,119
72639,182,152,34,71,32,15,41,99,0,12,30,0,10,12,8,30,0
72640,174,140,49,47,33,11,60,66,6,8,34,0,8,15,11,30,4
72641,1182,778,140,334,247,57,239,393,100,46,404,28,136,146,94,370,34
72642,989,671,35,146,359,131,86,530,20,35,318,20,78,127,93,272,46
72644,762,557,71,204,225,57,137,354,44,22,205,21,39,86,59,178,27
72645,802,514,110,182,174,48,139,277,66,32,288,36,72,115,65,263,25
72648,286,249,53,126,62,8,96,101,14,38,37,2,14,18,3,35,2
72650,1983,1400,204,582,463,151,409,753,128,110,583,44,122,224,193,553,30
72651,419,343,93,96,120,34,153,158,19,13,76,10,25,18,23,68,8
72653,11937,8191,1104,2815,3118,1154,1972,5114,567,538,3746,448,825,1200,1273,3355,391
72655,181,139,36,43,47,13,48,71,13,7,42,0,11,22,9,40,2
72658,620,490,55,191,209,35,140,276,26,48,130,6,27,58,39,120,10
72660,178,119,23,69,21,6,36,46,16,21,59,10,16,23,10,57,2
72661,288,190,0,56,114,20,19,156,5,10,98,10,7,70,11,98,0
72662,996,740,154,278,260,48,250,391,57,42,256,44,81,87,44,222,34
72663,196,142,30,67,26,19,46,79,12,5,54,5,10,24,15,45,9
72666,36,30,0,5,7,18,0,30,0,0,6,0,0,6,0,6,0
72668,96,72,10,17,39,6,23,45,0,4,24,0,4,6,14,20,4
72669,93,63,17,26,20,0,25,26,7,5,30,2,9,8,11,28,2
72672,178,123,22,69,30,2,50,58,9,6,55,8,22,15,10,44,11
72675,590,419,82,186,113,38,118,222,46,33,171,8,65,59,39,155,16
72677,111,76,19,34,17,6,26,21,16,13,35,8,15,4,8,30,5
72679,26,13,3,7,3,0,9,3,0,1,13,0,0,7,6,13,0
72680,284,222,39,87,76,20,71,108,11,32,62,7,19,22,14,62,0
72682,19,10,0,5,5,0,5,5,0,0,9,0,5,4,0,9,0
72683,86,79,18,36,17,8,35,38,2,4,7,0,2,2,3,7,0
72685,488,366,91,157,104,14,137,166,48,15,122,19,20,54,29,111,11
72686,28,19,2,5,8,4,2,15,0,2,9,0,0,3,6,9,0
72687,2635,1947,314,840,677,116,580,1070,196,101,688,66,179,259,184,607,81
72701,13224,7149,1969,3282,1547,351,2478,2946,1028,697,6075,3201,1564,820,490,4455,1620
72703,11221,5985,1662,2758,1184,381,2023,2816,736,410,5236,3059,1199,514,464,3665,1571
72704,5140,3594,1319,1546,615,114,1343,1527,440,284,1546,749,438,225,134,1035,511
72711,10,7,0,4,3,0,3,3,1,0,3,0,0,0,3,3,0
72712,9194,6720,1878,3334,1216,292,2781,2549,922,468,2474,797,786,547,344,2052,422
72714,4417,3198,365,660,1483,690,516,2493,94,95,1219,123,193,429,474,1102,117
72715,3200,2618,151,339,1611,517,232,2326,22,38,582,41,108,230,203,498,84
72717,296,233,49,116,60,8,95,113,15,10,63,2,17,39,5,58,5
72718,347,279,82,130,50,17,120,121,17,21,68,12,23,22,11,58,10
72719,838,702,275,311,99,17,335,259,86,22,136,47,50,28,11,112,24
72721,77,59,3,38,14,4,32,11,3,13,18,0,6,6,6,18,0
72722,919,705,197,315,163,30,314,270,83,38,214,48,55,80,31,186,28
72727,1694,1293,344,614,299,36,501,576,145,71,401,60,152,119,70,335,66
72729,141,103,37,35,20,11,36,53,6,8,38,2,16,10,10,26,12
72730,2198,1686,502,778,302,104,709,686,185,106,512,114,159,157,82,409,103
72732,1632,1249,246,547,421,35,465,684,61,39,383,48,119,123,93,316,67
72734,2447,1918,512,876,434,96,797,761,196,164,529,117,139,150,123,485,44
72736,1895,1405,362,626,330,87,542,600,186,77,490,50,175,130,135,412,78
72738,827,677,150,281,208,38,306,308,26,37,150,29,53,45,23,145,5
72739,237,160,22,83,47,8,34,99,27,0,77,27,25,15,10,62,15
72740,3054,2267,478,1014,573,202,878,1019,249,121,787,115,199,279,194,708,79
72742,216,156,26,71,49,10,60,76,9,11,60,4,21,16,19,56,4
72744,1750,1299,262,591,352,94,460,634,101,104,451,67,129,130,125,400,51
72745,3463,2639,799,1228,537,75,1137,1181,190,131,824,302,267,159,96,679,145
72747,54,50,5,22,15,8,18,19,3,10,4,0,4,0,0,0,4
72749,14,6,0,5,1,0,4,2,0,0,8,0,5,3,0,8,0
72751,1598,1217,256,574,331,56,479,541,131,66,381,46,108,94,133,330,51
72752,162,113,11,49,47,6,40,52,10,11,49,12,11,14,12,47,2
72753,2342,1792,394,856,438,104,691,772,185,144,550,68,137,186,159,477,73
72756,13623,10018,2596,4433,2360,629,3937,4277,1120,684,3605,871,1224,920,590,2943,662
72758,6663,5067,1285,2369,1023,390,2296,2008,449,314,1596,327,438,446,385,1334,262
72760,254,185,38,65,70,12,62,112,6,5,69,0,37,18,14,56,13
72761,5707,4154,1088,1812,1017,237,1650,1802,406,296,1553,349,461,372,371,1326,227
72762,9430,7230,1622,3568,1613,427,3007,3156,631,436,2200,418,646,594,542,1825,375
72764,11347,8308,2635,3560,1708,405,3259,3294,1112,643,3039,671,997,852,519,2557,482
72768,548,402,71,219,86,26,176,137,65,24,146,13,43,53,37,121,25
72769,345,285,58,134,71,22,122,133,12,18,60,18,23,12,7,56,4
72773,356,268,72,76,71,49,84,149,24,11,88,5,16,39,28,88,0
72774,1948,1560,330,788,361,81,552,736,178,94,388,47,162,115,64,328,60
72776,208,159,19,97,30,13,65,85,7,2,49,3,24,17,5,39,10
72801,6542,4008,1206,1619,894,289,1231,1625,651,501,2534,918,580,478,558,2016,518
72802,6798,5327,1166,2584,1336,241,2075,2417,478,357,1471,301,483,432,255,1279,192
72820,91,76,23,32,19,2,37,30,4,5,15,2,0,2,11,13,2
72821,650,445,96,203,113,33,157,200,64,24,205,21,51,78,55,190,15
72823,2448,1854,428,811,499,116,686,892,151,125,594,69,181,208,136,541,53
72824,660,510,75,264,126,45,190,241,36,43,150,12,33,65,40,137,13
72826,39,18,1,7,8,2,5,12,1,0,21,0,5,11,5,15,6
72827,98,75,11,38,21,5,27,30,7,11,23,0,3,4,16,23,0
72828,51,39,7,17,11,4,14,15,5,5,12,0,7,0,5,12,0
72829,29,9,0,9,0,0,0,9,0,0,20,0,11,0,9,20,0
72830,4735,3335,796,1373,873,293,1176,1520,399,240,1400,252,322,441,385,1199,201
72832,427,253,56,95,87,15,68,123,26,36,174,38,41,56,39,146,28
72833,1489,1122,334,457,262,69,389,472,164,97,367,55,87,94,131,338,29
72834,3529,2666,571,1263,687,145,903,1203,315,245,863,101,190,322,250,773,90
72835,381,249,47,101,94,7,80,152,17,0,132,21,12,65,34,126,6
72837,2759,2175,503,945,624,103,766,1033,239,137,584,65,149,237,133,527,57
72838,75,46,7,24,13,2,10,30,2,4,29,2,0,15,12,29,0
72839,69,43,5,19,19,0,19,19,0,5,26,0,9,11,6,26,0
72840,719,571,135,219,177,40,220,254,34,63,148,15,31,43,59,148,0
72841,60,57,6,18,25,8,23,28,0,6,3,2,1,0,0,3,0
72842,552,393,93,133,143,24,129,190,36,38,159,44,11,61,43,119,40
72843,788,629,103,320,172,34,270,283,33,43,159,10,49,51,49,132,27
72845,401,295,54,144,75,22,101,160,18,16,106,20,38,21,27,83,23
72846,1507,1136,289,486,284,77,462,484,99,91,371,50,109,103,109,325,46
72847,941,696,139,287,221,49,256,346,38,56,245,41,77,84,43,210,35
72851,210,161,14,78,50,19,58,94,9,0,49,7,15,27,0,34,15
72852,125,94,23,36,32,3,30,47,10,7,31,2,10,11,8,26,5
72853,882,604,163,260,152,29,211,226,98,69,278,35,73,111,59,254,24
72854,233,169,29,87,39,14,57,83,18,11,64,0,29,28,7,54,10
72855,2648,1834,377,786,496,175,576,859,240,159,814,126,198,260,230,746,68
72856,228,155,19,76,47,13,69,61,7,18,73,3,23,30,17,65,8
72857,584,404,100,172,79,53,119,213,44,28,180,13,22,103,42,168,12
72858,924,747,163,405,154,25,300,351,74,22,177,22,41,72,42,142,35
72860,197,155,47,59,38,11,51,75,14,15,42,0,14,17,11,38,4
72863,601,462,86,234,104,38,205,189,19,49,139,13,17,55,54,126,13
72865,371,299,73,118,100,8,114,151,15,19,72,15,14,20,23,59,13
72901,9230,5176,1470,2344,1039,323,1576,1942,1112,546,4054,975,1379,928,772,3400,654
72903,10037,6459,1381,2918,1649,511,2176,3056,728,499,3578,878,1062,846,792,3079,499
72904,7623,5159,1517,2090,1151,401,1631,1887,971,670,2464,339,816,733,576,2122,342
72908,4768,3550,739,1789,864,158,1311,1562,453,224,1218,279,350,369,220,1099,119
72916,2154,1593,405,750,363,75,556,724,178,135,561,271,187,61,42,450,111
72921,4144,3324,855,1478,838,153,1238,1547,408,131,820,96,271,259,194,726,94
72923,1644,1139,274,516,280,69,398,509,131,101,505,82,222,133,68,463,42
72926,283,221,19,100,95,7,70,128,6,17,62,20,11,21,10,57,5
72927,3211,2397,543,997,696,161,833,1140,248,176,814,74,171,281,288,738,76
72928,243,198,49,52,72,25,49,121,20,8,45,7,13,8,17,43,2
72930,179,157,24,58,52,23,45,87,0,25,22,0,0,22,0,22,0
72932,247,189,60,84,43,2,78,77,22,12,58,5,19,28,6,47,11
72933,1960,1445,338,674,348,85,635,584,117,109,515,76,146,115,178,481,34
72934,278,216,64,87,64,1,90,108,18,0,62,11,20,22,9,54,8
72935,91,64,14,23,16,11,20,28,6,10,27,0,4,12,11,23,4
72936,4477,3658,935,1746,818,159,1577,1455,406,220,819,137,245,317,120,715,104
72937,1239,936,175,454,234,73,320,477,73,66,303,28,83,113,79,263,40
72938,553,439,103,200,121,15,163,190,45,41,114,10,8,33,63,102,12
72940,934,710,197,321,166,26,311,323,52,24,224,10,44,90,80,213,11
72941,1595,1280,256,603,366,55,481,597,107,95,315,43,102,123,47,276,39
72943,1046,815,190,358,205,62,303,373,78,61,231,31,81,74,45,204,27
72944,957,684,156,316,170,42,240,335,76,33,273,29,69,100,75,260,13
72945,86,66,12,31,17,6,24,25,11,6,20,1,1,2,16,19,1
72946,1469,1126,217,513,331,65,446,520,74,86,343,39,112,121,71,299,44
72947,1685,1223,234,559,351,79,385,663,90,85,462,81,152,120,109,388,74
72948,204,147,24,55,62,6,55,69,23,0,57,0,29,6,22,57,0
72949,3921,2797,576,1294,794,133,1011,1323,264,199,1124,97,272,435,320,993,131
72950,190,129,22,28,79,0,34,84,0,11,61,0,4,37,20,61,0
72951,421,314,55,141,89,29,95,153,44,22,107,5,18,68,16,95,12
72952,1025,835,210,430,161,34,353,370,67,45,190,18,64,68,40,170,20
72955,182,147,14,101,32,0,59,69,0,19,35,0,27,8,0,35,0
72956,10805,8237,1966,3971,1847,453,3092,3443,1037,665,2568,355,846,805,562,2198,370
72958,3133,2233,580,908,562,183,845,990,222,176,900,168,227,333,172,800,100
72959,1041,744,144,360,212,28,267,360,55,62,297,44,101,102,50,256,41
73002,478,350,70,149,109,22,136,170,32,12,128,23,21,56,28,111,17
73003,12701,10495,2696,5919,1663,217,5036,3850,1051,558,2206,506,911,575,214,1907,299
73004,294,245,66,103,58,18,111,118,13,3,49,8,19,12,10,47,2
73005,3503,2554,573,1189,649,143,860,954,462,278,949,100,252,303,294,863,86
73006,1449,1056,217,471,282,86,376,440,128,112,393,28,164,136,65,351,42
73007,649,486,91,220,138,37,147,264,25,50,163,37,69,36,21,123,40
73008,8307,5486,1239,2347,1470,430,1717,2643,717,409,2821,620,827,794,580,2496,325
73009,514,377,82,168,97,30,140,168,32,37,137,5,26,64,42,133,4
73010,4356,3541,775,1743,894,129,1498,1553,302,188,815,153,259,285,118,706,109
73011,146,122,19,51,33,19,40,67,10,5,24,4,9,9,2,22,2
73013,11666,8912,1705,4797,2001,409,3686,3843,911,472,2754,716,699,725,614,2287,467
73014,553,425,95,201,108,21,170,198,29,28,128,27,17,49,35,113,15
73015,1230,877,124,396,254,103,261,402,118,96,353,33,81,121,118,334,19
73016,487,392,68,229,73,22,185,144,40,23,95,5,35,31,24,92,3
73017,719,525,87,273,132,33,173,273,41,38,194,19,46,83,46,171,23
73018,7784,5215,1144,2355,1345,371,1670,2240,719,586,2569,476,570,845,678,2292,277
73020,6193,5100,854,2649,1434,163,1775,2485,451,389,1093,106,493,304,190,940,153
73021,173,137,20,74,23,20,62,59,11,5,36,6,16,7,7,29,7
73022,24,17,0,17,0,0,5,2,0,10,7,4,3,0,0,7,0
73024,219,159,22,88,30,19,69,69,19,2,60,8,16,9,27,55,5
73026,3444,2790,246,1657,798,89,926,1501,200,163,654,102,285,192,75,603,51
73027,437,291,53,170,62,6,131,102,40,18,146,31,29,46,40,116,30
73028,1326,948,171,386,302,89,319,461,102,66,378,39,95,142,102,342,36
73029,718,513,112,195,153,53,182,222,60,49,205,30,52,56,67,192,13
73030,1582,1190,256,535,314,85,443,560,112,75,392,16,117,164,95,370,22
73031,36,28,0,11,7,10,6,17,0,5,8,0,6,2,0,8,0
73032,105,51,17,14,18,2,22,23,2,4,54,5,4,28,17,39,15
73033,114,80,13,32,26,9,12,50,6,12,34,1,6,17,10,31,3
73034,11432,8009,1431,4325,1895,358,3268,3538,706,497,3423,1439,885,667,432,2654,769
73036,6318,4340,1008,1873,1147,312,1454,1963,556,367,1978,412,567,543,456,1715,263
73038,863,636,99,250,212,75,200,337,53,46,227,22,64,81,60,216,11
73040,749,513,92,197,170,54,164,238,52,59,236,29,67,90,50,217,19
73041,184,125,9,68,30,18,43,64,7,11,59,7,16,17,19,59,0
73042,435,314,71,133,93,17,102,152,34,26,121,16,19,56,30,106,15
73043,66,46,6,19,14,7,12,25,7,2,20,4,4,6,6,18,2
73044,6976,4873,1003,2353,1214,303,1776,2189,506,402,2103,399,568,654,482,1854,249
73045,3299,2642,562,1322,640,118,1044,1123,331,144,657,85,207,199,166,591,66
73047,1201,862,163,359,260,80,286,414,104,58,339,31,114,106,88,305,34
73048,813,569,101,267,153,48,208,277,47,37,244,29,64,76,75,208,36
73049,1918,1425,266,768,323,68,519,646,160,100,493,99,161,169,64,417,76
73050,209,90,21,41,24,4,14,17,33,26,119,53,20,34,12,96,23
73051,2472,1918,397,899,504,118,752,833,162,171,554,139,156,200,59,452,102
73052,2416,1784,327,767,513,177,635,934,122,93,632,85,79,199,269,597,35
73053,281,217,27,101,66,23,74,111,14,18,64,5,19,24,16,59,5
73054,1369,1096,199,571,287,39,420,503,116,57,273,28,112,92,41,214,59
73055,3750,2788,449,1309,761,269,868,1421,304,195,962,140,212,322,288,873,89
73056,178,127,21,50,47,9,44,75,0,8,51,7,2,18,24,48,3
73057,1033,729,182,277,213,57,221,361,79,68,304,32,105,102,65,270,34
73058,100,75,12,48,13,2,22,31,9,13,25,0,10,12,3,15,10
73059,1039,781,161,371,190,59,310,361,65,45,258,37,57,71,93,234,24
73061,505,364,84,174,84,22,148,146,42,28,141,23,55,41,22,128,13
73062,686,480,82,183,145,70,154,234,33,59,206,11,30,57,108,206,0
73063,263,196,34,83,61,18,62,107,23,4,67,12,15,21,19,64,3
73064,5685,4649,971,2521,1075,82,1920,1944,503,282,1036,151,353,313,219,872,164
73065,1961,1648,260,867,487,34,569,851,161,67,313,17,100,117,79,276,37
73066,105,58,12,19,24,3,15,24,5,14,47,8,25,4,10,42,5
73067,747,567,125,270,138,34,231,266,46,24,180,25,66,52,37,156,24
73068,3824,2957,835,1409,599,114,1189,1170,379,219,867,149,277,302,139,743,124
73069,9986,5022,1444,2107,1074,397,1569,2091,734,628,4964,2284,1257,743,680,3847,1117
73071,11785,6934,2413,3275,981,265,2625,2508,1124,677,4851,2514,1313,674,350,3430,1421
73072,14588,8729,2115,4341,1844,429,3426,3893,788,622,5859,3247,1263,829,520,4038,1821
73073,213,159,39,60,53,7,58,81,8,12,54,11,17,11,15,42,12
73074,433,334,72,141,95,26,112,161,45,16,99,7,32,35,25,90,9
73075,3571,2395,525,1078,605,187,802,1087,270,236,1176,138,286,392,360,1030,146
73077,3031,2106,438,921,610,137,732,1051,187,136,925,168,217,259,281,828,97
73078,1655,1466,281,808,344,33,733,587,93,53,189,16,72,70,31,165,24
73079,226,182,30,78,50,24,67,98,11,6,44,11,10,15,8,40,4
73080,3058,2224,588,934,558,144,787,994,285,158,834,127,246,257,204,754,80
73082,1245,912,162,396,274,80,321,427,82,82,333,29,92,110,102,295,38
73084,2594,1749,321,805,424,199,444,721,277,307,845,75,219,441,110,771,74
73086,3223,2303,395,1029,632,247,792,1127,214,170,920,118,213,338,251,834,86
73089,2909,2423,519,1175,666,63,952,1148,212,111,486,36,178,199,73,418,68
73090,302,217,33,119,57,8,80,102,21,14,85,15,32,22,16,77,8
73092,345,251,58,90,66,37,86,105,32,28,94,16,25,30,23,86,8
73093,703,567,119,305,110,33,265,237,37,28,136,22,43,39,32,123,13
73095,665,511,91,230,153,37,197,222,58,34,154,14,60,30,50,130,24
73096,4769,2803,765,1341,551,146,1061,1188,255,299,1966,1109,314,329,214,1397,569
73097,6,6,0,0,6,0,0,6,0,0,0,0,0,0,0,0,0
73098,1788,1294,227,567,364,136,369,619,195,111,494,50,122,159,163,443,51
73099,15194,12023,2359,6713,2582,369,5021,4948,1401,653,3171,525,1258,944,444,2726,445
73102,702,107,23,61,11,12,18,33,9,47,595,157,199,196,43,534,61
73103,2332,926,295,427,158,46,299,327,201,99,1406,562,536,208,100,1186,220
73104,835,422,208,153,32,29,63,53,256,50,413,77,157,123,56,335,78
73105,2202,1352,203,586,442,121,223,491,310,328,850,172,273,241,164,782,68
73106,4948,2656,833,1287,442,94,893,770,557,436,2292,829,883,392,188,1722,570
73107,10898,5909,1893,2434,1091,491,1833,2226,1022,828,4989,1077,1959,1165,788,4095,894
73108,5152,3463,1399,1463,450,151,1323,915,785,440,1689,332,605,480,272,1460,229
73109,7663,4493,1307,1901,949,336,1291,1622,904,676,3170,481,911,1090,688,2785,385
73110,14716,9185,2797,3732,1917,739,2506,3507,2032,1140,5531,1475,1714,1352,990,4746,785
73111,5070,3119,608,1058,1112,341,431,995,814,879,1951,181,559,810,401,1825,126
73112,15021,7347,2187,2689,1776,695,1810,3455,1173,909,7674,1842,2694,1752,1386,6565,1109
73114,6323,4036,1434,1658,669,275,932,1217,1308,579,2287,745,844,471,227,1981,306
73115,8801,6021,1554,2523,1504,440,1871,2372,981,797,2780,612,883,901,384,2412,368
73116,4873,2631,441,1157,705,328,844,1369,206,212,2242,569,654,599,420,1926,316
73117,2298,1272,293,456,361,162,158,282,412,420,1026,62,324,411,229,962,64
73118,6601,3354,1136,1392,552,274,984,1379,682,309,3247,1056,1251,582,358,2561,686
73119,10940,7188,2445,2953,1324,466,2300,2535,1581,772,3752,639,1228,1112,773,3162,590
73120,17560,9273,2499,3528,2413,833,2485,4869,1133,786,8287,3552,2288,1341,1106,6877,1410
73121,1230,867,94,378,305,90,164,433,140,130,363,15,129,127,92,332,31
73122,5779,3712,895,1593,901,323,1173,1573,582,384,2067,458,641,606,362,1807,260
73127,10172,6533,2209,2727,1241,356,1939,2320,1566,708,3639,894,1345,960,440,3010,629
73128,825,550,150,251,113,36,196,233,65,56,275,66,122,52,35,245,30
73129,7282,4971,1738,1992,984,257,1629,1516,1059,767,2311,567,738,692,314,1942,369
73130,6900,5294,1021,2688,1300,285,1679,2386,757,472,1606,316,550,535,205,1465,141
73131,905,681,78,387,178,38,232,395,40,14,224,11,139,47,27,157,67
73132,10276,6806,1808,3225,1500,273,2395,2708,1174,529,3470,1438,1177,656,199,2812,658
73134,1750,756,258,351,109,38,226,302,141,87,994,478,284,78,154,846,148
73135,5660,4267,1149,2306,739,73,1463,1496,898,410,1393,446,531,333,83,1129,264
73139,7322,4386,1201,1725,1172,288,1147,2076,632,531,2936,1148,921,627,240,2471,465
73141,1065,782,170,350,205,57,223,320,101,138,283,11,134,100,38,244,39
73142,3739,2134,635,1036,369,94,732,899,367,136,1605,871,420,278,36,1325,280
73145,729,723,456,240,27,0,501,127,88,7,6,6,0,0,0,6,0
73149,2127,1376,442,562,301,71,493,504,221,158,751,212,305,183,51,596,155
73150,1753,1374,206,650,450,68,420,789,97,68,379,44,147,153,35,329,50
73151,309,280,19,170,74,17,136,124,13,7,29,3,9,11,6,24,5
73159,11485,7958,1881,3538,2039,500,2467,3608,1136,747,3527,939,1041,973,574,3073,454
73160,14711,11435,3134,5634,2284,383,4639,4302,1582,912,3276,707,1256,965,348,2758,518
73162,10069,7241,1162,4134,1652,293,2918,3176,732,415,2828,715,919,691,503,2432,396
73165,1727,1441,192,741,472,36,523,799,67,52,286,32,78,130,46,247,39
73169,621,484,86,250,132,16,154,262,49,19,137,24,39,66,8,109,28
73170,7830,6509,1212,3835,1286,176,2910,2840,422,337,1321,284,362,436,239,1157,164
73173,166,142,16,77,49,0,60,64,7,11,24,0,7,9,8,24,0
73179,576,418,98,224,96,0,176,181,39,22,158,5,91,46,16,139,19
73401,13129,9143,1813,4251,2345,734,3044,4094,1178,827,3986,521,1306,1206,953,3607,379
73425,51,32,8,12,12,0,12,16,2,2,19,3,4,6,6,17,2
73430,496,405,45,151,163,46,119,250,18,18,91,9,8,49,25,87,4
73432,350,267,65,109,81,12,93,130,25,19,83,5,23,32,23,80,3
73433,1063,764,134,312,240,78,250,412,51,51,299,35,83,91,90,276,23
73434,137,92,7,59,26,0,36,39,9,8,45,7,4,28,6,38,7
73435,98,71,7,38,16,10,21,41,5,4,27,4,5,8,10,27,0
73437,47,36,7,15,12,2,12,22,2,0,11,6,5,0,0,11,0
73438,1398,1013,200,453,260,100,358,475,82,98,385,45,105,115,120,368,17
73439,2635,1892,243,700,800,149,458,1134,166,134,743,73,205,266,199,665,78
73440,158,115,19,34,54,8,23,76,8,8,43,7,6,16,14,43,0
73441,132,100,8,40,37,15,29,48,8,15,32,0,9,16,7,30,2
73442,245,188,20,96,50,22,66,99,10,13,57,9,14,24,10,51,6
73443,1265,985,250,417,262,56,416,403,85,81,280,52,97,77,54,251,29
73444,72,46,23,15,5,3,23,20,0,3,26,0,0,20,6,26,0
73446,2581,1799,405,767,452,175,615,774,221,189,782,77,139,301,265,716,66
73447,439,336,77,149,89,21,127,155,15,39,103,5,33,33,32,91,12
73448,1958,1449,255,666,421,107,471,682,197,99,509,59,109,173,168,441,68
73449,1027,706,120,281,251,54,221,414,19,52,321,50,32,192,47,272,49
73450,421,322,63,133,116,10,113,164,24,21,99,1,38,31,29,91,8
73453,244,188,20,107,45,16,51,96,19,22,56,7,9,17,23,56,0
73455,246,184,32,96,35,21,52,82,19,31,62,2,14,19,27,58,4
73456,846,593,124,252,164,53,213,286,62,32,253,16,59,94,84,244,9
73458,353,292,46,130,88,28,81,172,29,10,61,6,22,15,18,56,5
73459,496,355,58,188,93,16,134,158,32,31,141,26,35,47,33,126,15
73460,1773,1202,239,547,298,118,414,525,170,93,571,97,110,248,116,503,68
73461,292,206,50,80,58,18,74,100,18,14,86,9,30,24,23,72,14
73463,1275,913,179,412,258,64,313,435,102,63,362,40,87,139,96,341,21
73481,362,271,34,134,80,23,85,143,12,31,91,4,17,46,24,89,2
73487,119,68,16,25,18,9,22,16,11,19,51,5,14,22,10,43,8
73488,15,13,0,7,4,2,5,8,0,0,2,0,0,0,2,2,0
73491,419,307,60,150,81,16,123,140,31,13,112,8,29,36,39,105,7
73501,7988,5379,1268,2541,1284,286,1773,2050,904,652,2609,488,923,823,375,2228,381
73503,1436,1398,821,577,0,0,1135,158,105,0,38,26,7,5,0,38,0
73505,17379,12864,3932,5710,2668,554,4986,4694,2171,1013,4515,1303,1437,1148,627,3830,685
73507,7230,4824,1627,2030,871,296,1756,1740,953,375,2406,609,810,634,353,2016,390
73520,64,51,6,18,22,5,21,21,1,8,13,0,0,13,0,13,0
73521,8544,6157,1804,2864,1135,354,2460,2498,854,345,2387,602,601,733,451,2085,302
73526,878,673,159,301,158,55,277,282,69,45,205,24,60,56,65,183,22
73527,1459,1193,239,603,305,46,472,445,175,101,266,47,76,98,45,243,23
73528,228,159,46,72,27,14,63,82,11,3,69,5,15,34,15,67,2
73529,1845,1404,238,636,421,109,442,713,137,112,441,49,126,176,90,404,37
73530,237,159,27,63,50,19,58,76,12,13,78,4,11,31,32,71,7
73531,167,129,29,50,41,9,52,67,6,4,38,4,10,11,13,38,0
73532,246,187,40,78,46,23,74,97,10,6,59,9,21,21,8,50,9
73533,11203,8028,1533,3441,2345,709,2610,4096,770,552,3175,380,720,1052,1023,2984,191
73537,300,195,48,59,62,26,64,91,25,15,105,12,19,36,38,97,8
73538,1363,1103,165,582,300,56,412,561,53,77,260,44,74,75,67,244,16
73539,71,57,16,22,14,5,28,20,7,2,14,6,2,3,3,14,0
73540,163,123,22,58,34,9,44,63,8,8,40,3,17,15,5,36,4
73541,921,738,149,341,204,44,273,365,70,30,183,37,26,59,61,172,11
73542,2124,1452,357,523,451,121,494,669,187,102,672,66,139,193,274,622,50
73543,511,417,90,188,120,19,168,175,52,22,94,12,35,29,18,77,17
73544,105,68,16,33,8,11,29,30,9,0,37,9,6,8,14,37,0
73546,527,374,70,140,123,41,115,190,39,30,153,19,13,70,51,153,0
73547,599,398,65,155,144,34,117,207,44,30,201,23,54,55,69,192,9
73548,282,216,33,59,80,44,44,136,16,20,66,8,20,26,12,60,6
73549,146,122,29,57,33,3,43,57,10,12,24,0,5,8,11,22,2
73550,1083,760,154,325,204,77,255,361,86,58,323,20,91,77,135,305,18
73551,23,17,3,12,2,0,7,5,5,0,6,0,3,3,0,6,0
73552,400,317,51,128,108,30,118,142,27,30,83,10,22,30,21,75,8
73553,23,21,2,12,6,1,8,12,0,1,2,0,0,2,0,2,0
73554,1512,959,159,386,281,133,252,504,136,67,553,70,82,180,221,517,36
73555,93,77,23,32,14,8,32,30,4,11,16,0,4,6,6,16,0
73556,121,91,31,38,18,4,43,35,5,8,30,3,4,12,11,30,0
73557,189,129,31,63,26,9,31,52,26,20,60,7,21,24,8,58,2
73559,229,145,23,69,34,19,43,65,18,19,84,6,18,42,18,71,13
73560,337,268,64,127,62,15,108,96,54,10,69,10,15,22,22,67,2
73561,7,4,0,2,2,0,4,0,0,0,3,0,3,0,0,0,3
73562,332,258,65,108,70,15,99,120,16,23,74,6,27,15,26,67,7
73564,280,180,22,79,59,20,45,113,5,17,100,13,26,37,24,86,14
73565,459,311,59,123,86,43,102,156,35,18,148,20,29,52,47,133,15
73566,712,478,107,211,120,40,134,218,84,42,234,22,58,72,82,219,15
73567,341,245,58,112,64,11,77,107,39,22,96,10,11,41,34,92,4
73568,585,370,84,137,100,49,97,185,56,32,215,32,57,71,55,196,19
73569,229,143,19,58,52,14,47,71,19,6,86,3,23,32,28,77,9
73570,512,353,55,146,112,40,125,158,37,33,159,20,16,67,56,153,6
73571,53,30,0,0,30,0,0,30,0,0,23,0,13,5,5,23,0
73572,1498,1053,214,435,316,88,365,492,122,74,445,55,110,116,164,412,33
73573,1035,706,144,284,211,67,236,389,37,44,329,34,86,109,100,302,27
73601,3831,2658,667,1094,678,219,848,1115,439,256,1173,171,244,398,360,1045,128
73620,362,286,40,162,70,14,92,135,37,22,76,3,21,29,23,73,3
73622,127,87,7,38,27,15,28,49,3,7,40,2,14,7,17,34,6
73624,655,514,140,250,108,16,223,199,72,20,141,23,42,50,26,125,16
73625,220,172,36,65,53,18,56,87,18,11,48,10,11,16,11,42,6
73626,397,290,51,153,61,25,105,135,29,21,107,16,33,32,26,92,15
73627,218,142,30,74,31,7,66,59,10,7,76,13,23,23,17,63,13
73628,680,441,90,170,132,49,155,239,36,11,239,23,48,80,88,220,19
73632,1458,990,227,364,274,125,342,456,129,63,468,56,83,152,177,430,38
73638,37,31,8,17,6,0,15,10,3,3,6,0,0,4,2,6,0
73639,304,206,36,62,82,26,43,145,15,3,98,9,25,37,27,94,4
73641,327,255,50,85,77,43,76,136,23,20,72,4,20,29,19,70,2
73642,78,67,6,24,30,7,19,47,0,1,11,2,5,2,2,11,0
73644,4818,3328,798,1448,838,244,1203,1435,468,222,1490,272,516,375,327,1310,180
73645,623,415,72,176,119,48,136,190,43,46,208,28,37,66,77,192,16
73646,162,105,19,55,26,5,33,63,7,2,57,3,21,23,10,53,4
73647,263,182,13,81,78,10,46,112,9,15,81,8,17,27,29,76,5
73650,338,242,44,128,54,16,99,93,28,22,96,8,20,43,25,94,2
73651,1763,1149,264,432,305,148,353,507,142,147,614,72,137,232,173,562,52
73654,354,263,38,101,93,31,98,148,10,7,91,8,14,30,39,88,3
73655,461,324,51,119,133,21,83,203,31,7,137,22,38,49,28,125,12
73658,105,74,4,34,23,13,16,47,4,7,31,4,2,14,11,29,2
73659,86,72,6,38,26,2,20,50,0,2,14,4,2,8,0,12,2
73660,215,147,8,75,42,22,50,77,3,17,68,13,11,21,23,67,1
73661,190,143,24,85,32,2,63,63,11,6,47,2,9,15,21,43,4
73662,1719,1172,229,491,358,94,373,617,120,62,547,58,142,207,140,511,36
73663,546,363,61,156,91,55,134,176,18,35,183,21,43,59,60,172,11
73664,427,324,65,122,97,40,114,161,30,19,103,3,26,30,44,94,9
73666,49,27,6,9,6,6,6,21,0,0,22,0,0,11,11,22,0
73667,241,170,25,93,36,16,79,77,5,9,71,6,20,23,22,68,3
73668,17,13,0,13,0,0,5,8,0,0,4,0,3,0,1,1,3
73669,615,450,79,221,104,46,167,209,50,24,165,5,33,87,40,157,8
73673,148,99,8,43,22,26,31,60,5,3,49,4,3,26,16,47,2
73701,9369,6051,1725,2551,1387,388,2077,2421,998,555,3318,656,1058,941,663,2808,510
73703,10817,7564,1435,3515,1950,664,2695,3842,683,344,3253,708,840,885,820,2875,378
73716,238,172,25,64,61,22,48,99,9,16,66,2,13,28,23,64,2
73717,2747,1676,321,689,500,166,507,829,192,148,1071,434,224,207,206,898,173
73718,207,163,28,65,58,12,58,79,12,14,44,8,7,12,17,43,1
73719,52,36,3,18,13,2,13,19,4,0,16,0,0,8,8,16,0
73720,112,88,14,21,32,21,12,64,0,12,24,4,0,13,7,20,4
73722,193,152,12,60,65,15,45,93,9,5,41,2,13,14,12,39,2
73724,490,314,42,152,93,27,97,171,29,17,176,6,46,48,76,172,4
73726,264,165,21,71,50,23,70,78,9,8,99,10,14,41,34,99,0
73727,91,67,23,26,14,4,33,26,6,2,24,3,2,10,9,21,3
73728,868,572,97,242,165,68,193,291,48,40,296,37,40,111,108,286,10
73729,239,178,24,78,73,3,63,101,11,3,61,9,6,16,30,55,6
73730,310,218,41,90,62,25,75,93,29,21,92,10,22,25,35,88,4
73731,66,34,2,19,11,2,11,19,2,2,32,14,2,6,10,32,0
73733,86,59,15,26,16,2,33,23,3,0,27,5,4,11,7,27,0
73734,325,275,53,122,77,23,92,146,20,17,50,11,10,22,7,37,13
73735,274,222,63,77,72,10,87,102,22,11,52,11,15,12,14,44,8
73736,154,121,10,55,42,14,30,78,5,8,33,7,7,12,7,31,2
73737,1467,1034,170,495,270,99,385,529,105,15,433,52,107,84,190,409,24
73738,494,340,59,154,80,47,104,177,39,20,154,11,31,56,56,151,3
73739,175,120,25,41,42,12,42,66,8,4,55,2,17,14,22,50,5
73741,267,188,35,80,58,15,57,104,19,8,79,4,14,32,29,74,5
73742,1329,1006,197,487,264,58,390,454,103,59,323,32,64,113,114,307,16
73743,55,45,11,24,4,6,26,19,0,0,10,4,2,1,3,10,0
73744,139,110,23,49,27,11,41,48,16,5,29,7,1,10,11,27,2
73746,30,30,10,14,6,0,10,20,0,0,0,0,0,0,0,0,0
73747,177,119,28,44,28,19,49,62,8,0,58,15,15,15,13,48,10
73749,232,151,19,48,69,15,45,92,3,11,81,6,17,22,36,75,6
73750,2518,1801,314,853,488,146,742,796,147,116,717,109,180,197,231,645,72
73753,177,140,20,65,51,4,38,83,10,9,37,4,8,7,18,37,0
73754,436,340,67,182,79,12,145,136,31,28,96,5,41,37,13,87,9
73755,358,266,57,86,95,28,90,141,16,19,92,12,17,46,17,81,11
73756,112,95,22,42,27,4,33,42,14,6,17,4,4,6,3,15,2
73757,69,52,12,25,14,1,32,20,0,0,17,4,0,8,5,17,0
73758,118,82,8,35,24,15,34,36,2,10,36,0,15,7,14,36,0
73759,716,492,81,213,155,43,188,242,47,15,224,39,38,66,81,218,6
73760,161,122,14,48,43,17,41,77,1,3,39,0,6,8,25,37,2
73761,176,131,29,57,39,6,60,65,1,5,45,2,7,12,24,44,1
73762,783,566,80,298,152,36,217,242,58,49,217,29,74,66,48,206,11
73763,654,446,89,190,121,46,158,217,36,35,208,14,30,67,97,202,6
73764,66,52,5,34,10,3,28,23,1,0,14,0,6,2,6,14,0
73766,435,317,52,155,78,32,99,159,42,17,118,16,25,37,40,108,10
73768,499,393,59,189,118,27,144,210,32,7,106,20,23,36,27,93,13
73771,262,165,19,71,57,18,52,92,12,9,97,9,25,22,41,90,7
73772,1797,1274,243,536,386,109,452,605,108,109,523,87,160,145,131,507,16
73773,674,497,94,282,107,14,208,198,71,20,177,17,57,68,35,167,10
73801,5724,4013,896,1877,1001,239,1475,1853,451,234,1711,312,459,557,383,1513,198
73802,11,4,0,2,2,0,2,2,0,0,7,0,0,5,2,7,0
73832,429,284,42,119,95,28,93,150,18,23,145,13,37,49,46,137,8
73834,692,491,71,225,147,48,155,255,54,27,201,27,51,73,50,177,24
73835,95,62,6,23,23,10,7,42,9,4,33,6,6,4,17,33,0
73838,181,131,16,60,39,16,52,70,7,2,50,4,19,16,11,38,12
73840,287,210,39,106,48,17,66,113,29,2,77,6,15,28,28,69,8
73841,175,132,20,48,48,16,32,86,11,3,43,4,8,17,14,39,4
73842,213,153,27,61,48,17,54,82,16,1,60,8,11,22,19,58,2
73843,404,302,37,122,93,50,71,189,25,17,102,11,24,36,31,96,6
73844,116,78,6,38,22,12,16,51,3,8,38,0,11,8,19,38,0
73847,38,35,15,2,15,3,14,13,0,8,3,3,0,0,0,3,0
73848,733,485,78,225,137,45,187,244,31,23,248,28,41,77,102,234,14
73851,36,28,2,13,12,1,7,20,0,1,8,2,4,2,0,6,2
73852,748,554,100,253,140,61,203,257,61,33,194,18,52,60,64,180,14
73853,145,114,13,45,42,14,22,78,5,9,31,4,4,13,10,31,0
73855,68,52,0,28,19,5,21,27,0,4,16,0,0,7,9,14,2
73857,185,157,37,62,45,13,52,88,13,4,28,6,8,12,2,25,3
73858,715,479,73,207,141,58,125,308,32,14,236,15,57,64,100,225,11
73859,541,372,37,189,109,37,137,203,16,16,169,26,20,54,69,157,12
73860,618,357,52,168,102,35,116,194,33,14,261,28,50,88,95,251,10
73901,60,50,10,26,13,1,32,15,2,1,10,2,4,0,4,10,0
73931,215,163,17,64,60,22,56,98,4,5,52,2,17,22,11,46,6
73932,892,675,117,261,230,67,222,356,67,30,217,29,33,50,105,206,11
73933,796,546,101,234,160,51,204,262,40,40,250,26,65,79,80,246,4
73937,94,73,12,31,26,4,35,34,4,0,21,4,4,10,3,21,0
73938,299,225,36,112,66,11,76,104,26,19,74,15,15,8,36,72,2
73939,572,349,128,142,63,16,153,150,32,14,223,153,45,14,11,135,88
73942,4241,3132,858,1458,632,184,1407,1222,308,195,1109,328,244,346,191,873,236
73944,209,169,43,69,39,18,54,71,31,13,40,9,3,16,12,37,3
73945,1014,771,201,321,202,47,307,355,70,39,243,47,57,77,62,223,20
73946,32,24,0,8,8,8,7,15,0,2,8,3,0,0,5,8,0
73947,277,187,32,87,43,25,78,81,15,13,90,17,23,17,33,77,13
73949,685,514,129,211,121,53,220,227,36,31,171,41,27,52,51,162,9
73950,635,496,87,272,106,31,210,212,30,44,139,24,42,41,32,127,12
73951,485,370,90,173,96,11,155,164,34,17,115,26,33,38,18,100,15
74001,183,133,35,59,35,4,56,52,12,13,50,9,18,17,6,46,4
74002,910,664,96,305,217,46,215,348,44,57,246,30,51,73,92,227,19
74003,6124,4010,1044,1755,924,287,1336,1564,656,454,2114,393,769,558,394,1882,232
74006,10102,7202,1086,3111,2249,756,2373,3979,579,271,2900,405,669,882,944,2736,164
74008,5678,4416,936,2295,967,218,1818,1946,446,206,1262,380,362,287,233,1046,216
74010,4064,2891,627,1244,812,208,923,1299,396,273,1173,189,250,402,332,1049,124
74011,8030,6676,1444,3599,1412,221,3035,2793,632,216,1354,280,446,436,192,1206,148
74012,16570,13354,3128,7583,2230,413,6286,5062,1359,647,3216,841,1220,711,444,2657,559
74014,8218,7010,1220,3818,1798,174,2872,3239,533,366,1208,191,461,378,178,1029,179
74015,2858,2211,474,1152,541,44,783,952,320,156,647,109,220,264,54,575,72
74016,2031,1552,368,756,361,67,614,628,189,121,479,80,118,154,127,418,61
74017,14400,11076,2402,5188,2954,532,4277,5077,1046,676,3324,549,1062,956,757,2988,336
74020,3011,2231,439,950,676,166,726,1130,205,170,780,101,234,239,206,688,92
74021,4527,3565,778,1698,887,202,1478,1504,313,270,962,127,324,305,206,833,129
74022,689,504,89,217,146,52,171,251,63,19,185,9,82,62,32,169,16
74023,4447,3172,696,1297,903,276,998,1550,323,301,1275,170,290,381,434,1221,54
74026,397,301,81,118,74,28,101,141,32,27,96,17,25,29,25,83,13
74027,407,304,57,116,109,22,88,179,23,14,103,11,23,45,24,94,9
74028,622,493,96,217,144,36,175,222,64,32,129,15,45,24,45,115,14
74029,2015,1441,259,651,431,100,456,702,153,130,574,57,138,176,203,530,44
74030,1565,1076,232,439,294,111,317,508,140,111,489,49,120,175,145,443,46
74032,699,544,106,266,136,36,226,239,57,22,155,19,57,41,38,136,19
74033,3081,2525,770,1359,323,73,1237,783,266,239,556,91,238,176,51,494,62
74034,78,69,15,27,20,7,29,36,2,2,9,1,7,0,1,6,3
74035,1424,973,152,488,253,80,293,437,175,68,451,49,115,165,122,390,61
74036,2195,1796,370,936,438,52,775,755,193,73,399,89,117,122,71,341,58
74037,3409,2692,560,1468,566,98,1035,1165,381,111,717,94,247,240,136,642,75
74038,742,583,132,233,169,49,223,300,40,20,159,11,74,55,19,141,18
74039,1062,838,187,395,228,28,389,334,47,68,224,15,99,78,32,200,24
74041,191,158,33,79,42,4,56,55,14,33,33,0,16,13,4,27,6
74042,169,132,27,61,29,15,59,52,13,8,37,7,6,12,12,34,3
74044,2571,2030,450,983,521,76,747,1010,182,91,541,79,150,205,107,453,88
74045,117,90,10,40,36,4,35,47,2,6,27,6,9,4,8,21,6
74047,2379,1897,449,952,462,34,794,749,222,132,482,47,225,145,65,445,37
74048,2470,1685,320,709,506,150,539,846,188,112,785,56,201,304,224,716,69
74050,199,154,17,72,44,21,62,41,12,39,45,0,32,13,0,45,0
74051,591,467,122,197,135,13,169,206,52,40,124,9,52,45,18,107,17
74052,553,368,120,123,98,27,133,153,55,27,185,19,41,71,54,168,17
74053,990,809,167,432,184,26,296,346,98,69,181,17,39,95,30,178,3
74054,315,216,63,85,47,21,66,105,45,0,99,17,40,32,10,73,26
74055,9252,7399,1560,4029,1624,186,3409,3066,662,262,1853,453,486,486,428,1617,236
74056,2324,1588,267,741,461,119,531,760,189,108,736,75,150,281,230,673,63
74058,1610,1135,214,521,300,100,397,510,142,86,475,35,137,140,163,449,26
74059,1793,1340,300,589,361,90,456,638,129,117,453,66,149,151,87,411,42
74060,210,152,23,77,48,4,50,74,14,14,58,5,17,21,15,56,2
74061,761,609,97,239,194,79,161,308,58,82,152,13,19,75,45,152,0
74062,365,286,53,155,57,21,111,128,26,21,79,19,20,22,18,65,14
74063,10651,8138,1704,3969,2089,376,3081,3641,820,596,2513,353,856,771,533,2240,273
74066,11194,8484,1683,4091,2177,533,2927,3722,1058,777,2710,428,865,906,511,2346,364
74068,62,42,1,27,14,0,13,20,9,0,20,0,8,11,1,16,4
74070,3866,3081,653,1488,811,129,1255,1369,299,158,785,115,247,248,175,687,98
74071,63,45,0,36,9,0,14,21,0,10,18,0,9,4,5,17,1
74072,700,541,81,270,155,35,194,272,55,20,159,30,29,41,59,150,9
74073,1756,1459,332,695,362,70,576,630,149,104,297,46,77,76,98,281,16
74074,9954,5347,1607,2403,971,366,1858,2418,624,447,4607,2806,763,567,471,3084,1523
74075,8838,4412,1486,1805,898,223,1430,2081,551,350,4426,3034,731,352,309,2906,1520
74079,1903,1354,274,523,413,144,505,613,114,122,549,57,132,179,181,516,33
74080,897,731,167,352,187,25,339,290,74,28,166,28,50,63,25,150,16
74081,632,506,80,243,171,12,193,250,49,14,126,4,53,54,15,105,21
74083,414,317,58,138,102,19,125,158,15,19,97,13,27,41,16,87,10
74084,296,212,46,74,70,22,55,115,28,14,84,12,12,45,15,75,9
74085,1008,721,143,312,215,51,223,370,82,46,287,54,77,87,69,267,20
74103,67,29,0,24,5,0,0,29,0,0,38,0,33,5,0,38,0
74104,6029,2741,956,1230,385,170,928,980,410,423,3288,1235,1213,517,323,2587,701
74105,13963,7258,1867,3047,1554,790,2073,3290,1140,755,6705,2024,2152,1539,990,5771,934
74106,7088,4553,1299,1868,1097,289,794,1188,1659,912,2535,319,672,962,582,2304,231
74107,8263,5527,1521,2395,1294,317,1548,2197,1208,574,2736,620,879,700,537,2406,330
74108,2806,2227,615,961,527,124,774,860,324,269,579,79,242,177,81,523,56
74110,5605,3699,1267,1545,685,202,1117,1053,917,612,1906,361,690,543,312,1595,311
74112,9765,5448,1369,2271,1219,589,1564,2460,707,717,4317,1070,1441,1103,703,3609,708
74114,7558,4616,948,2081,1142,445,1612,2289,385,330,2942,520,1054,708,660,2553,389
74115,9104,6114,1967,2399,1341,407,1828,2165,1388,733,2990,464,1211,813,502,2521,469
74116,1449,998,372,429,155,42,258,347,322,71,451,130,189,97,35,348,103
74117,55,45,9,30,6,0,39,6,0,0,10,0,6,4,0,4,6
74119,2545,552,173,246,96,37,113,302,71,66,1993,533,724,407,329,1800,193
74120,2694,1177,403,546,183,45,387,451,231,108,1517,565,574,273,105,1259,258
74126,4128,3016,776,1368,712,160,653,861,950,552,1112,152,417,376,167,958,154
74127,7190,4651,1029,2163,1148,311,1254,1808,871,718,2539,395,971,824,349,2163,376
74128,5036,3456,1028,1221,958,249,1002,1575,547,332,1580,273,571,525,211,1393,187
74129,7473,4942,1409,1963,1249,321,1491,2174,822,455,2531,517,899,635,480,2128,403
74130,1004,719,136,380,183,20,185,334,140,60,285,37,108,95,45,231,54
74131,923,696,142,374,148,32,256,315,73,52,227,33,106,58,30,203,24
74132,2631,2130,387,1208,474,61,941,898,176,115,501,120,160,169,52,394,107
74133,15874,10176,2402,5141,2218,415,4048,4466,969,693,5698,2379,1831,828,660,4754,944
74134,5291,3361,1034,1794,483,50,1342,1264,507,248,1930,818,751,277,84,1534,396
74135,10262,5505,1200,2026,1560,719,1429,3030,656,390,4757,1267,1548,1023,919,4247,510
74136,14382,7487,2304,3185,1641,357,2311,3308,1212,656,6895,3054,2120,1192,529,5739,1156
74137,8461,6409,791,3800,1629,189,2925,2788,493,203,2052,467,764,540,281,1782,270
74145,8396,4971,1173,1863,1431,504,1465,2603,475,428,3425,1029,920,855,621,2914,511
74146,5835,3461,1262,1550,534,115,1283,1082,705,391,2374,915,742,457,260,1981,393
74301,4351,2953,549,1264,916,224,932,1424,356,241,1398,139,384,468,407,1273,125
74330,1047,821,128,401,236,56,294,421,77,29,226,22,90,82,32,204,22
74331,2728,1972,305,699,806,162,486,1245,148,93,756,82,234,269,171,639,117
74332,730,527,129,194,174,30,199,269,20,39,203,7,61,75,60,175,28
74333,426,348,92,158,87,11,158,154,20,16,78,9,15,36,18,74,4
74335,48,44,12,16,16,0,5,31,6,2,4,0,4,0,0,4,0
74337,1728,1273,258,593,338,84,463,571,145,94,455,91,96,182,86,383,72
74338,1683,1297,276,625,318,78,461,541,201,94,386,46,114,157,69,344,42
74339,1039,750,201,337,154,58,257,283,131,79,289,73,50,114,52,263,26
74340,488,301,18,127,128,28,38,222,11,30,187,11,41,72,63,156,31
74342,687,464,108,223,109,24,196,189,53,26,223,16,58,104,45,190,33
74343,1161,884,144,375,288,77,313,461,51,59,277,14,68,126,69,257,20
74344,5293,3620,562,1247,1441,370,900,2193,379,148,1673,130,445,654,444,1515,158
74346,2760,2127,442,951,641,93,726,1027,261,113,633,76,129,239,189,566,67
74347,1175,947,276,367,240,64,342,395,118,92,228,31,91,84,22,211,17
74349,245,167,29,77,51,10,47,92,24,4,78,5,20,25,28,66,12
74350,332,237,65,77,68,27,80,106,23,28,95,2,24,45,24,85,10
74352,2512,1850,398,805,571,76,637,927,170,116,662,48,228,251,135,573,89
74354,7220,4899,1171,1890,1399,439,1500,2334,660,405,2321,207,606,751,757,2122,199
74358,78,67,21,22,22,2,24,23,11,9,11,0,6,1,4,9,2
74360,715,502,99,236,133,34,183,228,46,45,213,25,41,95,52,188,25
74361,5719,4091,970,1731,1069,321,1491,1966,389,245,1628,165,458,535,470,1439,189
74363,1031,781,153,369,201,58,266,363,71,81,250,26,84,98,42,222,28
74364,547,447,117,225,82,23,211,169,35,32,100,17,29,37,17,87,13
74365,1844,1354,381,565,348,60,496,552,186,120,490,62,135,190,103,461,29
74366,645,495,71,220,169,35,137,242,65,51,150,3,42,70,35,141,9
74367,215,160,9,80,44,27,43,88,9,20,55,0,19,25,11,55,0
74368,55,48,14,18,14,2,15,19,6,8,7,0,0,6,1,7,0
74369,705,524,77,230,167,50,191,278,34,21,181,25,58,46,52,170,11
74370,1231,950,211,405,270,64,365,460,79,46,281,28,77,121,55,235,46
74401,6905,4661,1066,2004,1181,410,1319,1852,912,578,2244,262,687,712,583,2039,205
74403,12145,8167,1788,3497,2172,710,2643,3807,943,774,3978,771,1050,1124,1033,3468,510
74421,1550,1151,227,479,369,76,416,500,116,119,399,62,128,142,67,346,53
74422,308,219,31,97,76,15,67,94,32,26,89,12,19,39,19,89,0
74423,414,325,75,139,86,25,109,154,25,37,89,3,35,33,18,80,9
74425,379,272,18,89,139,26,55,185,15,17,107,0,22,63,22,93,14
74426,3762,2716,511,1008,925,272,841,1364,298,213,1046,71,237,431,307,975,71
74427,612,406,55,128,170,53,81,262,35,28,206,11,92,86,17,175,31
74428,352,282,41,112,100,29,75,182,19,6,70,6,18,36,10,68,2
74429,3695,2953,826,1358,669,100,1200,1200,390,163,742,119,304,181,138,662,80
74430,187,158,30,69,45,14,52,73,20,13,29,0,8,15,6,29,0
74431,387,292,73,133,65,21,101,126,38,27,95,9,16,41,29,90,5
74432,3937,2678,428,915,1081,254,524,1720,262,172,1259,60,285,548,366,1132,127
74434,3043,2390,542,1129,623,96,998,1042,247,103,653,82,251,212,108,563,90
74435,1261,940,166,419,289,66,302,505,92,41,321,37,87,123,74,296,25
74436,1662,1270,311,525,334,100,462,569,148,91,392,73,101,106,112,334,58
74437,4114,2890,628,1193,764,305,904,1289,365,332,1224,103,295,469,357,1108,116
74438,98,73,11,23,27,12,20,45,4,4,25,0,5,11,9,23,2
74440,35,25,6,9,10,0,6,13,2,4,10,0,3,2,5,10,0
74441,1765,1352,294,572,419,67,458,583,176,135,413,64,119,160,70,381,32
74442,448,336,68,147,104,17,120,171,24,21,112,6,24,53,29,102,10
74444,27,21,3,9,9,0,4,11,0,6,6,0,3,0,3,6,0
74445,971,759,148,348,199,64,285,328,82,64,212,20,64,70,58,201,11
74446,262,178,37,107,28,6,47,76,45,10,84,4,32,25,23,70,14
74447,7062,4695,965,2083,1278,369,1401,2055,770,469,2367,365,728,710,564,2154,213
74450,628,526,85,266,151,24,210,255,27,34,102,9,33,32,28,92,10
74451,1458,1062,203,467,314,78,330,514,121,97,396,35,92,149,120,343,53
74452,172,135,24,75,30,6,44,53,21,17,37,0,13,22,2,33,4
74454,1100,842,164,385,241,52,274,414,86,68,258,22,65,97,74,227,31
74455,1177,858,125,323,349,61,222,468,85,83,319,30,68,129,92,281,38
74456,60,51,14,29,8,0,23,13,10,5,9,0,2,7,0,9,0
74457,93,60,14,33,13,0,10,27,23,0,33,7,8,12,6,25,8
74459,22,17,2,6,8,1,6,6,2,3,5,0,0,3,2,5,0
74460,186,128,22,75,27,4,56,47,12,13,58,7,14,22,15,52,6
74461,128,94,15,23,41,15,21,55,1,17,34,0,5,21,8,33,1
74462,3003,2187,515,892,620,160,707,1049,222,209,816,86,161,289,280,775,41
74463,147,104,15,41,31,17,23,46,21,14,43,2,15,18,8,40,3
74464,10477,6903,1940,3049,1471,443,2480,2667,1075,681,3574,1249,799,1036,490,2837,737
74467,5518,4052,811,1701,1237,303,1158,2107,447,340,1466,201,400,558,307,1315,151
74468,90,68,17,27,19,5,23,35,10,0,22,5,13,2,2,17,5
74469,759,559,104,235,164,56,181,239,70,69,200,34,42,71,53,166,34
74470,640,494,110,184,157,43,152,248,54,40,146,10,31,58,47,133,13
74471,559,424,98,188,123,15,161,205,31,27,135,20,50,41,24,123,12
74472,98,68,13,33,19,3,21,41,4,2,30,4,2,5,19,26,4
74501,10715,7437,1593,3195,2067,582,2356,3643,898,540,3278,387,852,1066,973,3053,225
74521,107,79,12,33,23,11,24,49,6,0,28,0,9,15,4,26,2
74522,118,88,9,48,24,7,35,41,4,8,30,7,8,7,8,26,4
74523,2438,1686,369,683,488,146,524,823,211,128,752,77,160,285,230,688,64
74525,3428,2360,558,948,673,181,791,1038,305,226,1068,100,296,354,318,992,76
74528,58,47,7,20,14,6,5,27,6,9,11,0,3,5,3,11,0
74530,89,59,12,28,16,3,22,25,7,5,30,7,6,14,3,29,1
74531,389,295,68,99,94,34,90,144,27,34,94,11,18,36,29,87,7
74533,284,204,44,75,71,14,71,89,26,18,80,11,16,32,21,76,4
74534,127,100,9,50,32,9,36,46,3,15,27,2,2,21,2,27,0
74535,37,25,4,17,2,2,11,14,0,0,12,2,3,5,2,12,0
74536,706,426,87,165,135,39,137,205,52,32,280,18,75,117,70,259,21
74538,1730,1173,243,476,321,133,386,558,117,112,557,74,150,164,169,507,50
74540,84,56,5,32,14,5,25,30,0,1,28,3,2,17,6,26,2
74543,140,88,8,56,19,5,39,33,9,7,52,0,36,10,6,46,6
74545,110,80,16,16,32,16,16,44,8,12,30,0,8,14,8,30,0
74546,377,261,66,97,79,19,70,119,35,37,116,18,26,38,34,109,7
74547,1359,954,180,386,298,90,269,460,112,113,405,46,113,146,100,374,31
74549,58,38,4,13,18,3,9,20,8,1,20,0,4,16,0,18,2
74552,351,260,43,104,93,20,84,150,18,8,91,6,25,26,34,81,10
74553,589,414,101,168,112,33,155,181,43,35,175,20,44,54,57,161,14
74554,580,374,89,165,87,33,114,166,61,33,206,41,51,64,50,188,18
74555,400,296,72,101,108,15,101,155,22,18,104,3,28,42,31,91,13
74556,118,77,10,34,29,4,23,38,10,6,41,5,13,18,5,30,11
74557,206,151,24,74,39,14,43,83,19,6,55,8,18,20,9,49,6
74558,183,145,27,55,59,4,63,66,7,9,38,3,5,17,13,36,2
74560,247,186,44,63,56,23,56,87,13,30,61,0,7,27,27,57,4
74561,903,656,123,280,190,63,213,326,59,58,247,15,68,84,80,233,14
74562,315,224,36,116,57,15,99,91,16,18,91,4,20,35,32,88,3
74563,819,609,119,253,199,38,165,315,70,59,210,17,50,93,50,192,18
74565,304,211,56,89,45,21,79,74,38,20,93,17,24,32,20,82,11
74567,103,81,4,41,32,4,28,46,7,0,22,0,4,16,2,20,2
74569,245,183,38,81,42,22,77,80,13,13,62,9,8,21,24,57,5
74570,468,341,61,139,110,31,91,211,21,18,127,9,27,63,28,122,5
74571,1279,889,175,389,238,87,287,406,115,81,390,31,95,151,113,356,34
74572,263,200,50,77,58,15,69,73,35,23,63,2,9,27,25,52,11
74574,321,242,22,105,87,28,75,122,25,20,79,3,28,32,16,69,10
74576,85,61,6,30,18,7,15,36,3,7,24,5,9,2,8,20,4
74577,134,98,17,41,32,8,30,48,8,12,36,4,7,8,17,32,4
74578,2491,1793,361,845,465,122,524,807,332,130,698,100,160,255,183,631,67
74601,8384,5405,1404,2295,1286,420,1932,2090,794,589,2979,545,866,898,670,2619,360
74604,5180,3952,491,1839,1251,371,1372,2143,280,157,1228,175,288,392,373,1099,129
74630,231,169,34,78,46,11,54,66,33,16,62,18,16,15,13,58,4
74631,3336,2295,475,985,615,220,815,1039,278,163,1041,192,244,313,292,941,100
74632,242,166,22,81,51,12,57,93,14,2,76,7,18,34,17,68,8
74633,184,132,15,56,47,14,25,88,19,0,52,6,15,21,10,47,5
74636,115,92,16,35,28,13,26,58,6,2,23,5,2,8,8,23,0
74637,839,543,93,222,189,39,153,220,108,62,296,35,77,100,84,269,27
74640,148,110,23,57,21,9,54,53,1,2,38,0,10,12,16,36,2
74641,233,163,36,60,61,6,40,97,17,9,70,4,28,12,26,53,17
74643,249,167,25,72,58,12,60,71,21,15,82,11,18,21,32,76,6
74644,240,189,25,89,65,10,57,86,23,23,51,8,15,16,12,47,4
74646,98,83,5,38,27,13,20,57,0,6,15,0,4,4,7,13,2
74647,1445,1041,194,442,335,70,338,500,107,96,404,42,102,115,145,363,41
74650,289,228,23,92,80,33,73,133,14,8,61,9,11,13,28,56,5
74651,226,178,41,74,41,22,61,70,25,22,48,6,8,26,8,44,4
74652,479,343,83,140,80,40,107,170,43,23,136,18,28,51,39,121,15
74653,1426,979,210,396,281,92,338,452,109,80,447,81,145,101,120,397,50
74701,7670,5092,1354,2080,1186,472,1719,2230,665,478,2578,883,520,629,546,2154,424
74720,256,198,67,79,42,10,82,49,43,24,58,4,21,19,14,55,3
74721,44,44,4,15,19,6,12,25,0,7,0,0,0,0,0,0,0
74722,122,110,20,59,27,4,50,32,11,17,12,0,3,4,5,10,2
74723,563,426,68,165,150,43,118,227,42,39,137,13,44,43,37,123,14
74724,112,79,8,48,23,0,35,21,7,16,33,5,13,12,3,33,0
74726,780,567,110,251,155,51,195,277,62,33,213,18,45,92,58,200,13
74727,818,586,130,223,181,52,193,268,63,62,232,22,35,96,79,216,16
74728,4562,3349,853,1382,898,216,1101,1409,493,346,1213,140,356,484,233,1101,112
74729,935,707,131,317,220,39,245,360,67,35,228,21,53,105,49,205,23
74730,1264,965,234,398,292,41,327,480,93,65,299,28,69,99,103,276,23
74731,563,384,59,176,115,34,102,204,35,43,179,10,62,80,27,163,16
74733,1017,708,149,338,187,34,250,302,69,87,309,35,99,106,69,263,46
74734,456,337,69,142,111,15,108,162,52,15,119,23,34,41,21,111,8
74735,702,531,98,203,191,39,147,299,43,42,171,16,46,58,51,156,15
74736,276,215,27,103,66,19,77,113,14,11,61,5,7,30,19,54,7
74737,46,34,5,13,12,4,8,26,0,0,12,3,4,5,0,9,3
74738,251,187,44,81,49,13,50,75,33,29,64,5,15,28,16,56,8
74740,1004,736,160,298,219,59,245,327,97,67,268,48,80,66,74,251,17
74741,425,318,67,108,102,41,76,165,28,49,107,12,26,41,28,103,4
74743,3483,2348,596,935,612,205,670,983,449,246,1135,126,293,401,315,1047,88
74745,3839,2662,697,1081,729,155,763,985,567,347,1177,193,365,346,273,1106,71
74747,63,47,11,18,13,5,13,23,11,0,16,2,4,9,1,16,0
74748,225,167,42,66,39,20,43,98,16,10,58,2,29,22,5,52,6
74750,273,195,69,79,38,9,78,77,31,9,78,3,33,37,5,72,6
74753,40,17,0,7,10,0,7,10,0,0,23,0,0,0,23,23,0
74754,179,113,14,21,72,6,20,74,4,15,66,4,10,21,31,60,6
74755,43,27,6,15,6,0,6,14,0,7,16,0,0,16,0,8,8
74756,302,225,34,111,61,19,93,101,15,16,77,10,29,30,8,63,14
74759,536,349,73,151,99,26,121,174,25,29,187,19,38,72,58,174,13
74760,121,100,23,35,37,5,30,49,13,8,21,0,6,9,6,21,0
74761,95,76,17,28,26,5,25,38,8,5,19,0,3,11,5,18,1
74764,1361,1052,216,499,291,46,376,519,80,77,309,28,89,86,106,294,15
74766,636,504,118,220,125,41,186,216,66,36,132,4,44,48,36,125,7
74801,8794,6069,1437,2508,1625,499,1788,2616,890,775,2725,528,846,806,545,2365,360
74804,6629,4697,1055,2073,1222,347,1584,2231,584,298,1932,431,425,546,530,1692,240
74820,11407,7573,1932,3154,1895,592,2493,3453,1025,602,3834,1006,954,1087,787,3344,490
74824,384,301,65,139,81,16,109,140,30,22,83,16,22,21,24,69,14
74825,864,655,153,277,180,45,251,302,63,39,209,18,45,74,72,198,11
74826,476,379,75,149,122,33,105,210,29,35,97,9,23,33,32,92,5
74827,192,135,23,58,44,10,54,69,9,3,57,19,10,20,8,52,5
74829,281,186,25,67,72,22,41,77,30,38,95,4,25,35,31,91,4
74830,80,57,12,26,17,2,18,32,4,3,23,0,12,5,6,23,0
74831,370,277,36,120,103,18,58,168,32,19,93,4,27,41,21,83,10
74832,386,292,78,118,85,11,91,135,48,18,94,9,37,24,24,89,5
74833,257,191,38,84,56,13,71,93,13,14,66,13,17,21,15,57,9
74834,2682,2000,394,905,612,89,680,952,214,154,682,117,203,192,170,620,62
74836,98,63,9,22,25,7,17,29,9,8,35,0,8,19,8,32,3
74837,203,172,18,89,51,14,50,71,35,16,31,2,4,18,7,31,0
74839,338,252,26,104,97,25,74,138,11,29,86,6,24,29,27,84,2
74840,565,443,63,225,127,28,147,226,46,24,122,8,35,52,27,108,14
74842,150,110,24,46,38,2,38,51,15,6,40,6,6,7,21,37,3
74843,105,89,12,54,19,4,39,34,9,7,16,0,6,8,2,12,4
74844,194,144,31,54,47,12,45,54,25,20,50,8,20,12,10,44,6
74845,198,145,27,56,41,21,42,68,16,19,53,2,18,16,17,45,8
74848,2939,1976,445,791,522,218,705,839,208,224,963,80,206,376,301,886,77
74849,1256,913,196,416,244,57,287,443,115,68,343,23,96,150,74,314,29
74850,113,103,16,51,26,10,33,53,8,9,10,2,4,3,1,8,2
74851,2891,2331,490,1103,677,61,802,1125,261,143,560,65,183,162,150,523,37
74852,546,438,61,183,185,9,126,258,29,25,108,13,22,46,27,97,11
74854,770,579,109,252,164,54,213,243,60,63,191,30,45,79,37,179,12
74855,1566,1220,263,572,307,78,471,558,118,73,346,52,107,114,73,325,21
74856,284,223,53,92,67,11,83,107,16,17,61,4,19,25,13,56,5
74857,3003,2510,413,1354,693,50,1020,1119,175,196,493,74,238,123,58,399,94
74859,2334,1590,326,619,548,97,507,726,188,169,744,107,164,264,209,682,62
74860,558,438,71,185,148,34,135,262,25,16,120,13,23,49,35,116,4
74864,1798,1321,257,577,374,113,468,672,104,77,477,71,150,141,115,403,74
74865,626,486,114,198,139,35,186,222,48,30,140,18,36,49,37,131,9
74866,80,56,9,20,22,5,11,27,7,11,24,3,7,11,3,21,3
74867,378,261,27,119,89,26,60,138,33,30,117,11,34,44,28,108,9
74868,4739,3404,709,1481,901,313,1077,1597,423,307,1335,157,299,456,423,1172,163
74869,234,173,30,80,61,2,62,67,17,27,61,2,14,22,23,52,9
74871,851,638,124,278,197,39,195,323,56,64,213,8,71,86,48,189,24
74872,1306,942,200,372,299,71,319,434,93,96,364,40,94,138,92,325,39
74873,3934,2937,580,1444,737,176,1130,1287,280,240,997,111,265,336,285,875,122
74875,431,324,51,134,116,23,101,180,19,24,107,9,38,47,13,97,10
74878,496,382,77,172,104,29,129,171,45,37,114,12,28,47,27,95,19
74880,844,580,86,241,190,63,174,241,58,107,264,15,80,89,80,246,18
74881,1349,1029,223,499,246,61,385,480,102,62,320,35,117,111,57,291,29
74883,1052,710,152,295,200,63,175,352,106,77,342,23,62,137,120,321,21
74884,2356,1605,309,676,445,175,438,765,250,152,751,72,177,274,228,676,75
74901,908,643,144,252,196,51,190,307,67,79,265,28,90,102,45,245,20
74902,1668,1290,314,610,300,66,486,549,154,101,378,67,109,125,77,336,42
74930,670,521,116,234,150,21,199,240,54,28,149,16,38,43,52,138,11
74931,499,409,51,212,122,24,137,154,55,63,90,14,34,22,20,81,9
74932,696,571,122,243,169,37,208,250,58,55,125,13,37,47,28,117,8
74935,89,57,13,27,12,5,21,20,5,11,32,0,4,12,16,28,4
74936,526,379,86,164,104,25,126,163,48,42,147,28,23,67,29,126,21
74937,1877,1425,386,602,331,106,560,613,122,130,452,83,87,148,134,401,51
74939,286,210,27,102,74,7,69,113,16,12,76,2,30,26,18,70,6
74940,829,648,137,307,176,28,252,296,58,42,181,26,58,65,32,161,20
74941,939,715,183,279,201,52,270,322,56,67,224,14,47,105,58,219,5
74942,120,91,9,49,23,10,30,46,11,4,29,1,8,11,9,26,3
74943,47,34,4,13,15,2,14,20,0,0,13,0,6,7,0,13,0
74944,384,295,50,149,72,24,125,124,19,27,89,6,20,27,36,87,2
74945,192,150,44,56,48,2,52,58,12,28,42,8,9,19,6,32,10
74946,80,53,11,25,14,3,14,18,10,11,27,2,4,12,9,18,9
74947,72,38,12,11,8,7,17,10,4,7,34,8,8,11,7,34,0
74948,4174,3248,780,1459,858,151,1255,1459,299,235,926,103,271,334,218,803,123
74949,123,82,18,42,15,7,31,34,10,7,41,0,8,15,18,41,0
74951,652,465,111,190,115,49,155,205,68,37,187,18,46,78,45,162,25
74953,4065,2924,722,1332,708,162,1016,1252,413,243,1141,183,246,367,345,1025,116
74954,1507,1172,310,533,291,38,445,474,154,99,335,78,99,94,64,288,47
74955,5290,3818,855,1635,1038,290,1304,1746,492,276,1472,224,362,550,336,1327,145
74956,576,465,142,149,153,21,164,246,22,33,111,19,18,44,30,90,21
74957,404,308,60,108,114,26,89,163,24,32,96,8,26,33,29,88,8
74959,2701,2020,505,821,571,123,672,959,235,154,681,63,242,250,126,603,78
74960,4456,3337,865,1426,847,199,1254,1257,453,373,1119,137,291,443,248,1056,63
74962,1934,1442,293,530,495,124,445,745,134,118,492,34,136,203,119,450,42
74963,321,221,47,99,60,15,73,97,29,22,100,5,34,38,23,97,3
74964,996,737,191,319,196,31,277,305,87,68,259,26,84,87,62,224,35
74965,1777,1338,338,579,352,69,527,554,160,97,439,64,125,139,111,382,57
74966,1129,857,177,342,294,44,301,393,66,97,272,20,54,107,91,241,31
75001,4944,1752,748,649,304,51,380,1055,146,171,3192,1533,1278,356,25,2649,543
75002,12237,10416,2670,6281,1311,154,5752,3333,946,385,1821,393,988,358,82,1439,382
75006,16952,11780,3150,5859,2488,283,4433,4794,1452,1101,5172,1517,2079,1183,393,4001,1171
75007,17483,13869,2786,9044,1912,127,6799,4953,1351,766,3614,992,1810,620,192,2862,752
75009,1710,1376,269,748,292,67,592,597,120,67,334,63,98,83,90,281,53
75010,4758,3567,1198,2029,305,35,1713,1217,484,153,1191,447,615,86,43,936,255
75013,3719,3312,859,2063,330,60,1960,1142,109,101,407,112,187,77,31,350,57
75019,12159,9844,1783,6933,1068,60,5839,2824,853,328,2315,764,1136,317,98,1908,407
75020,8777,5897,1170,2609,1592,526,1885,2629,767,616,2880,354,840,920,766,2526,354
75021,3045,2275,474,918,678,205,598,1123,330,224,770,105,237,293,135,682,88
75022,4426,3895,630,2708,524,33,2278,1397,175,45,531,160,272,70,29,426,105
75023,17484,13126,2571,8002,2371,182,5997,5328,1186,615,4358,1108,2028,859,363,3554,804
75024,7884,5265,1366,3415,484,0,2883,1785,313,284,2619,1297,1076,205,41,2148,471
75025,13260,11129,2637,7447,927,118,6714,3556,612,247,2131,782,985,323,41,1740,391
75028,11664,10376,2430,6832,1059,55,6115,3216,662,383,1288,279,732,202,75,1060,228
75032,4867,4056,744,2261,897,154,1957,1717,248,134,811,160,398,221,32,661,150
75034,5707,4475,1177,2376,829,93,2175,1656,435,209,1232,397,590,153,92,1018,214
75035,6773,5538,2569,2564,341,64,3160,1948,282,148,1235,459,617,127,32,953,282
75038,12466,5920,3091,2296,491,42,2018,2251,1081,570,6546,3787,2248,443,68,5263,1283
75039,1885,508,283,185,40,0,84,324,60,40,1377,870,458,49,0,1120,257
75040,16975,13923,3458,7937,2130,398,6571,4431,1682,1239,3052,555,1283,844,370,2540,512
75041,10758,7951,2599,3293,1647,412,3009,2593,1297,1052,2807,600,914,775,518,2399,408
75042,12439,9508,2769,4616,1727,396,4030,2902,1379,1197,2931,533,1182,800,416,2334,597
75043,19879,14419,3630,7533,2943,313,5456,5368,2347,1248,5460,1791,2020,1098,551,4520,940
75044,13187,9903,1923,6032,1813,135,4171,3900,1154,678,3284,852,1445,805,182,2718,566
75048,3304,2811,782,1629,376,24,1405,1002,285,119,493,113,211,144,25,344,149
75050,14272,9260,2955,4129,1790,386,3479,3331,1497,953,5012,1882,1767,950,413,3932,1080
75051,10197,7748,2503,3426,1489,330,2802,2306,1708,932,2449,518,749,703,479,2053,396
75052,18550,14988,3547,9037,2193,211,7104,4990,1882,1012,3562,975,1796,580,211,2768,794
75056,9234,7639,2198,4439,916,86,4047,2367,810,415,1595,443,765,295,92,1151,444
75057,4608,2849,948,1264,524,113,1125,1122,328,274,1759,764,550,276,169,1338,421
75058,578,483,80,282,93,28,214,175,58,36,95,13,18,24,40,88,7
75060,14828,11359,3344,5383,2253,379,4697,3635,1813,1214,3469,747,1259,1044,419,2737,732
75061,18801,12821,4466,5797,2036,522,4835,4205,2140,1641,5980,1975,2156,1183,666,4792,1188
75062,16131,10494,2846,4763,2544,341,3686,4155,1513,1140,5637,2356,2011,1057,213,4495,1142
75063,12644,5795,2413,2775,563,44,2066,2728,730,271,6849,3983,2364,468,34,5572,1277
75065,3076,2325,692,1187,413,33,1019,851,268,187,751,105,320,236,90,601,150
75067,19736,12327,4870,5903,1376,178,5329,4493,1623,882,7409,3782,2576,859,192,5535,1874
75068,2665,2128,636,1071,366,55,897,849,270,112,537,122,273,101,41,401,136
75069,9747,6842,2010,3200,1348,284,2604,2485,1024,729,2905,733,977,675,520,2459,446
75070,11502,9921,2592,5653,1484,192,5385,3794,540,202,1581,478,592,386,125,1358,223
75074,13014,9580,2565,4959,1823,233,3953,3527,1237,863,3434,1206,1257,646,325,2734,700
75075,12928,10046,1746,5423,2607,270,3939,4621,871,615,2882,720,1068,769,325,2359,523
75076,2798,2055,266,963,717,109,587,1125,251,92,743,89,246,265,143,614,129
75077,10507,9199,1843,5702,1537,117,4641,3687,555,316,1308,333,608,260,107,1030,278
75078,932,820,177,485,128,30,435,293,54,38,112,23,51,13,25,93,19
75080,17143,11484,2475,5188,3207,614,4049,5360,1215,860,5659,1868,1879,1274,638,4234,1425
75081,12351,8871,1423,5016,2104,328,3628,3765,829,649,3480,1164,1194,789,333,2866,614
75082,5447,4382,816,2708,824,34,2219,1880,156,127,1065,390,410,186,79,864,201
75087,5885,4765,776,2635,1162,192,2077,2043,433,212,1120,306,363,311,140,982,138
75088,7936,6981,1359,4409,1072,141,3570,2496,673,242,955,139,454,295,67,822,133
75089,5991,5177,1412,3076,600,89,2918,1731,380,148,814,142,389,197,86,662,152
75090,8029,5535,1522,2441,1188,384,1986,2104,878,567,2494,380,715,732,667,2085,409
75092,8446,5559,1217,2501,1350,491,1886,2620,633,420,2887,965,763,636,523,2508,379
75093,16622,11991,2230,7894,1708,159,6295,4629,826,241,4631,1917,1831,511,372,3813,818
75094,1063,916,213,507,169,27,493,359,34,30,147,21,62,49,15,114,33
75098,7060,5743,1452,3189,978,124,2752,2016,672,303,1317,229,591,299,198,1031,286
75101,155,115,32,53,17,13,60,31,10,14,40,1,15,15,9,24,16
75102,384,320,39,172,71,38,131,146,13,30,64,7,7,36,14,64,0
75103,4414,3315,570,1348,1074,323,1057,1787,251,220,1099,119,266,384,330,989,110
75104,10730,8802,2156,5246,1226,174,4015,2695,1357,735,1928,388,1019,344,177,1587,341
75105,138,65,3,23,39,0,14,38,5,8,73,11,17,34,11,57,16
75110,11220,8084,1979,3542,1907,656,2676,3368,1198,842,3136,508,722,959,947,2758,378
75114,1352,1129,255,637,221,16,577,362,110,80,223,13,107,47,56,189,34
75115,13800,10652,1987,5831,2438,396,4042,4375,1466,769,3148,737,1065,855,491,2871,277
75116,6604,5153,1201,2388,1288,276,1815,2072,722,544,1451,142,560,452,297,1259,192
75117,1267,964,172,350,345,97,284,519,86,75,303,27,88,104,84,280,23
75119,7968,6065,1437,2867,1402,359,2372,2395,731,567,1903,305,583,515,500,1633,270
75121,25,8,0,0,8,0,0,8,0,0,17,0,4,5,8,17,0
75124,1643,1266,185,563,412,106,347,696,128,95,377,44,66,162,105,313,64
75125,1907,1461,330,750,363,18,523,602,190,146,446,67,202,137,40,357,89
75126,3574,3055,608,1786,549,112,1507,1115,257,176,519,54,228,175,62,452,67
75127,546,430,103,161,147,19,130,198,61,41,116,5,42,55,14,105,11
75132,66,49,19,16,9,5,16,25,5,3,17,3,6,3,5,17,0
75134,3963,3066,851,1582,493,140,945,889,785,447,897,148,396,254,99,788,109
75135,1571,1282,319,641,261,61,537,509,130,106,289,32,90,82,85,234,55
75137,6268,5111,859,2847,1197,208,1804,2124,727,456,1157,202,515,292,148,975,182
75140,2425,1761,356,729,518,158,611,893,167,90,664,54,178,258,174,593,71
75141,969,669,188,298,159,24,234,223,127,85,300,31,124,95,50,252,48
75142,5827,4570,1161,2153,1004,252,1847,1815,557,351,1257,201,381,434,241,1068,189
75143,5140,3760,728,1519,1176,337,1150,2012,326,272,1380,132,354,603,291,1168,212
75144,1141,813,185,344,196,88,273,336,112,92,328,35,68,88,137,301,27
75146,5579,4205,1111,2092,799,203,1521,1526,684,474,1374,286,566,314,208,1182,192
75147,7891,5775,972,2373,1897,533,1639,3095,573,468,2116,148,633,918,417,1841,275
75148,2347,1636,321,599,607,109,478,892,149,117,711,73,136,329,173,667,44
75149,18574,14466,4031,7465,2570,400,6008,4679,2366,1413,4108,824,1604,1200,480,3275,833
75150,20968,14423,3687,7503,2809,424,5718,5257,2104,1344,6545,2148,2494,1313,590,5461,1084
75152,1073,907,227,470,162,48,482,303,61,61,166,8,41,68,49,147,19
75153,173,143,33,62,30,18,63,70,8,2,30,15,9,6,0,23,7
75154,8964,7566,1676,4468,1251,171,3777,2530,845,414,1398,175,693,389,141,1214,184
75155,661,549,152,253,117,27,231,221,55,42,112,25,44,25,18,97,15
75158,1331,1125,190,579,310,46,451,524,84,66,206,12,89,84,21,166,40
75159,4504,3401,782,1621,875,123,1308,1299,338,456,1103,133,462,284,224,882,221
75160,6711,5104,1180,2410,1208,306,1828,1976,681,619,1607,183,532,476,416,1396,211
75161,2004,1606,272,843,411,80,618,827,127,34,398,40,162,146,50,329,69
75163,1126,778,124,287,267,100,186,445,82,65,348,29,125,136,58,307,41
75164,234,174,28,108,34,4,79,60,25,10,60,3,27,16,14,50,10
75165,9686,7572,1821,3678,1604,469,2968,3148,911,545,2114,391,698,539,486,1814,300
75166,160,130,14,82,30,4,63,56,5,6,30,2,6,6,16,28,2
75167,1284,1068,249,539,252,28,435,485,73,75,216,46,66,80,24,185,31
75169,5313,4055,694,1857,1269,235,1395,1917,402,341,1258,119,258,513,368,1096,162
75172,1036,773,247,351,147,28,299,228,135,111,263,46,113,72,32,200,63
75173,1289,1028,286,557,164,21,498,363,118,49,261,36,122,73,30,179,82
75180,6123,4797,1613,2277,792,115,1902,1303,975,617,1326,256,665,331,74,1017,309
75181,5038,4459,1030,2997,389,43,2729,1119,358,253,579,115,277,150,37,487,92
75182,867,770,61,450,243,16,351,325,55,39,97,3,46,35,13,86,11
75189,3342,2740,625,1449,592,74,1130,1149,298,163,602,87,202,196,117,474,128
75201,2049,491,232,157,59,43,45,344,59,43,1558,983,426,124,25,1309,249
75202,447,95,27,32,36,0,0,82,0,13,352,191,135,20,6,280,72
75203,5842,4152,1467,1744,637,304,1298,871,872,1111,1690,368,619,429,274,1255,435
75204,9726,3517,1640,1277,486,114,1141,1233,535,608,6209,3436,2043,575,155,4948,1261
75205,9879,4968,659,2833,1179,297,2322,1909,442,295,4911,2184,1357,744,626,4050,861
75206,20553,6963,3236,2687,730,310,2166,2741,893,1163,13590,7822,3945,1182,641,10430,3160
75207,9,9,9,0,0,0,0,9,0,0,0,0,0,0,0,0,0
75208,11112,7315,2371,3454,1110,380,3303,1928,995,1089,3797,632,1730,815,620,2865,932
75209,6452,3452,1054,1342,765,291,1042,1323,383,704,3000,712,1183,732,373,2493,507
75210,3308,2084,729,706,426,223,300,330,850,604,1224,137,450,463,174,1062,162
75211,18839,14558,5134,6736,2051,637,6826,3319,2526,1887,4281,683,1554,1170,874,3400,881
75212,5914,4814,1289,2079,1074,372,1599,846,1064,1305,1100,113,290,437,260,984,116
75214,16010,8191,2510,3701,1207,773,2894,3651,794,852,7819,2733,2821,1110,1155,6292,1527
75215,6943,4176,1107,1737,883,449,702,736,1264,1474,2767,422,976,936,433,2312,455
75216,16492,12040,2496,4674,4080,790,2762,3333,2381,3564,4452,501,1414,1889,648,3917,535
75217,20145,16376,4729,8067,2809,771,6248,3990,3334,2804,3769,470,1378,1249,672,3184,585
75218,9676,5789,1149,2632,1267,741,1796,2661,548,784,3887,747,1589,829,722,3226,661
75219,11157,3793,1588,1429,611,165,1291,1272,622,608,7364,2795,3413,936,220,5675,1689
75220,14863,10876,5223,4234,1098,321,4716,2519,1708,1933,3987,1288,1701,633,365,2669,1318
75223,4655,3329,1051,1542,614,122,1426,735,544,624,1326,317,594,255,160,1073,253
75224,9724,7346,2183,3627,1159,377,2824,1794,1490,1238,2378,567,842,537,432,1852,526
75225,8469,5478,483,3026,1338,631,2406,2499,333,240,2991,552,623,774,1042,2715,276
75226,1043,428,233,168,14,13,115,173,90,50,615,423,167,25,0,463,152
75227,15332,11690,3946,5471,1786,487,4488,2949,2669,1584,3642,561,1607,937,537,3020,622
75228,24179,16010,5052,6915,2968,1075,5356,5064,3393,2197,8169,1983,3187,1669,1330,6848,1321
75229,11212,8266,1565,3771,2122,808,3120,3723,631,792,2946,443,1095,782,626,2289,657
75230,13589,6974,1353,2994,1738,889,2303,3441,603,627,6615,1635,2171,1632,1177,5772,843
75231,22039,11241,6104,4133,830,174,4024,2678,2719,1820,10798,5077,4296,967,458,8631,2167
75232,9873,7712,1621,3487,2148,456,2018,2750,1435,1509,2161,236,1010,649,266,1950,211
75233,4198,3255,1022,1486,545,202,1232,923,602,498,943,118,400,222,203,793,150
75234,10373,7332,1486,3457,1969,420,2888,3005,744,695,3041,337,1038,981,685,2610,431
75235,5561,3379,1250,1501,511,117,1451,771,540,617,2182,655,1003,376,148,1653,529
75236,3767,2660,1085,1203,341,31,877,677,760,346,1107,289,434,267,117,964,143
75237,5675,3199,1661,1317,209,12,665,456,1569,509,2476,1134,1075,250,17,2217,259
75238,12697,8407,2261,3913,1665,568,2969,3186,1471,781,4290,1205,1778,942,365,3646,644
75240,21334,10520,4597,4131,1504,288,3845,3894,1378,1403,10814,5545,3492,1306,471,8491,2323
75241,7926,6188,1216,2282,2369,321,845,2063,1566,1714,1738,163,514,858,203,1562,176
75243,27426,14139,5423,6214,2000,502,4377,4629,3188,1945,13287,6466,4800,1551,470,11035,2252
75244,7379,4530,1246,2051,941,292,1415,1951,641,523,2849,953,1099,565,232,2278,571
75246,1487,659,305,276,65,13,283,136,99,141,828,288,266,120,154,645,183
75247,17,12,0,3,6,3,3,3,0,6,5,0,0,0,5,5,0
75248,15327,9266,1301,4589,2914,462,2868,5056,730,612,6061,1726,2362,1566,407,5230,831
75249,2872,2420,556,1513,305,46,990,655,498,277,452,106,252,76,18,390,62
75251,883,223,144,63,16,0,33,136,9,45,660,441,159,52,8,484,176
75252,11649,5407,1543,2774,999,91,1955,2538,565,349,6242,3297,2164,699,82,5249,993
75253,5104,3917,1373,1722,730,92,1496,1225,761,435,1187,183,537,331,136,918,269
75270,0,0,0,0,0,0,0,0,0,0,0,0,0,0,0,0,0
75287,24467,9560,4108,4392,927,133,3300,3899,1671,690,14907,9361,4687,731,128,12225,2682
75401,6408,4420,1210,1966,955,289,1462,1690,706,562,1988,413,626,469,480,1729,259
75402,5682,4138,745,1903,1168,322,1442,2131,351,214,1544,329,345,529,341,1409,135
75407,3458,2745,604,1453,614,74,1064,1164,323,194,713,132,267,193,121,588,125
75409,1632,1315,274,662,325,54,500,598,110,107,317,48,125,92,52,282,35
75410,1499,1147,197,470,411,69,369,611,91,76,352,38,98,145,71,318,34
75411,414,293,26,133,101,33,95,156,36,6,121,30,21,43,27,107,14
75412,383,276,48,108,108,12,82,162,11,21,107,0,33,43,31,107,0
75413,153,119,25,54,39,1,44,53,13,9,34,4,17,7,6,32,2
75414,1122,895,185,439,216,55,374,382,77,62,227,43,61,76,47,204,23
75415,85,76,11,30,31,4,27,32,2,15,9,0,0,6,3,9,0
75416,1164,887,224,386,224,53,374,385,55,73,277,39,84,69,85,240,37
75417,1145,788,156,320,230,82,231,406,80,71,357,35,82,104,136,332,25
75418,4401,3063,616,1273,896,278,837,1477,467,282,1338,167,346,402,423,1193,145
75420,444,332,40,164,101,27,106,178,5,43,112,8,25,40,39,101,11
75421,444,364,58,197,89,20,101,198,24,41,80,8,21,26,25,74,6
75422,1041,805,118,375,267,45,239,450,62,54,236,22,64,102,48,215,21
75423,854,690,124,341,184,41,256,323,67,44,164,11,48,45,60,148,16
75424,1000,804,159,397,197,51,312,378,64,50,196,30,75,47,44,168,28
75426,2492,1727,276,752,518,181,529,708,251,239,765,102,226,261,176,694,71
75428,3499,2027,533,924,456,114,708,805,333,181,1472,730,260,244,238,1158,314
75431,646,517,126,212,157,22,204,209,42,62,129,18,31,44,36,97,32
75432,1307,935,206,444,219,66,352,381,120,82,372,31,73,101,167,341,31
75433,972,704,119,279,264,42,216,398,49,41,268,32,81,89,66,235,33
75434,19,19,0,0,19,0,0,19,0,0,0,0,0,0,0,0,0
75435,542,374,60,133,130,51,94,221,25,34,168,11,29,47,81,138,30
75436,705,520,87,234,145,54,156,248,68,48,185,23,51,47,64,171,14
75437,348,286,71,129,71,15,100,139,31,16,62,13,17,24,8,49,13
75438,349,267,51,119,76,21,108,127,15,17,82,8,9,40,25,76,6
75439,344,244,63,109,50,22,112,102,15,15,100,17,9,39,35,85,15
75440,1900,1414,264,590,460,100,485,708,104,117,486,36,107,205,138,432,54
75441,31,18,0,0,18,0,0,18,0,0,13,0,5,0,8,13,0
75442,2647,2091,453,1042,461,135,801,950,221,119,556,83,182,164,127,497,59
75444,78,37,6,18,6,7,19,18,0,0,41,0,15,11,15,33,8
75446,1113,776,139,343,228,66,276,369,73,58,337,32,73,122,110,309,28
75447,386,299,60,128,91,20,116,148,15,20,87,6,20,42,19,78,9
75448,353,215,16,87,93,19,57,144,0,14,138,14,36,35,53,132,6
75449,471,337,69,143,88,37,91,146,44,56,134,4,49,29,52,128,6
75450,137,127,9,52,49,17,36,66,0,25,10,0,0,5,5,10,0
75451,491,389,75,178,101,35,148,204,12,25,102,0,44,20,38,95,7
75452,1429,1074,253,478,281,62,409,469,122,74,355,49,103,96,107,320,35
75453,1204,905,190,405,266,44,332,446,66,61,299,24,83,105,87,244,55
75454,814,634,124,334,148,28,254,288,65,27,180,19,63,68,30,142,38
75455,8337,6308,1694,2767,1408,439,2572,2376,792,568,2029,294,585,554,596,1860,169
75457,2245,1644,334,740,492,78,574,798,173,99,601,44,165,193,199,551,50
75459,1387,1077,303,474,253,47,441,436,140,60,310,48,82,109,71,277,33
75460,9799,6245,1640,2676,1317,612,1638,2541,1280,786,3554,432,940,1198,984,3248,306
75462,3769,3033,757,1345,730,201,1189,1365,323,156,736,118,198,306,114,652,84
75468,261,237,41,117,75,4,98,102,33,4,24,0,0,15,9,24,0
75469,182,103,19,49,24,11,29,50,13,11,79,16,13,37,13,74,5
75470,154,126,22,45,46,13,57,64,0,5,28,0,11,12,5,22,6
75471,398,302,64,143,90,5,120,129,24,29,96,7,4,54,31,93,3
75472,1012,760,116,330,251,63,208,416,80,56,252,17,56,122,57,214,38
75473,1482,1209,225,571,310,103,455,613,86,55,273,25,94,95,59,264,9
75474,5093,3722,742,1737,1087,156,1246,1718,459,299,1371,112,532,481,246,1188,183
75475,73,45,10,19,16,0,17,28,0,0,28,3,0,9,16,28,0
75476,430,371,53,161,129,28,125,214,17,15,59,8,9,26,16,56,3
75477,353,253,47,114,79,13,88,94,34,37,100,8,7,47,38,100,0
75478,314,229,39,90,84,16,78,117,22,12,85,12,11,40,22,70,15
75479,646,487,81,230,139,37,167,242,49,29,159,14,52,50,43,149,10
75480,581,446,72,109,231,34,97,316,22,11,135,0,35,60,40,125,10
75481,110,79,5,33,24,17,15,51,7,6,31,5,6,16,4,28,3
75482,8844,6312,1557,2696,1555,504,2418,2722,637,535,2532,410,689,756,677,2235,297
75485,22,16,4,2,8,2,0,10,2,4,6,0,3,3,0,6,0
75486,659,541,101,261,142,37,177,311,31,22,118,7,33,62,16,110,8
75487,608,460,97,182,160,21,187,209,21,43,148,6,22,38,82,136,12
75488,410,274,47,133,85,9,103,151,11,9,136,7,20,53,56,129,7
75489,389,295,55,166,64,10,120,142,23,10,94,11,25,38,20,87,7
75490,567,425,92,203,106,24,166,178,48,33,142,6,39,54,43,132,10
75491,1541,1153,236,499,331,87,391,568,110,84,388,45,113,145,85,335,53
75492,220,168,22,76,55,15,55,85,16,12,52,0,12,23,17,50,2
75493,157,128,29,70,20,9,56,49,14,9,29,6,8,9,6,22,7
75494,3975,2861,554,1145,885,277,909,1454,331,167,1114,90,289,337,398,1014,100
75495,1954,1598,327,804,370,97,690,633,148,127,356,39,107,121,89,319,37
75496,1078,769,175,324,227,43,290,333,87,59,309,37,77,88,107,279,30
75497,859,635,94,257,234,50,189,392,35,19,224,31,50,86,57,176,48
75501,13115,9237,2271,4136,2243,587,2516,3667,1844,1210,3878,638,1301,1184,755,3364,514
75503,8478,5978,1237,2782,1552,407,1943,2722,863,450,2500,598,683,671,548,2234,266
75550,379,266,55,71,98,42,70,156,11,29,113,9,30,38,36,104,9
75551,4445,3246,627,1432,918,269,964,1545,427,310,1199,99,346,380,374,1101,98
75554,758,536,98,234,124,80,160,275,46,55,222,13,38,94,77,203,19
75555,571,439,89,149,156,45,171,194,36,38,132,5,38,61,28,126,6
75556,308,228,48,107,60,13,86,111,25,6,80,10,22,22,26,80,0
75558,558,416,86,165,156,9,148,205,20,43,142,17,39,36,50,133,9
75559,2426,1754,296,760,560,138,488,838,272,156,672,67,114,268,223,646,26
75560,430,266,58,114,77,17,83,103,39,41,164,11,42,70,41,151,13
75561,2059,1509,310,696,390,113,493,641,219,156,550,44,137,208,161,506,44
75562,60,24,0,15,0,9,0,24,0,0,36,0,0,20,16,36,0
75563,1910,1256,218,515,395,128,356,653,138,109,654,69,185,201,199,593,61
75564,33,21,21,0,0,0,7,0,14,0,12,0,0,12,0,12,0
75565,184,149,33,69,35,12,61,62,19,7,35,3,6,18,8,35,0
75566,355,265,21,124,92,28,91,120,16,38,90,7,25,40,18,81,9
75567,1465,1099,193,537,299,70,432,469,113,85,366,22,116,153,75,355,11
75568,1233,809,159,229,287,134,172,442,94,101,424,32,107,139,146,394,30
75569,990,666,217,295,111,43,241,224,127,74,324,72,90,102,60,293,31
75570,3570,2563,579,1124,649,211,950,1106,276,231,1007,137,251,371,248,942,65
75571,1061,823,151,401,206,65,274,394,109,46,238,16,55,79,88,218,20
75572,1369,991,160,451,342,38,349,438,101,103,378,26,113,133,106,335,43
75573,130,84,11,49,18,6,26,37,12,9,46,0,24,10,12,46,0
75574,713,532,123,235,127,47,180,253,58,41,181,24,48,63,46,155,26
75601,5571,3529,805,1349,973,402,1049,1671,412,397,2042,234,688,589,531,1839,203
75602,7470,5432,1496,2391,1262,283,1520,1829,1256,827,2038,322,769,541,406,1789,249
75603,2232,1624,274,735,509,106,448,910,112,154,608,59,182,209,158,549,59
75604,10280,7547,2162,3524,1507,354,2992,2718,1186,651,2733,795,825,782,331,2350,383
75605,10237,6977,1339,3352,1858,428,2379,3482,680,436,3260,835,902,778,745,2858,402
75630,1120,767,103,277,284,103,163,477,77,50,353,26,120,147,60,319,34
75631,1022,774,186,357,179,52,256,413,75,30,248,24,61,104,59,227,21
75633,5318,3864,718,1757,1050,339,1345,1848,390,281,1454,187,297,548,422,1377,77
75636,54,47,5,23,11,8,10,13,5,19,7,0,0,0,7,7,0
75638,2450,1827,296,828,536,167,526,875,244,182,623,65,198,239,121,595,28
75639,1229,927,132,511,233,51,323,406,94,104,302,17,101,118,66,281,21
75640,1413,1161,226,518,331,86,420,584,90,67,252,30,71,110,41,217,35
75641,77,61,11,15,29,6,10,15,31,5,16,3,5,4,4,16,0
75643,654,463,57,177,201,28,144,264,21,34,191,30,38,68,55,168,23
75644,7481,5568,1071,2576,1513,408,2010,2512,519,527,1913,236,490,632,555,1703,210
75647,4341,3224,668,1544,844,168,1146,1449,359,270,1117,127,293,375,322,951,166
75650,2899,2331,566,1248,394,123,1110,854,225,142,568,40,211,212,105,509,59
75651,716,512,146,182,154,30,197,221,35,59,204,33,62,65,44,168,36
75652,4664,3489,598,1639,932,320,1097,1620,425,347,1175,154,325,357,339,1050,125
75654,4528,3217,703,1383,872,259,1126,1493,342,256,1311,115,258,477,461,1234,77
75656,1813,1346,284,565,415,82,396,665,178,107,467,46,97,143,181,439,28
75657,3542,2430,462,1005,769,194,637,1194,343,256,1112,54,275,513,270,1000,112
75661,1061,769,82,340,274,73,143,431,90,105,292,26,82,102,82,273,19
75662,8400,6041,1162,2888,1501,490,2095,2770,623,553,2359,418,577,735,629,2052,307
75667,449,315,40,111,129,35,87,150,23,55,134,7,25,48,54,123,11
75668,872,593,139,221,168,65,115,276,97,105,279,20,85,114,60,252,27
75669,297,189,43,95,51,0,91,61,30,7,108,20,4,50,34,94,14
75670,6240,4217,1117,1899,919,282,1294,1421,772,730,2023,240,545,650,588,1823,200
75672,6630,4889,809,2331,1423,326,1538,2398,516,437,1741,223,358,586,574,1575,166
75680,28,23,0,11,12,0,11,12,0,0,5,0,0,0,5,5,0
75681,963,729,148,298,210,73,219,347,92,71,234,15,39,92,88,223,11
75683,1538,1113,239,502,318,54,399,480,105,129,425,38,148,139,100,367,58
75684,2355,1704,373,767,415,149,592,759,199,154,651,75,185,209,182,597,54
75686,4256,3126,526,1437,922,241,904,1507,393,322,1130,129,306,379,316,1053,77
75691,1330,1019,231,478,249,61,388,429,104,98,311,28,77,118,88,279,32
75692,1891,1419,231,645,432,111,468,647,156,148,472,83,158,135,96,452,20
75693,2022,1611,293,867,384,67,771,603,143,94,411,31,97,225,58,345,66
75701,12523,7966,1881,3207,2015,863,2452,3579,1156,779,4557,951,1043,1281,1282,3960,597
75702,8285,6057,1828,2635,1200,394,2094,1485,1337,1141,2228,358,721,713,436,1919,309
75703,13015,8237,1817,3825,2103,492,2829,3906,924,578,4778,1826,1327,988,637,4053,725
75704,2681,1991,380,862,583,166,545,1016,306,124,690,80,289,187,134,616,74
75705,652,468,57,270,121,20,101,153,124,90,184,15,64,63,42,146,38
75706,2279,1789,416,845,443,85,760,749,134,146,490,69,174,164,83,425,65
75707,4202,3164,583,1541,850,190,1214,1583,214,153,1038,184,297,336,221,952,86
75708,2043,1560,413,724,361,62,648,605,176,131,483,48,144,188,103,441,42
75709,1425,1074,183,507,264,120,316,532,128,98,351,73,142,91,45,305,46
75750,1221,1007,206,441,262,98,330,502,59,116,214,45,62,68,39,202,12
75751,8119,5954,1287,2565,1585,517,1988,2677,699,590,2165,268,648,822,427,1978,187
75754,1988,1513,246,692,475,100,508,814,115,76,475,50,140,133,152,422,53
75755,2589,1933,279,746,756,152,507,1131,181,114,656,90,150,298,118,564,92
75756,1278,1035,206,485,277,67,422,430,99,84,243,19,48,91,85,205,38
75757,2852,2222,438,916,693,175,708,1172,240,102,630,97,153,254,126,545,85
75758,3170,2349,425,914,813,197,704,1315,193,137,821,76,257,313,175,753,68
75759,57,41,8,13,8,12,6,12,10,13,16,6,3,3,4,10,6
75760,1094,735,132,351,185,67,269,313,75,78,359,30,113,133,83,339,20
75762,3010,2524,433,1218,705,168,916,1327,203,78,486,60,163,159,104,444,42
75763,2201,1623,262,682,536,143,469,838,179,137,578,75,118,211,174,489,89
75764,77,56,19,23,11,3,30,19,7,0,21,3,3,5,10,20,1
75765,1631,1215,171,563,427,54,328,652,149,86,416,27,114,170,105,373,43
75766,9334,6819,1680,2910,1726,503,2357,2816,879,767,2515,364,540,825,786,2318,197
75770,944,738,141,313,228,56,247,374,57,60,206,29,53,79,45,191,15
75771,5044,3911,622,1581,1320,388,1272,2122,289,228,1133,126,254,400,353,1002,131
75773,4419,3285,650,1324,1064,247,1045,1646,328,266,1134,74,210,426,424,1034,100
75778,1122,840,120,335,359,26,239,466,78,57,282,29,78,99,76,242,40
75782,75,55,15,25,6,9,23,14,11,7,20,4,5,4,7,16,4
75783,2693,1888,265,697,700,226,458,1160,183,87,805,59,196,322,228,743,62
75784,281,195,29,86,66,14,53,99,25,18,86,6,22,33,25,84,2
75785,3325,2459,504,1117,677,161,827,1043,348,241,866,58,153,346,309,778,88
75788,43,29,4,6,19,0,15,10,0,4,14,0,0,6,8,14,0
75789,2278,1675,312,710,513,140,576,775,165,159,603,63,137,240,163,548,55
75790,1488,1103,245,473,295,90,454,518,77,54,385,66,91,127,101,345,40
75791,3911,3346,730,1771,697,148,1514,1329,327,176,565,182,181,110,92,528,37
75792,1043,831,193,356,223,59,322,329,70,110,212,19,58,81,54,204,8
75801,11525,8305,2074,3514,2069,648,2757,3479,1325,744,3220,426,914,1059,821,2922,298
75831,1867,1461,296,631,445,89,513,710,118,120,406,69,108,127,102,379,27
75833,1219,833,91,308,327,107,217,489,62,65,386,22,85,168,111,360,26
75835,4709,3241,582,1323,975,361,857,1438,490,456,1468,114,406,537,411,1341,127
75838,230,167,17,79,59,12,61,87,10,9,63,0,6,32,25,54,9
75839,1681,1284,218,553,399,114,425,613,126,120,397,42,109,120,126,365,32
75840,2535,1833,292,896,474,171,649,822,180,182,702,90,148,233,231,646,56
75844,2082,1503,222,618,533,130,477,775,109,142,579,71,117,219,172,544,35
75845,1243,871,178,329,284,80,246,435,105,85,372,25,88,148,111,357,15
75846,1085,811,119,417,213,62,287,383,78,63,274,15,81,104,74,245,29
75847,672,498,87,208,157,46,149,222,57,70,174,21,50,57,46,153,21
75848,157,103,25,37,28,13,32,51,10,10,54,9,19,5,21,51,3
75849,118,74,12,23,35,4,18,36,11,9,44,1,6,25,12,43,1
75850,195,144,16,60,60,8,58,65,7,14,51,7,18,22,4,44,7
75851,961,698,134,249,229,86,231,362,50,55,263,18,40,120,85,251,12
75852,550,392,78,140,130,44,120,199,23,50,158,28,15,69,46,142,16
75853,331,248,64,113,62,9,112,126,10,0,83,8,15,36,24,80,3
75855,931,619,93,271,202,53,140,376,60,43,312,10,107,105,90,275,37
75856,65,52,13,19,20,0,22,19,5,6,13,0,0,0,13,13,0
75858,87,34,4,19,11,0,11,23,0,0,53,4,8,23,18,53,0
75859,506,368,43,117,189,19,94,239,8,27,138,15,26,72,25,112,26
75860,1924,1351,258,581,353,159,391,638,205,117,573,67,148,211,147,527,46
75861,687,485,133,216,110,26,217,164,54,50,202,22,65,59,56,182,20
75862,3922,2729,493,887,1065,284,625,1546,341,217,1193,83,364,466,280,1061,132
75901,9537,6912,1703,3088,1765,356,2633,2805,737,737,2625,710,674,709,532,2274,351
75904,11474,8378,2016,3866,1983,513,3139,3335,1145,759,3096,586,788,901,821,2755,341
75925,1370,981,207,349,339,86,305,484,100,92,389,52,103,129,105,372,17
75926,445,334,54,116,138,26,89,175,39,31,111,2,37,47,25,99,12
75928,434,321,29,154,76,62,111,141,41,28,113,17,31,43,22,113,0
75929,684,504,54,147,221,82,104,362,17,21,180,8,28,104,40,170,10
75930,878,580,152,231,143,54,251,233,52,44,298,29,79,108,82,267,31
75931,723,546,97,193,191,65,151,288,57,50,177,15,44,71,47,160,17
75932,703,486,77,148,214,47,123,319,17,27,217,14,39,87,77,202,15
75933,559,474,60,208,163,43,166,188,24,96,85,0,21,49,15,85,0
75934,52,30,0,13,12,5,3,20,3,4,22,2,4,10,6,22,0
75935,5093,3694,841,1612,867,374,1311,1436,477,470,1399,145,374,494,386,1284,115
75936,316,244,44,97,80,23,73,123,23,25,72,11,21,21,19,62,10
75937,500,367,76,164,96,31,108,158,51,50,133,8,49,46,30,117,16
75938,1080,816,172,278,281,85,290,403,57,66,264,19,67,105,73,236,28
75939,1434,1066,291,437,270,68,417,366,184,99,368,41,97,138,92,335,33
75941,2556,2042,562,831,522,127,819,763,284,176,514,28,174,207,105,468,46
75942,140,89,20,41,18,10,29,60,0,0,51,11,0,33,7,51,0
75943,333,268,61,125,65,17,121,112,19,16,65,6,23,33,3,62,3
75944,410,319,64,117,120,18,107,181,14,17,91,7,20,47,17,85,6
75946,1358,938,163,394,281,100,262,463,85,128,420,43,109,162,106,377,43
75948,2484,1762,179,543,784,256,391,1190,100,81,722,13,163,353,193,675,47
75949,2774,2206,494,998,567,147,854,922,234,196,568,81,120,225,142,513,55
75951,6489,4695,956,1922,1342,475,1470,2122,650,453,1794,174,458,654,508,1612,182
75954,1285,947,202,400,269,76,343,463,61,80,338,57,76,123,82,302,36
75956,2813,2031,400,888,609,134,733,968,193,137,782,102,150,278,252,707,75
75959,492,325,26,93,168,38,86,198,16,25,167,9,38,90,30,138,29
75960,336,282,76,124,73,9,102,113,42,25,54,12,11,17,14,54,0
75961,12485,7323,1734,3353,1766,470,2410,3164,1029,720,5162,2853,939,789,581,3744,1418
75964,6271,4505,1289,2040,948,228,1711,1561,755,478,1766,421,537,504,304,1440,326
75966,2138,1589,392,702,402,93,554,649,212,174,549,48,182,217,102,513,36
75968,800,589,138,234,151,66,204,261,64,60,211,31,52,77,51,185,26
75969,1421,1135,284,525,253,73,466,473,85,111,286,29,107,98,52,262,24
75972,2639,1906,342,725,616,223,499,903,259,245,733,41,203,310,179,689,44
75973,1128,822,148,317,305,52,230,409,64,119,306,9,92,96,109,273,33
75974,1097,825,208,329,248,40,283,337,133,72,272,35,66,109,62,248,24
75975,1350,913,189,346,266,112,258,467,89,99,437,38,65,160,174,403,34
75976,460,340,79,132,105,24,96,169,38,37,120,9,34,50,27,118,2
75977,310,208,22,88,87,11,59,105,9,35,102,9,44,36,13,96,6
75978,39,26,0,14,12,0,10,13,3,0,13,3,0,5,5,10,3
75979,3677,2529,461,892,933,243,750,1384,202,193,1148,98,258,528,264,1034,114
75980,1079,789,156,283,306,44,231,429,64,65,290,23,71,120,76,268,22
76001,6841,5869,1570,3419,785,95,3341,1957,377,194,972,318,461,162,31,733,239
76002,2283,1980,709,1115,139,17,1157,585,185,53,303,89,173,30,11,210,93
76006,12900,5427,2055,2733,585,54,1877,2231,828,491,7473,4504,2364,539,66,5994,1479
76008,2860,2431,286,1470,588,87,1171,964,181,115,429,47,179,132,71,365,64
76009,5729,4556,1124,2297,965,170,1950,1800,528,278,1173,139,437,450,147,947,226
76010,18397,12523,5315,5111,1637,460,5107,3245,2707,1464,5874,2283,2008,1010,573,4600,1274
76011,12349,6738,3280,2642,745,71,2504,1789,1537,908,5611,2777,2167,473,194,4435,1176
76012,9915,7043,1302,3434,1959,348,2300,3184,896,663,2872,664,1122,714,372,2322,550
76013,13779,8496,2047,3427,2340,682,2496,3961,1227,812,5283,2313,1398,915,657,4006,1277
76014,10367,7834,2259,4106,1338,131,3265,2392,1419,758,2533,904,1102,453,74,1896,637
76015,6232,4369,1089,2196,904,180,1577,1808,613,371,1863,762,579,422,100,1479,384
76016,10845,9007,1292,5569,1963,183,4088,3870,638,411,1838,346,734,437,321,1532,306
76017,15444,11614,2657,6855,1958,144,5387,4403,1269,555,3830,1268,1691,649,222,3128,702
76018,7496,6309,1750,3984,528,47,3554,1701,746,308,1187,371,617,176,23,894,293
76020,8667,6568,1232,3349,1738,249,2360,2919,748,541,2099,311,818,638,332,1782,317
76021,14395,9095,1862,5027,2035,171,3560,4034,955,546,5300,2145,1905,804,446,4470,830
76022,6132,3713,848,1720,990,155,1081,1664,518,450,2419,683,942,569,225,2009,410
76023,1952,1547,319,728,463,37,642,697,107,101,405,99,121,114,71,336,69
76028,13965,11240,2336,5629,2827,448,4738,4951,964,587,2725,415,873,804,633,2310,415
76031,13745,10478,2477,4744,2572,685,4137,4507,1067,767,3267,481,993,956,837,2803,464
76034,6350,5831,252,4047,1411,121,3084,2521,99,127,519,63,240,135,81,478,41
76035,130,109,11,47,51,0,39,52,18,0,21,0,0,21,0,21,0
76036,4499,3622,621,1919,879,203,1513,1472,411,226,877,88,247,321,221,778,99
76039,12163,7086,2194,3654,1130,108,2749,2808,1007,522,5077,2298,2132,595,52,4004,1073
76040,9976,5525,1834,2555,974,162,1971,2073,991,490,4451,1909,1728,678,136,3582,869
76041,126,96,42,33,21,0,15,58,15,8,30,0,5,17,8,25,5
76043,2037,1507,301,767,380,59,646,628,139,94,530,111,138,164,117,453,77
76044,1081,883,188,483,179,33,417,313,88,65,198,40,48,65,45,167,31
76048,7576,5379,976,2276,1662,465,1746,2763,503,367,2197,302,647,769,479,1937,260
76049,7402,5869,812,2203,2308,546,1744,3524,326,275,1533,227,446,567,293,1295,238
76050,1811,1500,304,722,415,59,621,688,109,82,311,31,81,108,91,275,36
76051,15644,11342,2326,7190,1618,208,5491,4067,1210,574,4302,1525,1640,786,351,3419,883
76052,995,877,141,574,150,12,405,397,50,25,118,29,50,35,4,76,42
76053,9526,6760,1710,3001,1521,528,2255,2745,1086,674,2766,593,937,871,365,2281,485
76054,4307,3552,487,1894,1033,138,1296,1830,244,182,755,116,265,282,92,639,116
76055,949,696,161,286,183,66,251,289,78,78,253,37,70,70,76,214,39
76058,4766,3877,1033,1936,779,129,1696,1563,421,197,889,137,368,303,81,720,169
76059,1567,1053,278,458,219,98,388,385,134,146,514,125,119,113,157,389,125
76060,1843,1447,331,791,268,57,582,528,224,113,396,73,189,68,66,284,112
76061,174,151,43,65,43,0,58,93,0,0,23,8,15,0,0,15,8
76063,10587,9032,1929,5171,1704,228,4500,3320,720,492,1555,256,681,419,199,1265,290
76064,459,367,63,202,87,15,157,140,48,22,92,13,28,28,23,74,18
76065,5492,4668,969,2536,992,171,2094,1815,471,288,824,151,273,241,159,662,162
76066,1002,821,132,367,259,63,258,459,52,52,181,20,87,47,27,145,36
76067,7678,5402,1137,2379,1425,461,1686,2414,746,556,2276,234,643,777,622,1992,284
76070,160,133,8,79,46,0,67,66,0,0,27,8,0,0,19,27,0
76071,1050,815,182,388,201,44,319,349,100,47,235,30,88,79,38,184,51
76073,1448,1171,257,576,315,23,527,527,79,38,277,32,130,64,51,218,59
76077,192,149,17,90,36,6,42,80,6,21,43,0,16,11,16,28,15
76078,1796,1420,390,744,257,29,622,595,109,94,376,70,172,87,47,301,75
76082,4997,4117,943,2076,953,145,1666,1760,505,186,880,155,327,258,140,731,149
76084,2041,1708,463,913,320,12,759,645,194,110,333,37,137,87,72,276,57
76086,9133,6527,1492,2984,1619,432,2441,2781,798,507,2606,546,686,655,719,2249,357
76087,6322,5196,690,2761,1553,192,2046,2639,290,221,1126,117,481,366,162,997,129
76088,3254,2599,562,1238,700,99,975,1234,245,145,655,131,243,182,99,543,112
76092,6280,5892,380,4517,929,66,3658,1992,167,75,388,9,237,93,49,277,111
76093,633,494,129,233,119,13,202,212,46,34,139,19,31,55,34,121,18
76102,2304,1092,484,387,146,75,193,243,492,164,1212,382,433,216,181,1083,129
76103,5167,3415,1103,1425,649,238,1191,1148,643,433,1752,261,790,345,356,1449,303
76104,5758,3531,1002,1290,908,331,772,829,941,989,2227,226,738,768,495,1944,283
76105,6562,4959,1605,2018,1066,270,1521,1063,1208,1167,1603,211,574,601,217,1367,236
76106,13191,10718,3160,5011,2098,449,4797,2476,1723,1722,2473,488,842,725,418,1958,515
76107,12030,6399,1675,2884,1310,530,2059,2535,952,853,5631,1342,1975,1416,898,4876,755
76108,9733,7224,1795,3628,1514,287,2674,2856,1074,620,2509,529,945,760,275,2066,443
76109,10347,5344,1006,2447,1319,572,1860,2655,418,411,5003,2105,1154,876,868,4056,947
76110,10362,7268,2289,3350,1295,334,3277,2012,970,1009,3094,907,1090,623,474,2401,693
76111,7036,4822,1387,2061,896,478,1851,1734,591,646,2214,377,872,496,469,1834,380
76112,16617,10144,3245,4209,1898,792,2666,3592,2377,1509,6473,1757,2636,1164,916,5449,1024
76114,8883,6010,1412,2734,1333,531,2123,2335,804,748,2873,545,865,846,617,2460,413
76115,5728,4641,1919,1870,701,151,2191,1182,744,524,1087,238,368,316,165,938,149
76116,20345,11628,3735,4604,2442,847,3522,4715,2022,1369,8717,2691,2959,1797,1270,7355,1362
76117,11330,7441,2103,3150,1687,501,2553,2769,1129,990,3889,770,1508,1075,536,3278,611
76118,4652,3349,928,1561,592,268,1412,1251,382,304,1303,297,403,330,273,1069,234
76119,12505,9497,2452,4396,2244,405,2568,2821,2371,1737,3008,386,1121,1112,389,2548,460
76120,5013,2365,1049,984,294,38,717,840,552,256,2648,1382,898,323,45,2112,536
76123,3599,3146,699,2062,317,68,1814,789,377,166,453,86,263,88,16,391,62
76126,5968,4591,766,2281,1321,223,1615,2313,430,233,1377,200,566,427,184,1196,181
76127,5,5,0,5,0,0,5,0,0,0,0,0,0,0,0,0,0
76131,2316,1874,611,1012,214,37,1018,581,174,101,442,88,234,93,27,337,105
76132,10565,4785,1467,2176,905,237,1781,1970,603,431,5780,2996,1701,654,429,4738,1042
76133,17847,12920,2756,6189,3054,921,4668,5403,1730,1119,4927,1111,1667,1340,809,4250,677
76134,6618,5029,1059,2486,1248,236,1726,1962,789,552,1589,233,545,578,233,1392,197
76135,5915,4104,1037,1872,972,223,1351,1803,499,451,1811,353,660,535,263,1503,308
76137,14016,10790,3667,5977,1032,114,5893,3370,1118,409,3226,1410,1323,415,78,2559,667
76140,6131,4922,1131,2426,1191,174,1706,1789,848,579,1209,141,527,404,137,982,227
76148,8150,6789,1746,3892,1029,122,3265,2276,783,465,1361,238,707,322,94,1040,321
76155,1583,580,444,115,21,0,143,369,35,33,1003,622,316,49,16,898,105
76177,12,6,2,2,2,0,0,2,4,0,6,0,4,2,0,2,4
76179,7340,5890,1154,3316,1262,158,2531,2327,677,355,1450,225,610,370,245,1263,187
76180,20167,14969,3396,8048,2996,529,6083,6020,1704,1162,5198,1586,1769,1203,640,4107,1091
76201,18761,9049,3104,3859,1502,584,3158,3564,1355,972,9712,6057,1790,1042,823,6779,2933
76205,13269,9084,2661,4410,1742,271,3693,3766,880,745,4185,2249,1172,578,186,2728,1457
76207,2355,1465,395,759,257,54,562,584,215,104,890,451,320,79,40,565,325
76208,3668,2778,801,1460,460,57,1234,955,424,165,890,236,375,200,79,668,222
76225,921,671,129,310,172,60,236,332,57,46,250,37,74,76,63,212,38
76226,2401,2111,174,1295,582,60,838,1093,99,81,290,30,126,89,45,236,54
76227,2390,1854,380,966,426,82,772,812,153,117,536,105,179,175,77,415,121
76228,413,328,66,144,98,20,118,178,10,22,85,8,19,33,25,79,6
76230,3798,2671,495,1078,840,258,895,1417,216,143,1127,152,215,400,360,1051,76
76233,970,760,142,364,199,55,286,380,63,31,210,17,66,69,58,176,34
76234,4495,3529,707,1798,826,198,1575,1481,261,212,966,116,316,313,221,858,108
76238,32,26,2,16,8,0,16,6,2,2,6,0,0,2,4,6,0
76239,449,340,50,166,96,28,90,193,35,22,109,11,32,40,26,103,6
76240,9699,7014,1685,2817,1934,578,2430,3297,761,526,2685,390,702,775,818,2390,295
76245,665,452,80,131,209,32,74,327,42,9,213,17,69,37,90,196,17
76246,28,25,7,14,4,0,10,9,6,0,3,0,0,3,0,1,2
76247,1851,1476,323,821,295,37,671,573,126,106,375,67,141,107,60,311,64
76248,8826,7762,1589,4990,1034,149,4427,2698,426,211,1064,169,517,276,102,919,145
76249,1596,1334,330,695,272,37,594,559,120,61,262,34,119,55,54,219,43
76250,280,233,38,129,58,8,116,83,19,15,47,12,11,10,14,42,5
76251,285,200,25,91,71,13,45,131,12,12,85,8,18,33,26,80,5
76252,1004,735,118,353,184,80,304,347,51,33,269,47,59,69,94,242,27
76253,91,64,18,31,13,2,27,23,4,10,27,6,4,11,6,20,7
76255,2201,1540,257,638,518,127,481,764,149,146,661,79,144,193,245,620,41
76258,2058,1570,334,808,351,77,703,642,134,91,488,86,188,124,90,415,73
76259,936,765,165,420,161,19,345,309,67,44,171,40,76,33,22,123,48
76261,90,59,9,29,17,4,26,27,3,3,31,0,10,7,14,26,5
76262,5613,4594,793,2614,1102,85,1986,2131,259,218,1019,196,575,157,91,838,181
76264,522,396,93,155,115,33,125,210,46,15,126,12,52,49,13,105,21
76265,740,516,77,242,158,39,170,259,59,28,224,13,50,105,56,211,13
76266,3649,2895,642,1536,618,99,1209,1172,344,170,754,126,317,192,119,619,135
76268,41,34,11,22,1,0,25,3,4,2,7,5,0,0,2,7,0
76270,630,496,68,217,198,13,145,276,45,30,134,17,28,54,35,120,14
76271,451,300,63,145,74,18,121,134,12,33,151,20,55,44,32,131,20
76272,1454,1159,226,580,306,47,410,536,126,87,295,36,111,106,42,248,47
76273,3299,2429,473,1117,611,228,932,1171,168,158,870,167,190,325,188,766,104
76301,8025,4751,1318,1982,1113,338,1460,1768,851,672,3274,585,1100,928,661,2836,438
76302,4494,3125,748,1405,711,261,968,1406,557,194,1369,310,361,419,279,1161,208
76305,1051,789,118,344,274,53,227,473,67,22,262,54,64,113,31,215,47
76306,6306,4481,1274,1924,1083,200,1542,1740,714,485,1825,351,625,620,229,1541,284
76308,8125,5150,1137,2352,1245,416,1900,2431,465,354,2975,1305,593,568,509,2375,600
76309,5828,3693,933,1597,885,278,1239,1684,488,282,2135,381,658,517,579,1834,301
76310,5780,4203,901,2120,942,240,1704,1813,477,209,1577,500,532,335,210,1409,168
76311,1356,1321,835,478,8,0,947,233,141,0,35,7,18,10,0,35,0
76351,853,585,134,261,141,49,246,257,53,29,268,26,62,100,80,247,21
76354,4279,3263,715,1490,885,173,1251,1496,335,181,1016,182,257,382,195,935,81
76357,283,228,31,102,84,11,80,132,4,12,55,3,20,16,16,50,5
76360,1598,1093,217,457,309,110,352,515,152,74,505,66,101,189,149,478,27
76363,141,102,20,27,45,10,23,58,16,5,39,2,16,5,16,35,4
76364,113,89,17,21,44,7,30,46,2,11,24,2,7,7,8,24,0
76365,2071,1470,229,663,437,141,492,744,153,81,601,40,158,217,186,544,57
76366,994,739,125,417,171,26,288,323,89,39,255,26,57,111,61,231,24
76367,3557,2776,535,1356,746,139,938,1284,347,207,781,104,233,293,151,682,99
76370,129,98,8,40,40,10,25,64,4,5,31,7,8,6,10,31,0
76371,740,515,97,216,151,51,196,237,48,34,225,13,51,75,86,221,4
76372,413,292,47,129,89,27,88,143,40,21,121,10,33,38,40,113,8
76373,71,71,16,18,26,11,22,44,5,0,0,0,0,0,0,0,0
76374,1788,1184,206,538,326,114,437,501,143,103,604,77,156,180,191,552,52
76377,368,271,59,115,73,24,69,136,41,25,97,12,16,42,27,89,8
76379,202,157,33,75,41,8,69,70,16,2,45,12,14,4,15,43,2
76380,1830,1209,204,432,398,175,362,659,103,85,621,47,154,226,194,609,12
76384,5267,3587,812,1472,984,319,1265,1520,458,344,1680,313,374,432,561,1565,115
76388,96,70,3,31,34,2,21,41,5,3,26,4,5,3,14,23,3
76389,442,333,77,143,95,18,173,131,13,16,109,23,30,20,36,101,8
76401,8955,5419,1479,2331,1311,298,2073,2418,547,381,3536,1652,618,584,682,2730,806
76424,3427,2423,501,1025,691,206,834,1106,325,158,1004,110,275,374,245,906,98
76426,3168,2446,474,1195,672,105,950,1167,210,119,722,114,186,257,165,637,85
76427,314,227,45,97,69,16,74,114,25,14,87,17,18,35,17,82,5
76429,83,56,5,20,23,8,10,32,5,9,27,0,12,8,7,27,0
76430,948,678,105,349,170,54,264,304,60,50,270,25,58,94,93,258,12
76431,1230,918,194,437,242,45,357,432,85,44,312,44,111,96,61,290,22
76432,510,389,54,183,133,19,130,194,40,25,121,12,32,47,30,116,5
76433,348,275,40,134,90,11,89,167,15,4,73,4,26,32,11,71,2
76435,226,163,46,55,50,12,62,81,10,10,63,2,13,20,28,59,4
76436,47,30,3,13,12,2,11,12,0,7,17,2,4,7,4,17,0
76437,2213,1518,239,561,486,232,421,818,150,129,695,63,130,250,252,643,52
76442,2952,2130,427,842,636,225,737,1061,234,98,822,88,191,280,263,772,50
76443,685,472,49,184,174,65,135,258,27,52,213,15,24,95,79,202,11
76444,1625,1113,189,478,333,113,348,562,129,74,512,77,90,168,177,470,42
76445,137,108,13,45,33,17,35,61,12,0,29,0,7,7,15,29,0
76446,2967,2179,449,1029,522,179,997,907,168,107,788,146,189,234,219,662,126
76448,2236,1634,326,626,487,195,534,824,176,100,602,72,126,218,186,538,64
76449,961,662,94,287,228,53,201,370,37,54,299,18,81,142,58,257,42
76450,4967,3609,577,1653,1075,304,1194,1925,272,218,1358,154,306,477,421,1244,114
76452,42,35,9,14,12,0,17,15,2,1,7,0,3,2,2,7,0
76453,398,291,36,119,116,20,75,171,26,19,107,2,18,35,52,100,7
76454,667,427,56,184,159,28,141,220,35,31,240,25,48,91,76,224,16
76455,287,220,45,89,72,14,58,109,20,33,67,9,10,18,30,65,2
76457,1340,973,188,399,303,83,312,514,95,52,367,27,74,136,130,343,24
76458,2041,1493,267,693,408,125,536,713,137,107,548,43,128,215,162,511,37
76459,73,59,5,35,17,2,26,25,6,2,14,0,8,4,2,12,2
76460,135,118,10,56,42,10,31,68,11,8,17,0,9,4,4,17,0
76462,879,657,127,297,193,40,248,333,35,41,222,18,50,98,56,199,23
76463,172,128,14,45,48,21,33,78,4,13,44,0,13,19,12,42,2
76464,174,131,10,59,47,15,39,68,6,18,43,5,11,15,12,41,2
76466,135,74,9,47,9,9,29,38,0,7,61,10,24,9,18,61,0
76468,50,42,6,9,22,5,15,27,0,0,8,0,0,0,8,8,0
76469,16,4,3,1,0,0,3,1,0,0,12,0,0,12,0,12,0
76470,1300,869,127,378,265,99,238,446,92,93,431,39,82,175,135,397,34
76471,695,488,63,206,170,49,132,288,34,34,207,19,34,94,60,193,14
76472,485,371,66,176,112,17,141,202,24,4,114,0,26,45,43,108,6
76474,126,101,12,49,24,16,30,47,8,16,25,4,3,11,7,25,0
76475,402,270,57,122,71,20,88,106,54,22,132,14,33,33,52,122,10
76476,766,582,108,267,183,24,189,274,68,51,184,29,58,50,47,156,28
76481,124,88,12,42,34,0,32,41,4,11,36,0,6,16,14,36,0
76483,497,355,56,156,115,28,118,177,29,31,142,10,20,58,54,134,8
76484,339,256,61,95,69,31,72,146,22,16,83,3,19,42,19,79,4
76486,413,318,67,136,102,13,114,155,41,8,95,14,22,34,25,90,5
76487,597,478,96,217,152,13,208,221,25,24,119,9,30,38,42,97,22
76490,23,18,9,9,0,0,12,3,0,3,5,0,5,0,0,2,3
76491,183,131,15,62,42,12,53,56,14,8,52,0,15,14,23,49,3
76501,5873,3881,805,1797,911,368,1257,1524,692,408,1992,273,570,640,509,1750,242
76502,8999,6490,1305,3039,1581,565,2336,3119,656,379,2509,540,740,651,578,2195,314
76504,8804,5474,1830,2174,966,504,1896,2033,1022,523,3330,1062,1017,665,586,2828,502
76511,863,636,129,283,155,69,238,236,78,84,227,31,39,53,104,213,14
76513,9623,7164,1611,3440,1704,409,2810,3058,872,424,2459,560,724,652,523,2056,403
76518,552,410,71,206,91,42,172,183,30,25,142,7,44,38,53,136,6
76519,205,158,19,58,66,15,43,98,11,6,47,5,15,17,10,36,11
76520,3267,2278,354,985,661,278,720,1014,257,287,989,76,234,337,342,935,54
76522,11641,9129,3527,3967,1496,139,4069,3239,1410,411,2512,1005,791,603,113,1931,581
76523,86,66,17,24,20,5,17,40,2,7,20,0,7,7,6,20,0
76524,811,665,136,353,149,27,285,293,47,40,146,16,35,59,36,122,24
76525,434,315,26,158,101,30,114,156,24,21,119,7,18,48,46,113,6
76527,1110,909,209,444,204,52,408,384,60,57,201,33,69,51,48,177,24
76528,5381,3938,775,1700,1170,293,1286,1878,463,311,1443,213,356,454,420,1311,132
76530,877,611,101,310,151,49,230,274,52,55,266,16,82,94,74,244,22
76531,2017,1413,263,528,447,175,432,780,119,82,604,40,102,208,254,584,20
76534,881,687,155,272,224,36,267,299,63,58,194,26,47,76,45,175,19
76537,769,627,143,289,158,37,271,269,59,28,142,15,64,30,33,127,15
76538,285,229,37,99,67,26,74,133,11,11,56,7,16,18,15,52,4
76539,2034,1684,373,853,423,35,691,775,136,82,350,62,137,129,22,294,56
76541,9081,5382,2799,1603,777,203,1824,2041,1148,369,3699,1694,1183,555,267,3013,686
76542,8843,6814,2433,3435,893,53,3048,2502,989,275,2029,922,785,248,74,1591,438
76543,10518,7881,3734,3161,857,129,3361,2627,1316,577,2637,1162,841,493,141,1994,643
76544,5829,5755,4025,1704,26,0,4591,548,590,26,74,55,19,0,0,74,0
76548,6345,4833,1387,2556,787,103,2082,1895,617,239,1512,678,411,313,110,1169,343
76549,6236,4915,2032,2245,588,50,2190,1668,823,234,1321,532,443,300,46,921,400
76550,4191,3052,580,1412,852,208,1134,1389,330,199,1139,112,270,373,384,1020,119
76554,728,543,111,266,128,38,211,220,76,36,185,26,40,69,50,152,33
76556,501,385,50,178,131,26,142,176,29,38,116,10,22,53,31,107,9
76557,1186,960,162,510,226,62,408,398,61,93,226,35,78,51,62,198,28
76559,844,660,216,292,129,23,281,237,103,39,184,83,57,28,16,147,37
76561,294,219,47,109,53,10,91,79,14,35,75,4,20,18,33,67,8
76565,66,32,6,8,12,6,14,18,0,0,34,0,15,19,0,27,7
76566,118,87,21,29,35,2,28,48,4,7,31,4,8,9,10,31,0
76567,3422,2511,560,1018,728,205,833,1228,312,138,911,156,245,281,229,823,88
76569,846,647,153,279,179,36,262,233,93,59,199,24,22,92,61,195,4
76570,1094,738,138,308,193,99,264,292,103,79,356,16,97,132,111,331,25
76571,1934,1519,248,648,496,127,527,831,96,65,415,57,135,120,103,353,62
76574,5711,4287,974,2050,963,300,1576,1709,516,486,1424,213,397,448,366,1257,167
76577,1006,744,148,359,171,66,270,329,94,51,262,19,45,94,104,249,13
76578,542,411,94,193,113,11,156,196,28,31,131,6,24,41,60,125,6
76579,1240,1017,222,497,236,62,387,473,130,27,223,43,40,56,84,204,19
76621,384,289,74,130,64,21,134,124,12,19,95,4,23,31,37,91,4
76622,359,281,49,131,79,22,104,149,14,14,78,6,27,34,11,58,20
76624,863,676,109,281,240,46,240,344,42,50,187,26,70,52,39,154,33
76626,561,414,83,193,98,40,161,188,37,28,147,18,34,55,40,136,11
76627,482,377,70,198,83,26,145,175,31,26,105,11,23,50,21,100,5
76628,44,33,12,12,9,0,11,17,3,2,11,0,6,3,2,8,3
76629,795,515,83,225,175,32,153,215,83,64,280,25,66,99,90,259,21
76630,576,478,119,237,118,4,202,175,75,26,98,7,31,33,27,83,15
76631,120,99,22,47,22,8,46,37,11,5,21,0,2,10,9,21,0
76632,625,447,97,194,110,46,175,187,36,49,178,13,65,55,45,158,20
76633,1253,1073,181,591,261,40,497,443,82,51,180,21,62,75,22,148,32
76634,2950,2065,303,844,675,243,680,1158,97,130,885,68,200,308,309,797,88
76635,437,286,86,115,65,20,105,100,58,23,151,19,34,55,43,134,17
76636,611,507,83,239,160,25,175,273,26,33,104,17,32,35,20,81,23
76637,231,155,27,59,53,16,54,79,13,9,76,10,18,22,26,69,7
76638,860,683,104,367,158,54,320,270,49,44,177,9,60,32,76,161,16
76639,653,475,83,210,143,39,164,213,44,54,178,12,29,66,71,165,13
76640,1195,866,193,425,209,39,357,378,86,45,329,60,91,105,73,299,30
76641,631,472,82,212,143,35,155,228,52,37,159,18,36,63,42,135,24
76642,2147,1533,337,708,374,114,549,586,221,177,614,77,183,169,185,576,38
76643,3960,3203,721,1765,631,86,1343,1340,377,143,757,214,294,189,60,582,175
76645,3975,2803,687,1079,763,274,902,1253,395,253,1172,160,283,462,267,1055,117
76648,1047,721,122,321,237,41,194,346,109,72,326,31,78,117,100,304,22
76649,431,312,69,111,79,53,104,164,22,22,119,11,30,48,30,115,4
76651,1094,878,195,412,213,58,365,341,87,85,216,34,60,64,58,192,24
76652,380,293,59,114,100,20,98,159,18,18,87,6,33,37,11,72,15
76653,447,326,52,126,118,30,109,171,19,27,121,12,28,50,31,118,3
76655,2241,1907,237,1082,489,99,827,845,89,146,334,33,109,58,134,314,20
76656,765,556,121,250,144,41,213,168,74,101,209,25,65,66,53,194,15
76657,3183,2366,429,1119,610,208,934,1049,216,167,817,117,156,269,275,743,74
76660,222,161,35,61,44,21,56,62,21,22,61,9,13,24,15,57,4
76661,3065,1944,422,879,511,132,558,667,390,329,1121,115,243,393,370,1034,87
76664,1251,874,203,361,231,79,266,370,132,106,377,33,112,109,123,352,25
76665,905,677,127,294,207,49,258,301,66,52,228,14,54,86,74,220,8
76666,149,102,11,46,31,14,35,60,0,7,47,6,10,20,11,45,2
76667,3844,2682,558,1215,754,155,849,1181,413,239,1162,127,296,334,405,1042,120
76670,441,312,58,149,88,17,104,144,43,21,129,12,28,50,39,117,12
76671,691,504,69,196,182,57,137,287,32,48,187,9,35,86,57,170,17
76673,357,279,37,135,87,20,75,170,17,17,78,2,11,39,26,70,8
76675,42,37,9,13,7,8,4,33,0,0,5,0,0,5,0,5,0
76676,176,122,23,49,32,18,49,52,14,7,54,10,10,23,11,51,3
76678,63,40,0,19,18,3,5,31,2,2,23,3,4,4,12,23,0
76679,492,387,36,182,137,32,127,214,27,19,105,20,12,44,29,98,7
76680,86,64,8,20,27,9,8,44,8,4,22,3,0,19,0,19,3
76681,228,161,27,75,42,17,59,83,4,15,67,5,20,14,28,59,8
76682,999,782,129,342,259,52,265,398,62,57,217,12,77,86,42,194,23
76685,56,48,6,26,11,5,4,20,14,10,8,0,2,6,0,6,2
76686,153,114,15,55,33,11,27,56,14,17,39,1,0,16,22,39,0
76687,556,409,67,152,169,21,98,245,40,26,147,7,36,53,51,119,28
76689,1072,816,148,401,207,60,341,356,49,70,256,28,75,82,71,244,12
76690,349,266,46,126,75,19,93,126,31,16,83,7,17,32,27,77,6
76691,2392,1773,340,855,441,137,727,769,140,137,619,60,130,193,236,559,60
76692,3462,2411,456,918,854,183,693,1308,235,175,1051,87,258,419,287,903,148
76693,649,450,85,215,114,36,167,202,52,29,199,22,50,62,65,187,12
76701,446,166,51,68,40,7,46,68,31,21,280,147,89,28,16,191,89
76704,2999,1816,504,623,494,195,216,458,635,507,1183,248,340,397,198,1043,140
76705,9952,6942,1928,3061,1550,403,2438,2723,1169,612,3010,962,896,696,456,2397,613
76706,11313,5938,1699,2460,1403,376,2001,2202,866,869,5375,3791,599,555,430,3094,2281
76707,5585,4075,1434,1717,680,244,1443,1145,961,526,1510,353,513,336,308,1295,215
76708,7956,5166,1423,2211,1131,401,1725,2000,921,520,2790,623,833,648,686,2331,459
76710,10562,5783,1361,2176,1589,657,1579,2843,713,648,4779,1465,1197,988,1129,4104,675
76711,2863,2101,538,972,422,169,744,697,357,303,762,146,199,224,193,649,113
76712,7636,5781,996,2817,1612,356,2250,2829,422,280,1855,473,483,604,295,1670,185
76798,0,0,0,0,0,0,0,0,0,0,0,0,0,0,0,0,0
76801,9634,6559,1527,2695,1810,527,2143,2938,948,530,3075,556,781,953,785,2716,359
76802,1771,1340,226,651,328,135,492,635,153,60,431,64,127,151,89,360,71
76821,2075,1464,247,660,435,122,478,732,119,135,611,30,133,201,247,582,29
76823,1211,868,193,374,238,63,288,399,100,81,343,15,81,142,105,324,19
76824,42,28,3,10,15,0,6,22,0,0,14,0,0,2,12,14,0
76825,2766,1888,395,805,506,182,694,868,202,124,878,72,224,249,333,806,72
76827,174,143,30,78,27,8,58,62,11,12,31,2,14,13,2,31,0
76828,107,76,7,20,36,13,16,43,11,6,31,0,7,14,10,31,0
76831,6,6,0,6,0,0,0,0,0,6,0,0,0,0,0,0,0
76832,220,167,16,83,46,22,44,96,15,12,53,3,17,15,18,51,2
76834,2719,1825,348,699,550,228,603,933,180,109,894,70,169,367,288,808,86
76837,591,398,67,172,118,41,142,172,40,44,193,14,34,66,79,183,10
76841,18,11,4,4,3,0,4,3,0,4,7,0,4,3,0,7,0
76842,72,64,0,17,31,16,8,40,7,9,8,0,0,6,2,8,0
76844,1433,991,150,427,290,124,332,513,99,47,442,36,82,136,188,414,28
76845,54,34,4,15,10,5,16,17,1,0,20,2,0,8,10,20,0
76848,26,19,4,0,15,0,4,15,0,0,7,0,0,7,0,7,0
76849,1625,1144,177,510,342,115,383,559,132,70,481,28,115,180,158,454,27
76852,71,61,5,18,28,10,19,36,3,3,10,0,3,7,0,10,0
76853,554,402,54,148,157,43,103,236,27,36,152,18,28,52,54,130,22
76854,142,90,4,30,42,14,18,69,0,3,52,6,0,17,29,52,0
76856,1475,1023,130,411,392,90,291,607,63,62,452,18,79,174,181,427,25
76857,684,520,80,205,189,46,152,311,32,25,164,23,23,77,41,132,32
76858,95,70,13,24,24,9,29,33,6,2,25,3,0,20,2,25,0
76859,987,659,84,279,212,84,189,327,92,51,328,29,74,138,87,300,28
76861,674,557,106,250,142,59,230,265,41,21,117,9,18,41,49,109,8
76862,67,54,6,16,19,13,12,40,0,2,13,0,5,6,2,13,0
76864,386,288,27,124,94,43,75,187,14,12,98,9,25,34,30,87,11
76865,70,43,8,15,15,5,8,35,0,0,27,2,4,0,21,25,2
76866,243,171,23,79,54,15,50,94,15,12,72,6,26,16,24,70,2
76869,85,53,0,18,21,14,11,42,0,0,32,0,18,12,2,32,0
76870,74,45,20,15,8,2,30,13,0,2,29,0,9,15,5,27,2
76871,382,288,56,98,104,30,94,165,21,8,94,6,24,20,44,87,7
76872,237,171,15,69,83,4,42,102,12,15,66,5,9,31,21,49,17
76873,32,18,0,5,7,6,3,15,0,0,14,1,4,6,3,13,1
76874,48,31,11,10,10,0,0,27,4,0,17,0,0,7,10,17,0
76875,310,226,32,78,85,31,51,150,23,2,84,13,9,26,36,82,2
76877,1611,1112,210,446,312,144,388,542,99,83,499,57,109,161,172,475,24
76878,622,390,90,150,110,40,121,179,38,52,232,17,48,76,91,217,15
76882,100,62,10,30,18,4,27,23,12,0,38,2,6,26,4,36,2
76884,69,60,8,20,25,7,12,45,0,3,9,0,6,3,0,9,0
76885,11,11,0,6,5,0,0,11,0,0,0,0,0,0,0,0,0
76887,57,46,0,16,26,4,10,36,0,0,11,0,6,0,5,11,0
76888,31,21,0,8,11,2,4,15,0,2,10,0,6,4,0,8,2
76890,361,282,35,134,86,27,95,161,15,11,79,11,13,27,28,75,4
76901,10099,7074,1681,3300,1523,570,2526,2881,996,671,3025,911,727,712,675,2580,445
76903,12270,8136,2210,3428,1855,643,2702,2932,1579,923,4134,761,1157,1073,1143,3637,497
76904,12233,7967,1793,3557,2103,514,2861,3841,835,430,4266,1612,977,984,693,3614,652
76905,3630,2872,714,1343,669,146,1134,1172,323,243,758,148,305,241,64,642,116
76930,52,42,7,19,12,4,13,20,2,7,10,0,0,0,10,10,0
76932,1055,853,185,438,177,53,460,284,71,38,202,26,70,70,36,195,7
76933,563,382,64,168,114,36,138,191,28,25,181,8,20,65,88,171,10
76934,420,306,51,181,67,7,114,124,33,35,114,9,45,38,22,102,12
76935,439,343,35,192,94,22,105,180,37,21,96,14,48,15,19,82,14
76936,1087,792,147,366,212,67,306,381,63,42,295,18,78,107,92,277,18
76937,97,85,15,31,32,7,26,45,9,5,12,3,2,1,6,12,0
76940,44,37,0,22,8,7,5,26,0,6,7,0,0,2,5,7,0
76941,605,453,66,226,134,27,170,231,35,17,152,15,43,66,28,137,15
76943,1449,1068,231,505,285,47,429,456,128,55,381,40,112,116,113,354,27
76945,797,541,88,203,200,50,170,286,49,36,256,13,36,114,93,237,19
76949,16,12,0,4,8,0,0,12,0,0,4,0,0,4,0,4,0
76950,1500,1170,252,551,298,69,506,500,92,72,330,49,103,112,66,326,4
76951,511,391,56,223,76,36,166,175,31,19,120,12,28,45,35,116,4
76953,25,16,0,6,10,0,2,14,0,0,9,0,2,2,5,9,0
76955,42,32,11,10,11,0,10,22,0,0,10,5,0,0,5,10,0
76958,104,81,4,55,15,7,21,41,5,14,23,0,12,11,0,21,2
77002,1802,306,104,159,43,0,54,208,24,20,1496,570,695,169,62,1336,160
77003,2569,1790,486,832,335,137,614,386,407,383,779,185,285,178,131,631,148
77004,11644,5922,1632,2461,1352,477,1035,1417,1766,1704,5722,1561,1880,1477,804,4700,1022
77005,9482,5882,790,3609,1232,251,2773,2481,368,260,3600,1118,1186,635,661,3070,530
77006,10989,2743,1028,1185,452,78,560,1469,324,390,8246,3829,3245,945,227,6477,1769
77007,9305,4684,1351,2185,889,259,1582,1773,642,687,4621,1673,1850,650,448,3662,959
77008,12428,6334,1650,3034,1142,508,2004,2648,726,956,6094,1561,2571,1107,855,4964,1130
77009,14272,9272,2513,3974,2099,686,3329,3019,1429,1495,5000,1171,2339,804,686,3859,1141
77010,38,19,0,0,10,9,0,19,0,0,19,9,0,10,0,19,0
77011,6332,5062,1517,2207,1105,233,2112,1289,688,973,1270,233,476,389,172,1077,193
77012,6758,5538,2065,2344,904,225,2751,1069,894,824,1220,301,487,287,145,932,288
77013,5341,4205,1483,1963,638,121,1768,1099,820,518,1136,321,428,300,87,883,253
77014,7766,4986,1964,2588,415,19,2136,1330,1096,424,2780,1382,1135,244,19,2249,531
77015,16391,12452,3816,6239,2124,273,5354,3780,1992,1326,3939,1002,1643,991,303,3212,727
77016,9729,7377,1349,2906,2583,539,1607,2383,1278,2109,2352,226,804,1047,275,2071,281
77017,9657,7431,2373,3615,1095,348,3492,1935,1090,914,2226,439,757,644,386,1795,431
77018,10631,6743,1392,3094,1506,751,2095,2916,763,969,3888,599,1647,896,746,3147,741
77019,7936,3274,764,1502,799,209,962,1768,179,365,4662,1905,1688,745,324,3755,907
77020,8234,6156,1706,2699,1391,360,2283,1389,1139,1345,2078,247,603,755,473,1811,267
77021,8770,5879,1368,2158,1852,501,975,1731,1574,1599,2891,341,988,1157,405,2515,376
77022,9990,7102,2063,3145,1515,379,2637,1825,1118,1522,2888,352,982,959,595,2462,426
77023,9580,7279,2228,3638,1111,302,3242,1803,1085,1149,2301,638,745,561,357,1813,488
77024,13971,9133,707,4648,2893,885,3527,4522,578,506,4838,813,1313,1387,1325,4490,348
77025,11169,5879,1484,2893,964,538,2117,2398,720,644,5290,1663,1815,990,822,4540,750
77026,9526,6489,1641,2601,1574,673,1595,1457,1558,1879,3037,321,906,1312,498,2643,394
77027,8391,2926,754,1233,733,206,776,1711,215,224,5465,2659,1673,662,471,4503,962
77028,5560,4062,697,1629,1449,287,780,1280,843,1159,1498,170,447,606,275,1320,178
77029,5816,4439,948,1874,1150,467,1566,1430,563,880,1377,170,378,479,350,1213,164
77030,5463,2515,773,1255,351,136,897,1297,146,175,2948,1582,831,387,148,2510,438
77031,6118,4235,1492,1928,704,111,1594,1170,870,601,1883,585,802,323,173,1516,367
77032,3579,2725,979,1259,438,49,868,582,902,373,854,190,409,213,42,714,140
77033,8962,6859,1190,2626,2586,457,1185,2148,1475,2051,2103,128,703,972,300,1866,237
77034,9581,6399,2046,2940,1167,246,2455,2193,1090,661,3182,1358,1027,614,183,2516,666
77035,14335,9779,3279,4631,1415,454,3379,2788,2314,1298,4556,1161,1958,1104,333,3719,837
77036,28375,18280,8295,7209,2199,577,6778,4718,4090,2694,10095,3964,4245,1337,549,8178,1917
77037,5320,4384,1344,2008,841,191,2042,1356,386,600,936,163,285,319,169,810,126
77038,5914,4831,1666,2463,604,98,2158,1085,1039,549,1083,322,418,287,56,822,261
77039,7756,6529,1798,3389,1220,122,2942,1998,920,669,1227,190,462,405,170,1036,191
77040,14570,10268,2384,6104,1557,223,4475,3627,1335,831,4302,1622,1873,673,134,3492,810
77041,7666,6336,1324,3985,905,122,3237,2061,501,537,1330,227,647,341,115,1082,248
77042,18162,8661,3312,3606,1467,276,2578,3938,1385,760,9501,4730,3253,1297,221,7976,1525
77043,8300,6083,1500,2836,1484,263,2300,2177,825,781,2217,456,957,632,172,1742,475
77044,4133,3359,984,1790,506,79,1483,907,621,348,774,143,347,226,58,582,192
77045,7473,6196,1263,3187,1582,164,1927,1771,1258,1240,1277,138,482,539,118,1106,171
77046,302,121,23,38,52,8,13,78,21,9,181,30,77,47,27,159,22
77047,3667,2858,471,1297,943,147,752,1144,405,557,809,87,213,296,213,704,105
77048,4650,3624,918,1623,973,110,763,893,1087,881,1026,129,365,434,98,908,118
77049,5181,4112,1062,2342,640,68,1743,1188,784,397,1069,271,507,247,44,884,185
77050,1300,1071,265,441,302,63,355,346,199,171,229,37,104,81,7,192,37
77051,4873,3251,619,1161,1003,468,464,862,862,1063,1622,81,464,691,386,1513,109
77053,7109,6150,1351,3794,936,69,2600,1391,1283,876,959,139,473,279,68,850,109
77054,9289,3358,1928,1230,176,24,824,1373,626,535,5931,3943,1635,266,87,4746,1185
77055,14005,10145,3092,4919,1530,604,4242,2981,1507,1415,3860,834,1711,899,416,2999,861
77056,7302,3334,615,1377,1018,324,823,2102,189,220,3968,1344,1265,691,668,3386,582
77057,20130,7358,2766,2791,1441,360,1952,3663,788,955,12772,6108,4302,1758,604,10788,1984
77058,8047,3766,1167,1491,976,132,827,1932,560,447,4281,1726,1589,754,212,3571,710
77059,5162,4714,475,3199,982,58,2788,1659,168,99,448,55,148,213,32,402,46
77060,11664,8322,3624,3659,887,152,3198,1765,2180,1179,3342,1413,1336,477,116,2562,780
77061,8965,6292,2340,2726,869,357,2436,1861,1294,701,2673,883,966,493,331,2205,468
77062,9617,7747,1197,4585,1755,210,3633,3225,556,333,1870,365,901,386,218,1577,293
77063,14709,5862,2367,2211,912,372,1590,2669,713,890,8847,4322,2795,1158,572,7223,1624
77064,11794,9184,2382,5580,1139,83,4774,2941,1005,464,2610,1014,1237,294,65,2098,512
77065,10360,7177,1806,4183,1080,108,3240,2603,1005,329,3183,1543,1195,345,100,2553,630
77066,8947,7242,1453,4320,1308,161,3285,2618,765,574,1705,506,700,419,80,1490,215
77067,7856,5834,2155,3111,538,30,2513,1310,1444,567,2022,936,867,202,17,1646,376
77068,3429,2790,394,1530,793,73,1073,1304,297,116,639,256,233,112,38,477,162
77069,6808,4257,594,2149,1304,210,1433,2309,314,201,2551,847,885,568,251,2218,333
77070,12124,8816,1942,5025,1604,245,3854,3374,1062,526,3308,1110,1129,727,342,2825,483
77071,9203,6489,1403,3693,1184,209,2190,2106,1310,883,2714,550,1254,578,332,2284,430
77072,15920,12469,3665,6544,2037,223,5176,3032,2562,1699,3451,912,1520,786,233,2904,547
77073,5186,3245,1317,1351,510,67,1211,1190,579,265,1941,904,734,286,17,1517,424
77074,13896,9064,3108,4129,1357,470,3408,2799,1775,1082,4832,1439,1810,961,622,3904,928
77075,7470,5460,1697,2854,815,94,2453,1655,763,589,2010,709,725,475,101,1612,398
77076,8508,6868,2256,3179,1137,296,3357,1680,1006,825,1640,230,610,514,286,1354,286
77077,20144,11074,3139,5570,2002,363,3916,4931,1442,785,9070,3667,3603,1364,436,7667,1403
77078,4120,3446,868,1806,706,66,1038,819,938,651,674,133,303,184,54,555,119
77079,11957,9009,906,4982,2542,579,3664,3824,956,565,2948,511,1070,986,381,2618,330
77080,15169,10955,3506,4889,2044,516,4610,3507,1410,1428,4214,952,1651,1009,602,3485,729
77081,17391,10944,5742,4452,670,80,4920,2441,1927,1656,6447,3326,2265,709,147,4952,1495
77082,15334,8647,2714,4631,1235,67,3252,3208,1367,820,6687,3077,2788,690,132,5413,1274
77083,15763,13086,2627,8555,1730,174,6434,3718,1900,1034,2677,616,1413,565,83,2148,529
77084,21997,16670,4374,9986,2124,186,8387,5041,2302,940,5327,1867,2493,807,160,4345,982
77085,2207,1805,416,953,365,71,624,533,299,349,402,24,213,147,18,365,37
77086,5889,4889,1510,2667,647,65,2313,1306,779,491,1000,257,504,177,62,832,168
77087,10311,8018,2140,4019,1560,299,3606,2212,1220,980,2293,278,811,647,557,1919,374
77088,15558,12099,2623,6369,2687,420,3984,3619,2399,2097,3459,645,1533,989,292,2877,582
77089,12148,9610,1886,5323,2139,262,3977,3525,1075,1033,2538,723,935,585,295,2026,512
77090,11487,6166,2259,2500,1253,154,1766,2574,1315,511,5321,2712,1927,600,82,4283,1038
77091,8889,6143,2013,2639,1241,250,1499,1562,1875,1207,2746,707,1119,704,216,2347,399
77092,14160,9334,3355,3941,1690,348,3231,2835,1996,1272,4826,1343,2043,1040,400,3956,870
77093,12327,9942,2804,4559,2192,387,4491,2659,1387,1405,2385,286,771,838,490,2048,337
77094,2351,2179,232,1663,284,0,1521,592,56,10,172,9,57,59,47,172,0
77095,13298,10814,2250,7286,1172,106,5993,3448,999,374,2484,795,1261,329,99,2081,403
77096,14333,9400,1992,4068,2308,1032,3182,3956,1220,1042,4933,1398,1602,989,944,4270,663
77098,7274,2240,775,1015,313,137,552,1236,228,224,5034,2256,1870,656,252,4051,983
77099,14091,10500,2914,5997,1504,85,4411,2881,2033,1175,3591,1167,1656,662,106,2932,659
77301,8107,5724,2001,2429,965,329,2068,1697,1129,830,2383,557,760,622,444,1936,447
77302,4363,3606,727,1766,965,148,1290,1678,353,285,757,130,192,340,95,606,151
77303,3927,3071,878,1507,567,119,1247,1240,348,236,856,133,267,350,106,701,155
77304,6430,4277,866,2043,1037,331,1485,2120,385,287,2153,603,594,545,411,1811,342
77306,2676,2148,617,1012,457,62,903,777,264,204,528,122,234,114,58,440,88
77316,3391,2557,585,1277,591,104,1124,1089,197,147,834,140,359,234,101,696,138
77318,3782,2991,409,1440,1022,120,979,1579,192,241,791,88,261,390,52,641,150
77320,8325,5698,1361,2614,1394,329,1936,2506,681,575,2627,866,670,711,380,2122,505
77326,78,49,14,9,18,8,16,18,0,15,29,16,6,7,0,29,0
77327,10219,7926,1923,3690,1896,417,3069,3329,801,727,2293,267,706,849,471,2026,267
77331,2466,1757,210,718,686,143,386,1043,214,114,709,84,169,337,119,617,92
77333,82,44,4,0,33,7,10,10,4,20,38,6,17,8,7,38,0
77334,63,40,8,18,7,7,14,15,0,11,23,0,0,14,9,17,6
77335,757,537,81,231,205,20,163,270,68,36,220,8,72,76,64,193,27
77336,3012,2415,412,1363,560,80,1012,1005,245,153,597,70,194,276,57,497,100
77338,7366,5229,1465,2656,1004,104,1918,1760,887,664,2137,593,821,568,155,1695,442
77339,11324,8928,1598,4751,2261,318,3898,3879,646,505,2396,591,930,653,222,2014,382
77340,8781,4990,1373,2093,1220,304,1591,2257,671,471,3791,2222,580,569,420,2490,1301
77341,0,0,0,0,0,0,0,0,0,0,0,0,0,0,0,0,0
77345,7397,6549,615,4538,1245,151,3818,2366,200,165,848,76,381,160,231,758,90
77346,9324,8031,1599,4990,1356,86,4102,3028,563,338,1293,304,614,265,110,1069,224
77351,10410,7659,1354,2966,2611,728,2294,3968,785,612,2751,292,734,1103,622,2497,254
77354,5320,4476,958,2362,1004,152,1889,1967,337,283,844,170,402,206,66,642,202
77355,4848,4029,811,2389,735,94,1961,1609,239,220,819,92,319,275,133,636,183
77356,5953,4627,515,2032,1785,295,1246,2892,258,231,1326,185,313,620,208,1122,204
77357,5735,4530,1119,2179,1057,175,1972,1718,447,393,1205,173,490,409,133,978,227
77358,1462,1006,225,479,243,59,336,429,126,115,456,40,193,163,60,395,61
77359,232,192,26,81,61,24,53,109,13,17,40,4,9,15,12,30,10
77360,1798,1257,193,376,558,130,263,795,112,87,541,28,145,254,114,482,59
77362,1038,790,130,466,175,19,380,293,71,46,248,43,52,77,76,228,20
77363,794,575,135,340,90,10,264,163,59,89,219,29,100,72,18,190,29
77364,855,612,65,220,241,86,126,386,51,49,243,25,66,114,38,215,28
77365,5492,4249,1051,2099,961,138,1610,1708,558,373,1243,230,474,393,146,1053,190
77367,98,66,18,21,19,8,15,28,15,8,32,0,9,16,7,31,1
77368,346,241,15,114,103,9,47,108,25,61,105,0,21,64,20,96,9
77369,558,381,45,204,79,53,128,203,24,26,177,1,57,79,40,166,11
77371,2612,1952,431,913,542,66,731,862,231,128,660,43,195,252,170,595,65
77372,3459,2721,678,1256,668,119,1143,1117,276,185,738,129,242,241,126,612,126
77373,12319,9957,2304,5776,1631,246,4608,3538,1089,722,2362,538,1046,593,185,1912,450
77374,130,102,40,33,29,0,56,46,0,0,28,0,0,14,14,28,0
77375,11858,9223,2210,5265,1508,240,4233,3286,1191,513,2635,527,1003,645,460,2083,552
77376,191,145,31,77,27,10,58,47,23,17,46,6,5,21,14,46,0
77378,3597,2845,807,1302,617,119,1261,878,397,309,752,159,207,265,121,592,160
77379,15155,12969,1722,8392,2692,163,6722,4735,1032,480,2186,516,1033,550,87,1767,419
77380,7740,5363,1094,2911,1161,197,2180,2146,663,374,2377,734,822,515,306,2007,370
77381,12392,10177,1124,7056,1757,240,5670,3574,707,226,2215,207,787,681,540,2032,183
77382,4539,3973,925,2569,394,85,2569,1237,106,61,566,98,293,130,45,531,35
77384,1342,1175,155,702,281,37,500,517,82,76,167,21,72,35,39,155,12
77385,3183,2645,483,1454,648,60,1180,1047,226,192,538,82,203,198,55,431,107
77386,4781,3843,1083,2028,632,100,1856,1505,331,151,938,337,327,196,78,717,221
77388,8993,7680,1287,4539,1647,207,3647,3132,514,387,1313,298,486,361,168,1099,214
77389,4347,3680,682,2167,740,91,1755,1416,363,146,667,101,248,283,35,534,133
77396,6800,5499,1622,2763,966,148,2414,1658,860,567,1301,309,566,326,100,1056,245
77401,6099,4343,422,2861,816,244,1965,1739,380,259,1756,291,671,427,367,1467,289
77412,90,76,30,36,10,0,29,10,37,0,14,9,0,0,5,14,0
77414,8937,6288,1477,3050,1340,421,2392,2331,1004,561,2649,460,867,902,420,2310,339
77415,70,49,0,22,27,0,9,40,0,0,21,0,0,7,14,21,0
77417,619,468,91,221,131,25,204,181,57,26,151,16,54,48,33,136,15
77418,3367,2471,433,1134,704,200,973,1094,169,235,896,44,266,295,291,778,118
77419,519,391,107,191,68,25,202,142,28,19,128,0,50,51,27,122,6
77420,689,566,122,291,132,21,241,231,58,36,123,18,20,33,52,114,9
77422,4722,3593,700,1831,881,181,1269,1611,364,349,1129,134,347,439,209,1000,129
77423,2268,1680,484,716,420,60,586,601,283,210,588,47,206,226,109,505,83
77426,516,380,57,146,135,42,65,219,33,63,136,0,29,48,59,136,0
77428,32,12,0,0,6,6,0,12,0,0,20,0,0,12,8,20,0
77429,14029,12074,2686,7238,1932,218,6284,4361,988,441,1955,514,856,441,144,1573,382
77430,868,660,72,344,196,48,187,381,42,50,208,27,83,59,39,177,31
77432,153,127,13,58,56,0,43,64,14,6,26,0,7,19,0,26,0
77433,1116,896,329,502,59,6,494,215,125,62,220,39,154,19,8,172,48
77434,1710,1293,195,601,384,113,496,501,119,177,417,53,111,116,137,354,63
77435,1544,1133,153,593,337,50,362,542,136,93,411,88,152,91,80,346,65
77437,5704,4226,918,2008,1030,270,1668,1682,524,352,1478,144,411,507,416,1339,139
77440,89,60,17,25,18,0,24,36,0,0,29,0,0,14,15,29,0
77441,803,653,80,329,231,13,205,372,40,36,150,7,46,77,20,147,3
77442,519,315,36,143,84,52,126,113,13,63,204,28,55,55,66,185,19
77443,54,27,6,21,0,0,0,17,10,0,27,0,6,8,13,27,0
77444,225,151,32,80,31,8,74,46,29,2,74,6,27,28,13,71,3
77445,3618,2631,584,1330,606,111,986,967,342,336,987,305,235,237,210,799,188
77446,529,275,34,101,94,46,67,123,28,57,254,117,43,55,39,177,77
77447,2600,2188,475,1175,458,80,1029,886,167,106,412,104,176,46,86,312,100
77448,181,152,10,70,38,34,36,68,16,32,29,0,9,0,20,29,0
77449,12108,10182,3035,6163,863,121,5550,2835,1350,447,1926,399,972,467,88,1551,375
77450,15501,13387,2197,8774,2178,238,7669,4184,985,549,2114,459,981,549,125,1716,398
77451,215,144,23,48,63,10,30,59,20,35,71,2,19,32,18,68,3
77454,54,38,9,29,0,0,25,13,0,0,16,0,0,0,16,16,0
77455,667,517,74,258,157,28,239,209,33,36,150,54,24,29,43,125,25
77456,433,335,51,163,99,22,133,175,16,11,98,5,54,25,14,78,20
77457,329,195,17,84,69,25,32,126,15,22,134,7,29,71,27,127,7
77458,92,68,10,32,17,9,32,28,0,8,24,0,12,0,12,24,0
77459,10746,9423,1314,6028,1913,168,4592,3756,600,475,1323,121,674,415,113,1149,174
77461,2767,2213,393,1236,477,107,984,869,230,130,554,134,136,149,135,481,73
77463,37,10,4,6,0,0,4,6,0,0,27,8,7,12,0,12,15
77464,174,140,37,69,30,4,52,67,17,4,34,7,7,15,5,27,7
77465,2336,1768,377,832,397,162,782,592,204,190,568,85,139,216,128,498,70
77466,279,221,37,121,51,12,80,107,19,15,58,19,21,7,11,50,8
77467,66,43,3,21,0,19,12,18,3,10,23,0,0,14,9,23,0
77468,95,53,10,31,5,7,19,7,10,17,42,0,0,42,0,42,0
77469,13324,11211,2601,6381,1918,311,5239,3931,1268,773,2113,503,835,551,224,1777,336
77470,113,86,13,29,38,6,28,48,0,10,27,0,5,15,7,27,0
77471,9118,7046,1688,3433,1482,443,2830,2397,1042,777,2072,347,666,599,460,1820,252
77473,51,28,5,11,10,2,6,12,6,4,23,5,12,5,1,23,0
77474,3785,2856,509,1372,760,215,1095,1266,283,212,929,150,317,250,212,810,119
77475,331,238,23,75,108,32,65,150,23,0,93,9,32,28,24,76,17
77476,435,329,37,177,82,33,109,192,17,11,106,0,46,43,17,88,18
77477,9791,7184,1741,4298,1041,104,3109,2368,1034,673,2607,957,1056,533,61,2238,369
77478,17138,14605,2509,8938,2771,387,7039,5300,1319,947,2533,503,1193,573,264,2168,365
77479,16502,14771,1935,10864,1811,161,9124,4161,1032,454,1731,298,855,439,139,1449,282
77480,2575,2152,399,1132,540,81,870,931,213,138,423,47,102,152,122,408,15
77481,73,58,11,13,31,3,7,30,5,16,15,0,3,8,4,15,0
77482,841,633,105,267,243,18,233,306,39,55,208,9,63,102,34,202,6
77483,144,108,15,54,39,0,60,39,0,9,36,8,6,8,14,36,0
77484,3038,2306,511,1111,608,76,807,1036,236,227,732,169,273,177,113,558,174
77485,888,697,153,352,151,41,266,269,94,68,191,24,48,50,69,168,23
77486,2765,2053,332,983,558,180,740,922,243,148,712,98,192,216,206,608,104
77488,5660,3895,668,1900,996,331,1289,1613,584,409,1765,352,441,489,483,1573,192
77489,10152,8615,1425,5752,1326,112,3526,2405,1602,1082,1537,191,880,354,112,1330,207
77493,4677,4021,888,2364,595,174,2005,1325,411,280,656,83,303,183,87,572,84
77494,3722,3262,596,2119,470,77,1957,1089,158,58,460,94,208,63,95,396,64
77502,11364,8797,2404,3902,1951,540,3646,3037,1154,960,2567,364,873,836,494,2148,419
77503,7707,5898,1687,2809,1218,184,2343,1810,1053,692,1809,395,632,573,209,1453,356
77504,7558,5019,1639,2302,908,170,1919,1767,818,515,2539,837,844,544,314,2138,401
77505,7020,5550,1324,3231,885,110,2704,1896,667,283,1470,501,589,283,97,1144,326
77506,11762,9047,3437,4149,1129,332,4275,2273,1448,1051,2715,553,856,871,435,2252,463
77507,0,0,0,0,0,0,0,0,0,0,0,0,0,0,0,0,0
77510,4890,3865,783,1877,1037,168,1612,1574,408,271,1025,137,439,283,166,806,219
77511,14636,11313,2979,5718,2286,330,4736,4267,1417,893,3323,684,1136,1093,410,2798,525
77514,1936,1439,327,663,375,74,546,615,135,143,497,48,127,203,119,424,73
77515,9452,7190,1630,3651,1573,336,2857,2766,996,571,2262,436,800,592,434,1913,349
77517,1609,1276,196,776,246,58,494,628,98,56,333,22,144,115,52,276,57
77518,2556,1813,586,769,376,82,665,704,280,164,743,107,335,207,94,569,174
77519,520,426,103,182,105,36,162,206,10,48,94,9,0,66,19,94,0
77520,15783,11892,3134,5564,2444,750,4877,4369,1507,1139,3891,634,1278,1039,940,3369,522
77521,13817,10281,2828,4949,2072,432,3727,3773,1719,1062,3536,1072,1388,737,339,2963,573
77530,8529,6854,1961,3679,1067,147,3291,1912,873,778,1675,305,794,444,132,1376,299
77531,5243,3732,1275,1681,630,146,1457,1332,695,248,1511,500,595,319,97,1214,297
77532,7150,5652,1052,3035,1244,321,2056,2334,758,504,1498,188,564,491,255,1231,267
77533,370,288,70,142,58,18,120,103,40,25,82,17,19,27,19,69,13
77534,914,750,141,430,163,16,353,284,74,39,164,21,55,61,27,149,15
77535,8288,6707,1440,3590,1437,240,2799,2521,894,493,1581,260,581,491,249,1373,208
77536,9621,7922,1429,4593,1613,287,3404,3172,794,552,1699,269,748,471,211,1378,321
77538,284,230,47,102,61,20,70,119,16,25,54,9,20,21,4,52,2
77539,9797,7032,1595,3501,1551,385,2399,2863,1110,660,2765,601,1037,824,303,2241,524
77541,6397,4709,1368,2065,1045,231,1835,1649,732,493,1688,280,600,556,252,1447,241
77545,1936,1653,459,890,274,30,956,457,135,105,283,54,147,47,35,239,44
77546,13264,10690,1845,6427,2144,274,5300,3872,985,533,2574,576,1028,543,427,2142,432
77547,2702,2185,581,966,483,155,1122,585,220,258,517,43,189,138,147,429,88
77550,12367,6963,1755,3023,1566,619,1567,2353,1664,1379,5404,1478,1755,1365,806,4578,826
77551,8995,5391,1203,2343,1504,341,1539,2266,1038,548,3604,855,1133,991,625,3087,517
77553,0,0,0,0,0,0,0,0,0,0,0,0,0,0,0,0,0
77554,3656,2336,380,1194,664,98,631,1378,250,77,1320,373,481,332,134,1095,225
77560,385,274,22,159,93,0,88,106,36,44,111,13,55,15,28,105,6
77561,212,155,37,86,31,1,60,73,14,8,57,4,11,24,18,54,3
77562,3485,2686,466,1566,540,114,984,1130,367,205,799,111,318,242,128,651,148
77563,3469,2423,465,1060,710,188,590,1196,319,318,1046,134,323,388,201,878,168
77564,862,648,172,273,176,27,272,304,36,36,214,40,40,62,72,190,24
77565,2770,1656,308,959,319,70,523,742,254,137,1114,275,562,222,55,945,169
77566,10165,7914,1450,4415,1705,344,3586,3110,806,412,2251,487,757,522,485,1966,285
77568,5167,3639,781,1623,889,346,946,1427,665,601,1528,218,487,467,356,1323,205
77571,11560,9209,2105,5153,1749,202,4036,3568,955,650,2351,470,1085,598,198,1956,395
77573,14662,11534,2624,6734,1979,197,5475,4528,1053,478,3128,802,1470,554,302,2515,613
77575,5155,3835,843,1698,1002,292,1396,1547,487,405,1320,155,357,495,313,1190,130
77577,378,243,47,106,71,19,49,139,27,28,135,20,59,49,7,109,26
77578,1950,1547,233,849,416,49,569,777,112,89,403,28,213,80,82,337,66
77581,10918,8747,1815,4747,1822,363,3846,3445,848,608,2171,523,739,580,329,1844,327
77582,258,207,20,108,69,10,79,85,17,26,51,0,8,26,17,45,6
77583,3225,2587,575,1372,565,75,1085,946,325,231,638,80,354,134,70,502,136
77584,10398,8521,2248,4533,1464,276,4209,3354,569,389,1877,442,777,516,142,1500,377
77585,347,272,30,129,93,20,110,115,10,37,75,24,10,25,16,67,8
77586,7783,5151,932,2762,1309,148,2068,2256,488,339,2632,980,1068,481,103,2165,467
77587,4296,3458,1009,1693,656,100,1628,967,443,420,838,109,325,238,166,701,137
77590,11110,8130,1919,3907,1877,427,2715,3160,1289,966,2980,538,941,928,573,2547,433
77591,4037,2620,436,1162,747,275,599,1076,413,532,1417,263,386,457,311,1230,187
77597,307,237,48,97,63,29,93,109,5,30,70,6,42,4,18,49,21
77598,9130,4636,2090,2115,385,46,1777,1522,843,494,4494,2391,1600,406,97,3594,900
77611,3603,2784,532,1337,791,124,1001,1270,306,207,819,145,300,199,175,713,106
77612,2903,2251,505,1032,584,130,854,1015,166,216,652,83,161,266,142,614,38
77613,359,269,41,104,99,25,75,109,36,49,90,12,22,39,17,80,10
77614,474,353,90,131,127,5,114,174,35,30,121,22,42,52,5,96,25
77615,670,521,112,227,160,22,193,260,41,27,149,26,36,58,29,131,18
77616,522,397,112,169,95,21,183,149,37,28,125,16,23,41,45,125,0
77617,247,138,9,59,66,4,42,72,13,11,109,6,41,50,12,78,31
77619,6516,4769,1020,2170,1110,469,1683,2212,482,392,1747,237,520,525,465,1582,165
77622,528,395,86,175,134,0,154,190,30,21,133,30,26,41,36,116,17
77623,198,123,11,40,58,14,49,61,2,11,75,4,35,25,11,59,16
77624,285,219,27,128,62,2,61,98,32,28,66,17,7,28,14,54,12
77625,2883,2173,492,1059,467,155,820,979,209,165,710,73,263,221,153,640,70
77627,8553,6276,1273,2889,1654,460,2335,2731,749,461,2277,488,786,586,417,1977,300
77629,292,210,34,100,61,15,74,106,19,11,82,7,29,19,27,76,6
77630,11024,7831,1924,3331,2017,559,2427,3238,1312,854,3193,411,885,1118,779,2844,349
77632,7954,6289,1217,3262,1610,200,2443,2857,609,380,1665,232,580,585,268,1491,174
77640,7904,5366,861,2206,1709,590,1054,1912,1167,1233,2538,288,765,924,561,2307,231
77642,13671,9267,2317,4309,1817,824,3138,3196,1883,1050,4404,699,1184,1361,1160,4044,360
77650,1342,880,43,386,387,64,175,571,50,84,462,14,165,201,82,418,44
77651,5304,4066,701,1976,1123,266,1417,1883,425,341,1238,260,335,325,318,1125,113
77655,236,185,29,82,57,17,71,75,14,25,51,8,12,26,5,42,9
77656,6366,4736,1089,2136,1228,283,1617,1989,637,493,1630,257,484,580,309,1476,154
77657,5514,4421,1007,2234,973,207,1958,1770,489,204,1093,239,392,359,103,968,125
77659,1672,1295,228,644,327,96,524,563,113,95,377,40,108,135,94,342,35
77660,489,400,90,177,108,25,135,202,39,24,89,13,35,27,14,80,9
77662,9999,7727,1793,3630,1949,355,2964,3311,815,637,2272,394,711,801,366,1963,309
77663,497,411,27,81,229,74,75,318,8,10,86,0,24,28,34,80,6
77664,1075,839,140,335,302,62,290,428,45,76,236,41,58,91,46,219,17
77665,2422,1800,417,823,451,109,654,828,199,119,622,79,158,241,144,538,84
77701,5831,3763,880,1688,885,310,968,1055,896,844,2068,323,708,671,366,1810,258
77702,1241,733,180,369,140,44,223,241,134,135,508,120,192,111,85,416,92
77703,5855,3989,1014,1827,827,321,928,1155,1244,662,1866,240,525,562,539,1666,200
77705,10444,7324,1680,3257,1883,504,2111,2464,1530,1219,3120,736,1105,783,496,2693,427
77706,11833,7196,1268,3351,1867,710,2358,3642,674,522,4637,1393,1152,1045,1047,4050,587
77707,6236,4495,1052,2168,951,324,1754,1758,531,452,1741,260,464,654,363,1528,213
77708,4213,3062,821,1429,649,163,933,1114,743,272,1151,348,444,221,138,978,173
77713,3603,2692,484,1413,680,115,1096,1196,206,194,911,136,345,260,170,775,136
77801,5461,2594,1394,834,288,78,1020,755,493,326,2867,2061,467,201,138,1763,1104
77802,8476,5199,1377,2228,1218,376,1975,2351,496,377,3277,1465,615,526,671,2375,902
77803,8542,6263,2007,2749,1132,375,2166,1923,1337,837,2279,716,651,597,315,1780,499
77807,2434,1647,532,788,229,98,687,669,198,93,787,385,186,144,72,573,214
77808,2661,2140,442,1171,441,86,917,874,201,148,521,156,115,124,126,403,118
77830,964,640,108,281,202,49,227,310,56,47,324,35,68,158,63,297,27
77831,955,746,103,333,254,56,235,382,81,48,209,57,61,42,49,171,38
77833,9503,6695,1261,3131,1771,532,2362,2968,796,569,2808,471,640,910,787,2408,400
77835,831,568,64,223,211,70,176,319,23,50,263,17,80,98,68,249,14
77836,4102,3026,617,1370,802,237,1046,1435,298,247,1076,148,239,350,339,987,89
77837,742,491,94,191,143,63,109,187,87,108,251,21,43,102,85,236,15
77840,16914,5329,2521,1859,731,218,1677,2002,700,950,11585,10210,856,305,214,5305,6280
77845,10783,7601,1751,4125,1547,178,3600,3099,477,425,3182,2029,540,441,172,1898,1284
77853,416,288,55,98,107,28,97,135,18,38,128,16,39,34,39,116,12
77855,83,66,16,9,36,5,20,43,0,3,17,0,4,13,0,17,0
77856,1530,1120,189,464,369,98,364,556,101,99,410,48,100,149,113,366,44
77857,203,136,32,50,38,16,42,58,19,17,67,7,16,21,23,55,12
77859,2444,1741,382,802,476,81,497,646,348,250,703,107,132,202,262,677,26
77861,672,538,115,223,155,45,204,259,39,36,134,17,39,42,36,125,9
77864,2466,1786,386,755,459,186,536,753,322,175,680,115,138,213,214,596,84
77865,554,428,72,190,158,8,148,224,44,12,126,7,45,49,25,123,3
77866,39,32,22,0,0,10,11,10,11,0,7,0,0,7,0,7,0
77867,44,42,8,24,10,0,27,12,3,0,2,2,0,0,0,0,2
77868,4405,3212,720,1599,692,201,1204,1188,472,348,1193,160,365,310,358,1038,155
77870,96,76,11,30,32,3,26,45,0,5,20,0,15,0,5,20,0
77871,1391,1013,132,338,412,131,278,635,58,42,378,15,57,173,133,349,29
77872,699,513,73,239,150,51,170,270,24,49,186,11,37,78,60,177,9
77873,390,253,46,119,61,27,85,128,20,20,137,18,55,26,38,123,14
77876,182,151,11,110,14,16,56,37,14,44,31,0,0,16,15,22,9
77878,276,211,47,107,37,20,81,84,23,23,65,18,7,21,19,55,10
77879,1839,1254,211,576,377,90,335,640,166,113,585,46,165,185,189,510,75
77880,486,357,35,211,93,18,144,123,49,41,129,15,29,65,20,111,18
77882,114,68,6,24,32,6,24,44,0,0,46,0,26,11,9,35,11
77901,14569,10178,2785,4547,2088,758,3360,3688,1961,1169,4391,1002,1525,1099,765,3827,564
77904,8770,6752,1181,3411,1794,366,2694,3064,694,300,2018,610,444,487,477,1759,259
77905,4842,3945,726,1972,1052,195,1588,1887,261,209,897,103,305,327,162,775,122
77950,101,66,10,31,18,7,21,28,9,8,35,6,7,18,4,32,3
77951,765,620,164,294,140,22,309,187,51,73,145,4,56,46,39,131,14
77954,3830,2767,544,1212,787,224,836,1172,448,311,1063,148,244,323,348,972,91
77957,3259,2324,471,1092,576,185,892,945,288,199,935,133,234,282,286,869,66
77960,47,42,8,8,18,8,0,26,0,16,5,5,0,0,0,5,0
77961,62,41,0,6,22,13,6,17,18,0,21,0,0,21,0,21,0
77962,1176,909,185,430,218,76,341,415,77,76,267,23,68,84,92,258,9
77963,2096,1568,264,699,452,153,565,747,162,94,528,55,123,180,170,472,56
77964,3074,2163,281,915,708,259,717,1087,168,191,911,88,217,251,355,850,61
77968,770,630,115,310,181,24,328,241,26,35,140,40,58,30,12,117,23
77969,49,45,7,31,7,0,20,20,0,5,4,0,0,4,0,4,0
77970,163,128,29,65,21,13,38,68,13,9,35,0,10,21,4,32,3
77971,276,222,33,147,28,14,103,105,5,9,54,0,14,12,28,54,0
77973,22,13,0,7,6,0,7,6,0,0,9,9,0,0,0,9,0
77974,115,88,11,47,23,7,38,37,10,3,27,4,3,8,12,27,0
77975,751,509,65,224,159,61,197,264,20,28,242,12,37,56,137,221,21
77977,204,168,43,83,39,3,44,61,29,34,36,0,19,4,13,30,6
77978,290,227,91,68,54,14,95,94,30,8,63,12,12,18,21,59,4
77979,5961,4532,924,2037,1320,251,1587,1904,615,426,1429,246,517,405,261,1206,223
77982,516,356,23,153,155,25,77,211,21,47,160,15,55,52,38,148,12
77983,750,552,104,249,162,37,198,238,65,51,198,22,50,82,44,181,17
77984,1779,1276,190,559,357,170,440,645,115,76,503,43,74,212,174,493,10
77988,244,173,49,87,22,15,80,52,26,15,71,0,17,32,22,71,0
77990,326,258,36,129,67,26,97,109,30,22,68,9,16,23,20,65,3
77991,120,112,24,76,6,6,65,25,15,7,8,0,3,5,0,8,0
77994,176,111,12,43,45,11,42,54,4,11,65,4,23,24,14,56,9
77995,3498,2509,521,1084,644,260,907,1106,273,223,989,59,266,357,307,918,71
78001,11,5,0,5,0,0,0,5,0,0,6,0,0,6,0,6,0
78002,2081,1587,372,697,391,127,613,586,199,189,494,70,167,158,99,433,61
78003,3073,2188,258,1017,671,242,673,1142,229,144,885,132,241,349,163,766,119
78004,330,284,67,158,59,0,135,130,14,5,46,13,21,0,12,33,13
78005,198,148,31,42,64,11,47,82,11,8,50,3,8,19,20,50,0
78006,6911,5375,810,2764,1488,313,2100,2639,428,208,1536,223,409,548,356,1311,225
78007,73,48,4,24,18,2,13,25,4,6,25,3,8,9,5,25,0
78008,169,117,25,39,42,11,49,55,6,7,52,0,5,15,32,47,5
78009,2241,1847,320,996,426,105,784,795,157,111,394,58,120,154,62,365,29
78010,953,668,88,330,196,54,205,331,59,73,285,23,76,102,84,252,33
78011,634,489,113,217,113,46,204,171,68,46,145,21,32,49,43,121,24
78012,162,129,29,68,28,4,70,44,11,4,33,2,14,11,6,33,0
78013,1803,1359,234,588,454,83,524,614,92,129,444,83,175,122,64,365,79
78014,1461,1096,252,473,310,61,418,351,182,145,365,54,85,109,117,322,43
78015,1988,1832,42,958,726,106,678,1085,28,41,156,0,67,56,33,113,43
78016,3082,2432,546,1092,574,220,936,1027,274,195,650,81,147,261,161,601,49
78017,1253,973,230,413,240,90,344,376,161,92,280,25,99,104,52,264,16
78019,261,203,32,97,52,22,82,70,22,29,58,4,15,25,14,53,5
78021,45,40,0,19,11,10,12,20,0,8,5,0,5,0,0,5,0
78022,1743,1294,183,622,387,102,481,581,113,119,449,27,127,190,105,400,49
78023,2692,2233,332,1289,533,79,963,1050,113,107,459,55,182,173,49,375,84
78024,456,355,41,155,131,28,101,224,18,12,101,6,55,29,11,92,9
78025,1964,1435,215,603,477,140,424,787,121,103,529,56,141,164,168,452,77
78026,1725,1354,253,688,360,53,550,483,186,135,371,59,90,127,95,345,26
78027,136,112,11,49,39,13,26,71,6,9,24,0,6,6,12,24,0
78028,14028,9615,1363,3538,3226,1488,2444,5442,1021,708,4413,436,907,1510,1560,3977,436
78039,562,436,101,197,108,30,198,146,44,48,126,38,35,16,37,105,21
78040,11909,9581,2310,3718,2518,1035,3472,2761,1471,1877,2328,207,528,849,744,2170,158
78041,11163,9243,2078,4554,2182,429,3856,3007,1214,1166,1920,492,588,594,246,1753,167
78043,9383,8034,2277,3456,1765,536,3745,2188,1137,964,1349,321,432,391,205,1184,165
78045,7911,7215,1978,4266,841,130,4425,1792,578,420,696,302,246,109,39,595,101
78046,9607,9113,3202,4573,1129,209,5515,1712,1314,572,494,77,178,192,47,400,94
78050,213,153,36,65,45,7,63,54,19,17,60,7,18,28,7,53,7
78052,1718,1407,259,722,352,74,607,492,169,139,311,21,112,134,44,274,37
78053,37,23,4,0,8,11,0,19,4,0,14,0,9,5,0,9,5
78055,530,356,44,158,117,37,94,211,32,19,174,12,51,54,57,160,14
78056,370,258,56,142,47,13,105,138,7,8,112,10,28,44,30,112,0
78057,306,212,20,89,66,37,53,139,20,0,94,6,44,26,18,81,13
78058,192,134,15,64,55,0,33,83,12,6,58,4,14,35,5,55,3
78059,1622,1292,269,635,319,69,523,551,119,99,330,45,94,140,51,291,39
78061,3027,2359,571,1070,492,226,892,757,400,310,668,78,170,254,166,605,63
78063,2935,2202,258,1145,683,116,756,1165,198,83,733,112,231,241,149,585,148
78064,4411,3374,674,1728,791,181,1357,1327,404,286,1037,129,278,370,260,903,134
78065,2876,2316,534,1135,473,174,996,775,344,201,560,35,151,230,144,507,53
78066,156,156,0,115,23,18,114,42,0,0,0,0,0,0,0,0,0
78067,0,0,0,0,0,0,0,0,0,0,0,0,0,0,0,0,0
78069,1439,1136,278,531,304,23,430,470,142,94,303,57,94,83,69,250,53
78070,2605,2126,302,1231,538,55,891,1002,149,84,479,56,227,144,52,386,93
78071,1316,953,209,438,236,70,365,418,98,72,363,52,117,96,98,323,40
78072,259,174,18,76,65,15,54,100,11,9,85,0,25,27,33,83,2
78073,2050,1714,385,749,511,69,615,662,241,196,336,57,153,96,30,285,51
78074,17,8,0,0,8,0,0,8,0,0,9,0,9,0,0,9,0
78075,45,45,10,5,19,11,8,30,7,0,0,0,0,0,0,0,0
78076,3912,3179,642,1384,912,241,1349,1162,347,321,733,59,129,309,236,685,48
78101,2164,1833,293,1022,442,76,772,760,186,115,331,36,138,104,53,295,36
78102,7789,5650,1211,2597,1444,398,1947,2022,1074,607,2139,377,654,684,424,1849,290
78107,114,67,6,34,27,0,20,47,0,0,47,0,15,16,16,37,10
78108,3289,2607,407,1467,564,169,1170,1128,167,142,682,144,252,218,68,551,131
78109,7586,6359,1552,3774,921,112,2942,2271,832,314,1227,275,521,315,116,952,275
78112,1903,1616,503,772,304,37,783,500,220,113,287,49,136,87,15,192,95
78113,753,539,86,239,163,51,214,253,34,38,214,17,35,75,87,187,27
78114,5651,4568,840,2195,1254,279,1751,1984,410,423,1083,134,365,321,263,953,130
78116,102,63,2,33,21,7,15,40,0,8,39,0,12,23,4,39,0
78117,204,175,32,73,53,17,78,79,14,4,29,5,10,0,14,26,3
78118,1407,1006,180,448,266,112,312,385,156,153,401,42,92,150,117,359,42
78119,1769,1298,317,558,304,119,412,512,243,131,471,25,115,202,129,428,43
78121,2471,2014,370,1076,470,98,889,798,169,158,457,66,151,165,75,392,65
78122,185,150,31,74,25,20,54,79,0,17,35,0,8,18,9,20,15
78123,923,680,97,315,222,46,197,349,51,83,243,30,89,84,40,207,36
78124,1555,1239,172,620,355,92,459,555,141,84,316,47,102,130,37,282,34
78125,23,13,0,11,2,0,5,8,0,0,10,0,0,10,0,10,0
78130,16054,11781,2662,5330,2832,957,4273,5041,1449,1018,4273,771,1218,1075,1209,3699,574
78132,3898,3099,412,1696,809,182,1314,1403,222,160,799,137,241,274,147,620,179
78133,5612,4079,514,1735,1441,389,995,2412,427,245,1533,190,550,559,234,1276,257
78140,1100,829,202,337,250,40,273,277,161,118,271,36,58,112,65,253,18
78141,244,182,16,83,63,20,59,113,8,2,62,7,13,12,30,56,6
78142,106,70,12,27,25,6,17,50,2,1,36,4,12,10,10,36,0
78143,38,23,0,16,5,2,10,7,6,0,15,0,6,9,0,15,0
78144,11,6,0,6,0,0,6,0,0,0,5,5,0,0,0,5,0
78145,24,18,2,13,3,0,15,3,0,0,6,0,0,0,6,6,0
78146,239,172,31,76,54,11,50,73,38,11,67,11,14,26,16,66,1
78147,622,496,105,259,96,36,225,166,59,46,126,9,33,55,29,119,7
78148,7125,5171,1133,2552,1262,224,1929,2300,641,301,1954,647,662,464,181,1686,268
78151,554,411,69,171,113,58,113,182,62,54,143,14,40,49,40,132,11
78152,801,660,86,354,192,28,271,338,23,28,141,11,63,31,36,104,37
78154,6226,5018,940,2731,1112,235,1955,2231,535,297,1208,172,564,352,120,1050,158
78155,13887,10392,2222,4884,2551,735,3632,4296,1383,1081,3495,520,1046,1086,843,2982,513
78159,406,282,56,104,82,40,78,148,35,21,124,7,10,49,58,120,4
78160,1281,968,167,461,289,51,394,431,73,70,313,20,64,138,91,276,37
78161,136,106,11,66,29,0,28,29,34,15,30,7,14,0,9,23,7
78163,2678,2215,258,1253,564,140,881,1139,129,66,463,77,177,140,69,379,84
78164,1613,1097,142,478,342,135,332,570,119,76,516,73,71,191,181,477,39
78201,16721,11150,2795,4762,2568,1025,3485,3784,1947,1934,5571,998,2111,1455,1007,4679,892
78202,3987,2614,706,1010,513,385,728,617,616,653,1373,168,364,482,359,1242,131
78203,2022,1398,302,658,270,168,326,397,355,320,624,105,129,225,165,502,122
78204,3730,2725,526,1141,712,346,927,844,369,585,1005,174,250,281,300,872,133
78205,1011,135,13,48,54,20,4,97,17,17,876,169,247,295,165,795,81
78207,15557,11863,3010,4785,2832,1236,3709,3038,2414,2702,3694,401,925,1535,833,3183,511
78208,1781,1247,413,481,270,83,259,293,472,223,534,104,212,151,67,396,138
78209,18109,10027,2076,4658,2028,1265,3414,4314,1415,884,8082,1738,2665,1803,1876,7066,1016
78210,12357,8760,1950,3768,2119,923,2699,2898,1463,1700,3597,521,1043,1247,786,3049,548
78211,8681,7339,1616,3058,2057,608,2515,2203,1152,1469,1342,121,376,459,386,1170,172
78212,12159,6393,1546,2929,1282,636,2094,2334,960,1005,5766,1656,1942,1301,867,4835,931
78213,16184,9884,2855,4153,2047,829,3211,3867,1643,1163,6300,2232,1875,1331,862,5114,1186
78214,7607,5890,1343,2579,1576,392,1833,1909,1177,971,1717,200,479,618,420,1515,202
78215,548,198,41,75,47,35,27,62,50,59,350,126,178,46,0,299,51
78216,17318,9433,2559,4006,2120,748,2891,3936,1481,1125,7885,2759,2720,1505,901,6715,1170
78217,13905,8420,2356,3714,1864,486,2573,3496,1565,786,5485,1791,1956,1127,611,4386,1099
78218,11138,7185,2168,2907,1688,422,2312,2540,1413,920,3953,991,1275,1179,508,3411,542
78219,4990,3744,725,1772,1018,229,1019,1410,739,576,1246,107,436,516,187,1067,179
78220,5979,4291,757,1694,1408,432,796,1418,1017,1060,1688,120,475,653,440,1531,157
78221,11229,9119,2403,3830,2407,479,3168,2930,1738,1283,2110,224,636,790,460,1827,283
78222,5130,3902,901,1923,884,194,1255,1363,723,561,1228,127,495,402,204,1060,168
78223,15208,10853,2866,5015,2328,644,3769,3541,2115,1428,4355,655,1422,1417,861,3776,579
78224,3946,3371,924,1490,808,149,1291,1144,540,396,575,89,227,216,43,489,86
78225,4318,3398,620,1455,992,331,1066,1183,516,633,920,70,243,261,346,799,121
78226,2753,2262,760,900,461,141,828,567,539,328,491,52,202,156,81,433,58
78227,12652,9964,2572,4292,2586,514,3359,3265,2076,1264,2688,462,721,1126,379,2232,456
78228,18280,14247,3266,6265,3669,1047,4622,5025,2674,1926,4033,704,1142,1171,1016,3441,592
78229,13015,5871,2475,2227,839,330,1681,1976,1217,997,7144,3883,1788,971,502,5722,1422
78230,15316,9658,1931,4384,2630,713,3183,4389,1196,890,5658,2277,1659,1202,520,4657,1001
78231,2949,2075,313,1073,547,142,809,905,192,169,874,334,207,243,90,697,177
78232,13843,9420,1530,4873,2563,454,3368,4491,889,672,4423,1458,1546,906,513,3656,767
78233,13125,9768,2195,4961,2238,374,3682,3805,1363,918,3357,779,1329,912,337,2665,692
78234,930,909,358,542,9,0,634,135,131,9,21,6,10,5,0,13,8
78235,168,168,54,114,0,0,128,29,11,0,0,0,0,0,0,0,0
78236,275,259,140,119,0,0,188,35,32,4,16,8,8,0,0,14,2
78237,10194,8339,1816,3281,2444,798,2647,2513,1404,1775,1855,160,436,773,486,1629,226
78238,7571,5073,1315,2294,1223,241,1614,2013,857,589,2498,751,836,567,344,2063,435
78239,8924,6861,1346,2911,1822,782,2007,3087,1050,717,2063,202,586,728,547,1801,262
78240,19356,10895,3673,5008,1687,527,3687,4042,1924,1242,8461,4074,2505,1153,729,6536,1925
78242,8022,6606,2235,3033,1236,102,2801,1740,1351,714,1416,357,486,473,100,1164,252
78244,5555,4709,1166,2821,676,46,2044,1421,881,363,846,110,494,208,34,680,166
78245,9970,7970,2194,4113,1403,260,3534,2556,1213,667,2000,548,810,436,206,1552,448
78247,13990,11060,2845,6272,1744,199,5092,3980,1231,757,2930,583,1529,637,181,2304,626
78248,5087,3775,490,2425,775,85,1856,1476,292,151,1312,557,573,158,24,1108,204
78249,12350,9039,2105,5096,1576,262,4002,3357,1030,650,3311,1381,1208,613,109,2330,981
78250,21541,17988,4658,10685,2358,287,9184,5477,2154,1173,3553,798,1788,747,220,2702,851
78251,9390,6757,2275,3442,986,54,3029,2252,949,527,2633,1221,1042,332,38,1999,634
78252,593,473,83,214,176,0,200,153,44,76,120,12,22,33,53,96,24
78253,3276,2834,530,1658,598,48,1321,1181,251,81,442,93,218,63,68,360,82
78254,465,410,45,213,137,15,169,219,7,15,55,8,7,34,6,47,8
78255,1140,921,52,539,293,37,384,459,18,60,219,9,89,65,56,184,35
78256,1613,818,224,452,142,0,350,338,56,74,795,579,127,89,0,469,326
78257,916,704,85,330,265,24,255,419,30,0,212,36,70,68,38,189,23
78258,5877,4967,720,3302,817,128,2819,1842,194,112,910,277,281,118,234,767,143
78259,2960,2700,399,1756,492,53,1459,1055,165,21,260,30,120,84,26,237,23
78260,947,773,101,419,235,18,344,389,20,20,174,20,76,55,23,153,21
78261,370,334,23,247,58,6,183,127,11,13,36,0,18,12,6,36,0
78263,1459,1185,164,683,262,76,594,486,38,67,274,35,96,74,69,238,36
78264,2282,1838,485,790,508,55,782,667,187,202,444,30,149,168,97,342,102
78266,1197,1049,41,496,472,40,366,631,31,21,148,36,43,31,38,116,32
78330,319,272,58,115,83,16,118,98,27,29,47,4,8,24,11,38,9
78332,9280,7333,1678,3249,1959,447,2766,2808,958,801,1947,233,633,675,406,1778,169
78336,4419,3261,713,1435,941,172,1178,1296,437,350,1158,210,339,423,186,934,224
78338,23,20,5,3,9,3,3,8,1,8,3,0,3,0,0,3,0
78339,264,240,66,91,80,3,89,78,49,24,24,8,4,4,8,21,3
78340,141,92,10,49,28,5,32,51,5,4,49,5,13,22,9,44,5
78343,1606,1248,213,579,349,107,476,501,131,140,358,42,94,118,104,323,35
78344,173,141,29,59,36,17,76,48,12,5,32,9,10,4,9,25,7
78347,31,23,5,7,11,0,7,16,0,0,8,0,0,2,6,8,0
78349,133,108,13,44,43,8,35,53,17,3,25,2,3,12,8,25,0
78351,248,211,23,113,66,9,98,68,14,31,37,0,14,15,8,33,4
78352,22,22,4,5,0,13,9,7,0,6,0,0,0,0,0,0,0
78353,223,164,21,64,62,17,42,81,6,35,59,7,20,13,19,52,7
78355,2586,2011,422,879,549,161,637,677,436,261,575,57,121,222,175,542,33
78357,1036,759,156,347,197,59,277,278,130,74,277,32,104,79,62,227,50
78358,507,342,26,137,132,47,66,217,29,30,165,15,49,76,25,138,27
78359,675,573,100,266,154,53,218,197,83,75,102,10,37,40,15,93,9
78361,1816,1381,298,599,332,152,597,466,166,152,435,33,96,152,154,421,14
78362,3325,2465,728,1220,435,82,1145,867,273,180,860,200,351,204,105,715,145
78363,10333,7378,2116,3130,1642,490,2629,2739,1125,885,2955,1089,679,683,504,2312,643
78364,91,72,6,25,33,8,10,48,7,7,19,0,2,11,6,16,3
78368,3465,2684,460,1142,864,218,853,1156,389,286,781,51,152,321,257,717,64
78369,216,158,21,70,55,12,78,57,15,8,58,7,21,20,10,54,4
78370,1538,1263,244,628,323,68,477,486,142,158,275,16,107,100,52,261,14
78371,123,108,24,44,26,14,45,37,13,13,15,7,0,5,3,13,2
78372,1569,1222,265,601,297,59,544,482,97,99,347,19,92,153,83,320,27
78373,1581,1035,121,474,371,69,266,608,99,62,546,73,238,176,59,460,86
78374,5282,4261,1021,2193,951,96,2075,1611,384,191,1021,264,279,314,164,868,153
78375,1225,937,132,380,337,88,331,417,109,80,288,35,59,109,85,270,18
78376,43,27,0,11,13,3,5,16,2,4,16,0,6,5,5,16,0
78377,1468,1083,191,477,298,117,321,489,140,133,385,48,92,119,126,354,31
78379,488,373,55,142,148,28,108,171,35,59,115,12,35,24,44,101,14
78380,6886,5728,1078,2712,1535,403,2049,2101,839,739,1158,77,356,492,233,1028,130
78382,7495,5268,770,2083,1895,520,1396,2807,653,412,2227,181,648,881,517,1904,323
78383,1200,883,103,373,342,65,258,484,63,78,317,27,125,72,93,251,66
78384,3413,2575,527,1099,684,265,914,917,335,409,838,71,218,323,226,793,45
78385,103,83,22,35,16,10,28,26,14,15,20,0,7,13,0,19,1
78387,3191,2474,572,1155,530,217,889,940,392,253,717,52,192,291,182,632,85
78389,662,510,112,206,148,44,205,214,56,35,152,18,41,60,33,144,8
78390,1941,1582,326,727,412,117,599,599,191,193,359,11,75,176,97,344,15
78391,114,94,11,39,37,7,21,48,10,15,20,0,8,7,5,16,4
78393,976,713,116,331,204,62,242,316,66,89,263,33,81,105,44,235,28
78401,1861,861,204,400,175,82,234,205,223,199,1000,120,309,281,290,900,100
78402,244,105,11,43,30,21,9,79,17,0,139,38,25,61,15,98,41
78404,6353,4097,938,1838,983,338,1090,1379,826,802,2256,469,996,520,271,1844,412
78405,5135,3858,858,1622,998,380,1154,1101,820,783,1277,187,281,446,363,1119,158
78406,265,235,56,119,37,23,97,78,17,43,30,5,10,0,15,21,9
78407,1258,998,194,438,274,92,279,269,236,214,260,22,90,91,57,228,32
78408,3572,2538,670,1124,546,198,772,747,551,468,1034,124,351,353,206,827,207
78409,833,646,146,341,130,29,252,220,97,77,187,41,44,58,44,142,45
78410,8141,6554,1409,3667,1311,167,2671,2513,967,403,1587,271,493,558,265,1316,271
78411,10560,7544,1397,3523,1998,626,2401,2991,1157,995,3016,595,1033,802,586,2553,463
78412,13385,8862,1957,4186,2076,643,2859,3518,1410,1075,4523,1282,1359,1172,710,3663,860
78413,13172,9157,2039,5146,1677,295,3837,3491,1196,633,4015,1443,1351,872,349,3211,804
78414,5941,4110,1134,2303,544,129,1918,1593,416,183,1831,609,637,292,293,1516,315
78415,12557,9657,2219,4714,2172,552,3262,3131,1857,1407,2900,607,1037,860,396,2398,502
78416,4991,4057,708,1671,1293,385,1135,1558,623,741,934,76,231,387,240,808,126
78417,905,775,170,406,133,66,329,236,113,97,130,4,63,43,20,115,15
78418,10013,7085,1536,3587,1707,255,2581,3096,890,518,2928,765,1116,853,194,2238,690
78501,18677,14304,3463,6252,3444,1145,5356,4911,2139,1898,4373,974,1142,1294,963,3736,637
78503,4545,3882,731,1860,1047,244,1723,1298,413,448,663,178,160,129,196,593,70
78504,10553,8440,1815,4823,1486,316,4275,2720,816,629,2113,792,738,412,171,1716,397
78516,7151,6125,1426,2490,1436,773,2621,2284,741,479,1026,99,193,375,359,907,119
78520,13885,11149,2408,5043,2791,907,4419,3186,1632,1912,2736,303,573,987,873,2465,271
78521,22196,19315,4791,9234,4294,996,8685,5281,3066,2283,2881,469,717,1105,590,2515,366
78526,6752,6066,1797,3069,983,217,3404,1509,782,371,686,108,254,212,112,543,143
78537,8290,7247,1718,2935,1822,772,3133,2495,846,773,1043,85,159,489,310,931,112
78538,2014,1773,469,779,417,108,860,477,191,245,241,36,64,97,44,224,17
78539,23305,19798,5759,9435,3785,819,9598,5468,2691,2041,3507,941,1031,956,579,2777,730
78543,2030,1724,404,728,430,162,766,448,216,294,306,23,30,137,116,289,17
78545,23,15,6,9,0,0,6,9,0,0,8,0,8,0,0,8,0
78547,336,290,45,172,73,0,146,120,17,7,46,10,18,9,9,46,0
78548,472,394,81,166,119,28,181,106,44,63,78,1,18,31,28,69,9
78549,245,198,44,84,56,14,66,79,35,18,47,0,12,16,19,47,0
78550,16568,12583,2979,5667,2770,1167,5024,4272,1793,1494,3985,713,1072,1235,965,3496,489
78552,9604,7910,1386,3379,2265,880,3034,3566,721,589,1694,125,378,647,544,1478,216
78557,1850,1703,468,833,331,71,898,344,255,206,147,10,24,60,53,135,12
78558,577,535,178,229,118,10,351,111,33,40,42,20,0,15,7,22,20
78559,2938,2381,371,1092,698,220,842,1002,275,262,557,33,85,232,207,504,53
78560,981,895,191,416,256,32,414,232,95,154,86,5,9,44,28,86,0
78562,484,451,89,222,113,27,232,107,41,71,33,2,10,10,11,33,0
78563,108,58,27,13,18,0,32,21,0,5,50,8,5,26,11,42,8
78565,171,112,9,48,34,21,27,33,20,32,59,0,29,9,21,59,0
78566,3293,2815,713,1389,568,145,1323,816,424,252,478,20,141,177,140,442,36
78569,1574,1267,228,616,352,71,510,456,141,160,307,18,41,155,93,294,13
78570,7703,6575,1674,2847,1622,432,3006,1932,959,678,1128,89,270,474,295,999,129
78572,30725,26962,7203,12400,5317,2042,13619,8252,3047,2044,3763,490,899,1278,1096,3337,426
78575,1209,952,153,469,231,99,407,391,71,83,257,45,77,91,44,235,22
78576,899,811,289,349,148,25,524,164,83,40,88,11,19,48,10,71,17
78577,12988,11172,2864,4390,2937,981,4904,3814,1244,1210,1816,212,400,622,582,1671,145
78578,3386,2627,645,1041,748,193,969,1026,381,251,759,102,240,283,134,662,97
78579,742,700,181,335,139,45,378,172,83,67,42,4,17,13,8,38,4
78580,3753,3098,602,1402,772,322,1307,1053,371,367,655,67,106,248,234,590,65
78582,8827,7763,1986,3522,1870,385,3957,2030,894,882,1064,87,234,523,220,1016,48
78583,1614,1310,197,594,403,116,469,587,147,107,304,39,65,149,51,276,28
78584,4662,4160,1059,1854,1045,202,1897,1159,694,410,502,53,72,208,169,469,33
78586,12729,10852,2382,4712,2883,875,4650,3545,1363,1294,1877,169,399,716,593,1687,190
78588,58,53,2,27,21,3,21,23,0,9,5,2,0,3,0,5,0
78589,7242,6513,1722,3135,1339,317,3307,1812,816,578,729,106,132,281,210,624,105
78592,431,383,78,170,109,26,188,119,27,49,48,4,9,21,14,39,9
78593,1171,1017,263,439,224,91,438,307,156,116,154,23,45,66,20,133,21
78594,135,124,10,68,33,13,58,38,15,13,11,5,0,6,0,11,0
78595,1258,1209,431,534,211,33,667,295,172,75,49,0,0,33,16,46,3
78596,14099,11947,2651,5365,2955,976,5295,3786,1623,1243,2152,283,387,739,743,1932,220
78597,1395,831,88,245,443,55,140,586,60,45,564,133,224,168,39,448,116
78598,176,132,6,32,70,24,13,100,5,14,44,3,11,17,13,35,9
78602,6304,4570,1023,2338,940,269,1632,1962,584,392,1734,337,603,532,262,1436,298
78605,1365,1051,186,539,295,31,376,552,46,77,314,38,95,104,77,252,62
78606,1600,1172,211,537,313,111,389,564,146,73,428,53,119,146,110,383,45
78607,112,67,0,14,40,13,0,53,14,0,45,0,0,16,29,45,0
78608,109,104,21,50,28,5,54,45,0,5,5,0,0,5,0,5,0
78609,1120,766,64,212,381,109,88,619,21,38,354,28,64,107,155,315,39
78610,4373,3709,676,2212,692,129,1787,1320,361,241,664,81,344,183,56,545,119
78611,4053,2945,425,1256,971,293,880,1591,300,174,1108,147,243,372,346,947,161
78612,2902,2279,446,1292,480,61,825,983,296,175,623,110,272,183,58,456,167
78613,11404,9555,2858,5512,1051,134,5200,3039,925,391,1849,570,792,375,112,1356,493
78614,158,122,15,64,26,17,63,50,0,9,36,8,4,8,16,28,8
78615,428,321,55,169,75,22,157,116,39,9,107,3,38,37,29,101,6
78616,1496,1165,211,631,282,41,444,510,131,80,331,31,150,114,36,272,59
78617,4108,3212,1145,1411,567,89,1354,1017,456,385,896,191,408,245,52,682,214
78618,99,81,9,23,42,7,20,58,3,0,18,0,4,10,4,16,2
78619,593,448,46,271,115,16,192,219,29,8,145,48,40,33,24,123,22
78620,3318,2690,315,1764,517,94,1298,1081,225,86,628,50,297,197,84,472,156
78621,5455,4132,804,2127,974,227,1536,1781,537,278,1323,160,520,460,183,1071,252
78622,133,115,26,43,36,10,44,51,10,10,18,3,0,7,8,13,5
78623,86,79,0,48,21,10,12,67,0,0,7,0,0,0,7,7,0
78624,7461,5250,680,2049,1773,748,1635,2934,351,330,2211,169,602,784,656,1999,212
78626,6174,4500,1312,2104,888,196,1943,1672,494,391,1674,388,525,407,354,1394,280
78628,9941,8204,900,3846,2822,636,2793,4531,528,352,1737,264,444,722,307,1513,224
78629,4135,2965,683,1223,837,222,1114,1230,379,242,1170,100,315,335,420,1065,105
78631,719,521,77,218,188,38,174,287,26,34,198,10,51,80,57,187,11
78632,260,199,0,79,96,24,57,123,8,11,61,2,19,27,13,54,7
78634,1286,1120,241,706,141,32,519,422,120,59,166,31,68,33,34,129,37
78635,43,28,8,4,9,7,12,16,0,0,15,0,15,0,0,15,0
78636,1255,914,141,420,294,59,308,482,69,55,341,27,118,112,84,301,40
78638,687,525,42,270,140,73,186,281,24,34,162,7,42,67,46,135,27
78639,2502,1676,179,536,676,285,383,1059,75,159,826,46,189,267,324,740,86
78640,4632,3815,1163,2006,537,109,1859,1260,452,244,817,149,430,176,62,592,225
78641,6437,5171,1249,2937,883,102,2478,1941,551,201,1266,264,620,230,152,941,325
78642,2042,1659,265,891,446,57,762,697,101,99,383,16,151,125,91,331,52
78643,2470,1743,231,726,616,170,517,1001,152,73,727,72,210,261,184,657,70
78644,4880,3718,802,1844,806,266,1384,1460,501,373,1162,202,382,294,284,987,175
78645,3189,2190,361,1067,583,179,676,1181,188,145,999,127,366,315,191,804,195
78648,2600,1840,413,804,416,207,644,700,236,260,760,116,168,270,206,685,75
78650,410,300,53,178,57,12,122,131,29,18,110,7,62,25,16,92,18
78652,1083,905,146,529,202,28,330,405,102,68,178,50,93,29,6,100,78
78653,1646,1287,206,631,372,78,500,561,72,154,359,38,203,85,33,257,102
78654,7287,5330,796,2245,1855,434,1523,3004,533,270,1957,296,548,620,493,1675,282
78655,797,609,88,335,155,31,202,300,57,50,188,61,66,43,18,155,33
78656,740,567,150,321,60,36,264,191,84,28,173,39,82,36,16,120,53
78657,542,396,28,81,213,74,50,332,14,0,146,12,50,72,12,127,19
78658,27,10,0,10,0,0,0,10,0,0,17,0,11,0,6,17,0
78659,1097,818,178,440,179,21,325,371,54,68,279,57,113,91,18,260,19
78660,11030,9170,2602,5541,908,119,4975,2499,1137,559,1860,565,855,321,119,1313,547
78661,105,81,7,33,35,6,27,41,4,9,24,1,9,9,5,21,3
78662,789,503,104,246,134,19,230,197,38,38,286,54,89,62,81,231,55
78663,164,126,12,65,40,9,44,66,10,6,38,0,7,10,21,32,6
78664,15864,11890,3993,6508,1196,193,6152,3662,1419,657,3974,1546,1570,523,335,2979,995
78666,17708,9674,2723,4500,1926,525,3483,3696,1312,1183,8034,5369,1462,700,503,4589,3445
78669,2221,1620,221,857,441,101,540,893,122,65,601,86,336,143,36,456,145
78670,22,0,0,0,0,0,0,0,0,0,22,3,11,8,0,19,3
78671,263,193,29,62,71,31,47,92,33,21,70,11,28,31,0,65,5
78672,570,351,22,104,153,72,32,273,17,29,219,13,43,102,61,187,32
78675,52,52,7,6,35,4,13,35,4,0,0,0,0,0,0,0,0
78676,3768,2739,280,1296,919,244,822,1527,267,123,1029,117,339,385,188,870,159
78681,10494,8966,2067,5336,1426,137,4736,2965,887,378,1528,399,766,281,82,1171,357
78701,1707,377,84,120,120,53,63,258,16,40,1330,666,413,141,110,1028,302
78702,7289,4838,1231,2109,1054,444,1388,1122,1075,1253,2451,471,576,791,613,1996,455
78703,9565,4572,1265,2177,835,295,1701,2188,337,346,4993,2204,1769,575,445,3911,1082
78704,20753,8585,3305,3672,1268,340,2180,3189,1956,1260,12168,6004,4659,1010,495,8729,3439
78705,9937,1419,857,432,106,24,366,624,74,355,8518,7303,921,208,86,5128,3390
78717,2680,2216,561,1416,202,37,1401,678,99,38,464,186,229,42,7,363,101
78719,527,422,102,227,93,0,195,138,53,36,105,23,37,36,9,98,7
78721,3104,2280,573,860,621,226,635,515,473,657,824,86,312,267,159,678,146
78722,2830,1125,392,447,170,116,335,395,157,238,1705,910,513,142,140,1044,661
78723,10513,6630,2206,2899,1206,319,2027,1976,1437,1190,3883,1494,1324,755,310,2678,1205
78724,3843,3190,1138,1562,432,58,1184,744,771,491,653,69,395,158,31,493,160
78725,721,509,132,262,93,22,203,130,85,91,212,24,157,31,0,171,41
78726,2246,1834,350,1290,164,30,1076,570,138,50,412,195,195,15,7,322,90
78727,9446,5663,1559,3240,780,84,2106,2405,719,433,3783,2034,1290,345,114,2749,1034
78728,7978,4143,1831,1982,216,114,1656,1529,561,397,3835,2225,1213,345,52,2919,916
78729,9970,6135,1763,3650,640,82,2876,2252,604,403,3835,1849,1384,390,212,2811,1024
78730,1929,1384,127,979,265,13,649,678,41,16,545,345,133,56,11,434,111
78731,11707,5967,969,2795,1545,658,1797,3328,372,470,5740,2941,1453,824,522,4244,1496
78732,1457,1082,303,663,98,18,538,445,52,47,375,101,194,74,6,238,137
78733,2949,2422,369,1766,275,12,1503,682,170,67,527,98,276,127,26,396,131
78734,5001,3752,372,2049,1047,284,1373,1957,247,175,1249,214,648,235,152,951,298
78735,4228,2572,655,1325,491,101,969,1317,136,150,1656,797,616,138,105,1235,421
78736,2576,1962,361,1225,325,51,839,804,203,116,614,130,273,163,48,454,160
78737,2487,2120,195,1368,490,67,974,981,93,72,367,6,229,87,45,266,101
78738,1107,892,61,432,345,54,327,485,49,31,215,26,67,79,43,202,13
78739,2650,2405,256,1702,435,12,1429,829,112,35,245,45,162,31,7,167,78
78741,17118,6780,3529,2483,649,119,1744,1874,1504,1658,10338,7938,1814,477,109,5942,4396
78742,185,150,61,56,26,7,63,54,29,4,35,5,26,4,0,22,13
78744,10125,7403,2724,3763,886,30,3384,1603,1474,942,2722,1213,1020,371,118,1886,836
78745,20558,12669,3588,6128,2405,548,4533,4583,1943,1610,7889,2793,3227,1285,584,5534,2355
78746,9876,6922,461,4765,1463,233,3411,2706,608,197,2954,1262,1009,422,261,2335,619
78747,1900,1437,275,559,498,105,350,852,113,122,463,36,186,174,67,352,111
78748,9189,6846,2115,3771,835,125,3054,2374,978,440,2343,783,1004,456,100,1696,647
78749,10749,7548,2104,4494,869,81,3721,2760,657,410,3201,1538,1071,467,125,2259,942
78750,8854,6679,1150,3874,1441,214,2869,2745,634,431,2175,559,978,397,241,1725,450
78751,7322,2108,981,876,141,110,543,907,229,429,5214,3351,1385,313,165,3354,1860
78752,6736,3440,1515,1311,445,169,1040,1070,705,625,3296,1879,840,252,325,2270,1026
78753,16436,10138,4328,4154,1423,233,3486,3055,2379,1218,6298,2574,2713,721,290,4753,1545
78754,2416,1451,489,609,287,66,479,684,164,124,965,430,410,101,24,808,157
78756,4040,1409,364,774,153,118,436,573,234,166,2631,1107,877,318,329,2064,567
78757,9969,5137,1264,2332,1064,477,1418,2383,677,659,4832,1693,1637,815,687,3569,1263
78758,18179,9415,3798,4221,1192,204,3060,3079,1623,1653,8764,4972,2659,826,307,6285,2479
78759,19507,9644,2261,5059,1863,461,3502,4766,746,630,9863,5051,3109,1114,589,7614,2249
78801,7012,5539,1271,2445,1347,476,2302,2064,712,461,1473,266,352,475,380,1347,126
78827,471,365,82,131,99,53,141,125,40,59,106,9,23,41,33,90,16
78828,191,138,4,55,60,19,33,89,7,9,53,2,15,25,11,50,3
78829,391,353,89,182,55,27,144,92,56,61,38,0,0,23,15,33,5
78830,271,207,27,77,77,26,46,100,28,33,64,0,14,33,17,62,2
78832,1268,901,138,323,325,115,299,460,70,72,367,25,63,171,108,341,26
78833,575,421,60,139,186,36,104,234,54,29,154,16,45,58,35,147,7
78834,2420,1975,467,825,538,145,808,619,318,230,445,50,97,136,162,405,40
78836,40,40,0,18,15,7,15,18,0,7,0,0,0,0,0,0,0
78837,183,131,19,78,30,4,60,43,21,7,52,12,15,15,10,52,0
78838,64,47,3,17,21,6,11,34,0,2,17,0,7,5,5,15,2
78839,2490,2007,489,785,553,180,779,604,346,278,483,27,128,184,144,430,53
78840,13899,11203,2647,4881,3061,614,5011,4027,1140,1025,2696,438,679,982,597,2399,297
78850,419,333,42,149,100,42,106,164,33,30,86,15,23,25,23,76,10
78851,19,13,0,11,2,0,7,4,2,0,6,0,0,6,0,6,0
78852,12721,10954,2486,5071,2716,681,5382,3209,1234,1129,1767,211,386,697,473,1656,111
78860,72,72,17,23,32,0,27,28,17,0,0,0,0,0,0,0,0
78861,3491,2747,569,1153,767,258,1007,1225,294,221,744,84,216,252,192,634,110
78870,267,210,58,97,46,9,102,69,22,17,57,8,8,27,14,56,1
78872,545,418,94,184,111,29,176,145,37,60,127,13,17,56,41,119,8
78873,634,434,46,168,165,55,122,257,27,28,200,15,31,90,64,191,9
78877,276,231,54,75,90,12,123,91,8,9,45,0,30,7,8,45,0
78879,86,52,6,14,28,4,15,33,4,0,34,0,9,10,15,31,3
78880,580,430,64,203,140,23,144,208,53,25,150,14,39,54,43,137,13
78881,784,584,103,238,186,57,210,261,79,34,200,12,78,51,59,181,19
78883,119,97,2,37,55,3,24,66,5,2,22,0,3,12,7,20,2
78884,546,407,43,153,172,39,114,224,16,53,139,6,26,53,54,129,10
78885,97,68,6,21,37,4,21,47,0,0,29,4,1,18,6,28,1
78886,206,155,30,64,50,11,85,70,0,0,51,5,14,10,22,51,0
78932,198,145,11,63,42,29,53,85,5,2,53,0,10,20,23,50,3
78933,310,221,56,96,57,12,115,100,6,0,89,7,5,23,54,89,0
78934,2578,1764,270,812,552,130,587,879,145,153,814,98,179,285,252,729,85
78935,178,161,23,77,51,10,87,44,7,23,17,0,0,6,11,17,0
78938,156,103,19,54,28,2,32,59,5,7,53,4,19,14,16,53,0
78940,783,546,59,220,203,64,165,306,33,42,237,22,50,68,97,216,21
78941,848,607,116,277,159,55,253,234,59,61,241,11,58,73,99,226,15
78942,2819,2071,485,869,566,151,910,814,211,136,748,131,215,179,223,678,70
78943,107,78,2,44,22,10,26,23,12,17,29,0,0,15,14,29,0
78944,262,186,45,92,43,6,88,70,22,6,76,8,19,29,20,76,0
78945,3999,2853,414,1298,784,357,1041,1401,191,220,1146,127,252,328,439,1085,61
78946,421,288,61,102,79,46,92,142,28,26,133,25,23,50,35,120,13
78947,1548,1174,198,593,288,95,503,498,80,93,374,33,143,105,93,340,34
78948,377,275,44,128,88,15,101,143,25,6,102,12,23,24,43,96,6
78949,244,186,7,66,85,28,36,127,6,17,58,8,5,24,21,58,0
78950,660,494,57,193,200,44,147,294,24,29,166,21,52,26,67,154,12
78953,290,197,22,88,74,13,38,124,16,19,93,0,44,43,6,74,19
78954,432,269,40,88,110,31,65,170,17,17,163,14,35,52,62,145,18
78956,2005,1366,183,646,414,123,481,656,139,90,639,55,121,230,233,582,57
78957,3233,2228,450,1048,539,191,832,1029,190,177,1005,149,300,307,249,840,165
78959,593,417,68,171,133,45,126,173,62,56,176,14,43,80,39,162,14
78960,37,31,0,9,15,7,0,16,0,15,6,0,0,0,6,6,0
78962,1621,1125,115,512,367,131,363,569,94,99,496,39,129,131,197,469,27
78963,177,147,16,75,43,13,35,94,6,12,30,0,5,0,25,30,0
79001,116,78,5,36,30,7,18,51,6,3,38,6,7,22,3,36,2
79002,24,24,4,8,7,5,4,20,0,0,0,0,0,0,0,0,0
79003,71,50,5,23,18,4,18,25,3,4,21,3,2,10,6,19,2
79005,520,395,113,182,84,16,193,158,30,14,125,14,24,53,34,113,12
79007,6097,4457,1081,1998,979,399,1770,1909,427,351,1640,259,390,530,461,1527,113
79009,673,545,160,223,127,35,294,181,42,28,128,15,32,34,47,122,6
79010,213,171,0,132,33,6,72,79,6,14,42,9,25,0,8,42,0
79011,116,89,21,42,22,4,41,41,1,6,27,2,0,10,15,25,2
79012,159,127,38,60,29,0,83,26,18,0,32,0,0,32,0,21,11
79013,730,640,286,292,55,7,379,128,103,30,90,34,37,16,3,59,31
79014,1244,920,173,439,243,65,352,460,69,39,324,55,64,106,99,303,21
79015,6123,3987,1092,1991,727,177,1656,1606,511,214,2136,1144,281,421,290,1635,501
79018,193,155,19,85,44,7,71,80,2,2,38,6,11,16,5,38,0
79019,733,572,100,266,157,49,220,293,39,20,161,15,28,49,69,155,6
79021,60,51,4,32,7,8,20,26,5,0,9,3,2,2,2,8,1
79022,3207,2360,654,1020,543,143,946,1009,273,132,847,151,199,261,236,791,56
79024,166,109,11,45,34,19,31,66,7,5,57,3,19,25,10,55,2
79025,36,31,8,13,10,0,14,12,5,0,5,0,0,5,0,5,0
79027,1831,1407,318,618,403,68,548,558,163,138,424,26,122,143,133,401,23
79029,5274,4138,1161,1833,900,244,1746,1660,464,268,1136,293,225,364,254,1003,133
79031,464,343,79,134,107,23,135,146,40,22,121,13,22,43,43,110,11
79032,54,50,12,19,19,0,11,30,5,4,4,0,0,4,0,4,0
79033,54,29,19,0,10,0,11,18,0,0,25,0,0,17,8,25,0
79034,251,151,20,72,43,16,59,78,5,9,100,3,12,34,51,96,4
79035,1712,1337,303,625,335,74,642,576,98,21,375,74,80,73,148,330,45
79036,2143,1641,245,798,482,116,609,863,88,81,502,34,136,205,127,442,60
79039,327,252,40,113,81,18,101,126,13,12,75,8,11,25,31,75,0
79040,692,542,123,242,148,29,226,264,45,7,150,17,33,47,53,142,8
79041,1184,898,241,351,240,66,370,374,100,54,286,25,81,86,94,270,16
79042,455,291,71,131,56,33,105,157,19,10,164,38,21,52,53,154,10
79043,528,428,135,172,103,18,210,160,38,20,100,7,28,30,35,96,4
79044,200,146,37,72,36,1,75,56,7,8,54,21,4,22,7,40,14
79045,6080,4787,1182,2138,1126,341,1837,1829,674,447,1293,145,306,480,362,1198,95
79046,266,186,10,104,54,18,64,109,7,6,80,0,21,40,19,74,6
79051,10,8,2,4,0,2,2,6,0,0,2,0,2,0,0,2,0
79052,491,399,92,141,135,31,154,189,28,28,92,21,21,35,15,84,8
79053,49,43,8,26,7,2,15,20,8,0,6,4,0,2,0,6,0
79054,289,197,34,74,71,18,59,110,16,12,92,18,14,21,39,92,0
79056,21,11,2,3,3,3,4,7,0,0,10,0,4,6,0,8,2
79057,479,303,51,103,119,30,103,169,17,14,176,11,35,62,68,172,4
79059,297,219,29,109,64,17,82,119,8,10,78,3,24,27,24,78,0
79061,134,96,6,42,41,7,23,58,8,7,38,4,7,18,9,38,0
79062,97,79,18,44,17,0,40,30,2,7,18,0,6,8,4,18,0
79063,283,236,41,121,55,19,126,93,8,9,47,14,15,8,10,47,0
79064,992,785,151,331,243,60,332,304,82,67,207,18,39,81,69,184,23
79065,8004,5588,1019,2545,1561,463,1891,2851,550,296,2416,252,570,811,783,2256,160
79068,1237,922,164,428,262,68,376,404,77,65,315,23,76,120,96,285,30
79070,3115,2401,612,1181,482,126,1082,1010,210,99,714,88,236,254,136,638,76
79072,9200,7013,1838,3108,1564,503,2887,2633,915,578,2187,376,541,762,508,1979,208
79078,155,112,17,53,42,0,20,66,12,14,43,9,9,18,7,33,10
79079,1188,789,135,302,266,86,231,444,79,35,399,36,97,119,147,376,23
79080,319,254,41,122,68,23,92,127,18,17,65,6,17,24,18,58,7
79081,1355,994,213,418,272,91,409,473,64,48,361,51,64,116,130,332,29
79082,79,60,13,26,14,7,26,26,2,6,19,3,3,4,9,17,2
79083,1034,775,140,369,224,42,268,357,94,56,259,22,72,98,67,248,11
79084,848,633,130,294,169,40,281,268,63,21,215,38,65,59,53,198,17
79086,744,574,133,284,127,30,273,208,66,27,170,14,52,60,44,153,17
79087,297,217,55,101,47,14,96,98,11,12,80,23,23,18,16,78,2
79088,2179,1618,386,641,463,128,598,709,200,111,561,43,105,190,223,516,45
79091,61,45,12,20,7,6,13,25,0,7,16,8,8,0,0,16,0
79092,463,352,85,145,94,28,148,162,20,22,111,10,27,47,27,100,11
79093,20,12,0,5,7,0,0,12,0,0,8,0,0,8,0,8,0
79095,1129,791,160,311,240,80,267,379,82,63,338,32,64,82,160,324,14
79096,731,534,96,226,161,51,198,256,50,30,197,14,39,76,68,186,11
79097,497,369,70,174,95,30,155,157,26,31,128,13,31,47,37,122,6
79098,174,149,42,49,42,16,72,67,4,6,25,5,7,8,5,25,0
79101,1239,465,215,201,33,16,155,93,135,82,774,150,250,125,249,669,105
79102,4055,2517,832,974,528,183,794,1006,491,226,1538,344,588,360,246,1340,198
79103,3432,2720,790,1239,567,124,1114,981,398,227,712,124,160,257,171,637,75
79104,2400,1851,573,776,403,99,658,591,366,236,549,113,160,198,78,469,80
79106,11841,7198,2048,2850,1611,689,2150,3059,1235,754,4643,1116,1379,1193,955,4023,620
79107,10448,7839,2432,3397,1643,367,2767,2263,1673,1136,2609,375,794,950,490,2303,306
79108,4227,3278,665,1590,863,160,1196,1632,216,234,949,95,341,304,209,795,154
79109,20036,12578,3073,5782,2901,822,4630,5705,1416,827,7458,2521,1921,1742,1274,6450,1008
79110,6789,5032,1518,2338,943,233,1979,1991,749,313,1757,356,645,494,262,1455,302
79111,522,439,199,201,35,4,254,97,60,28,83,30,37,12,4,53,30
79118,4517,3593,833,1797,853,110,1399,1618,357,219,924,214,346,314,50,695,229
79119,1405,1087,145,590,286,66,555,447,28,57,318,38,128,120,32,279,39
79121,2539,1941,156,1083,582,120,765,1066,61,49,598,122,157,230,89,530,68
79124,1895,1570,250,737,521,62,580,882,63,45,325,102,97,78,48,274,51
79201,2504,1677,321,723,475,158,523,845,226,83,827,105,194,297,231,762,65
79220,76,47,0,20,26,1,14,28,0,5,29,3,8,9,9,25,4
79223,12,8,0,2,6,0,3,5,0,0,4,0,2,2,0,4,0
79225,452,321,53,139,110,19,119,139,44,19,131,23,19,38,51,117,14
79226,1312,895,98,365,329,103,210,551,95,39,417,45,87,158,127,398,19
79227,705,469,86,176,147,60,156,238,42,33,236,18,41,75,102,220,16
79229,193,126,28,44,46,8,43,69,5,9,67,5,12,23,27,56,11
79230,75,58,2,19,33,4,9,44,2,3,17,3,5,4,5,17,0
79231,30,30,8,14,8,0,21,0,9,0,0,0,0,0,0,0,0
79232,20,18,3,5,10,0,4,14,0,0,2,0,0,0,2,2,0
79233,69,36,10,17,9,0,12,21,0,3,33,0,11,15,7,29,4
79234,66,46,3,17,20,6,9,35,1,1,20,0,2,4,14,20,0
79235,1658,1268,281,513,372,102,459,587,137,85,390,41,91,139,119,378,12
79236,53,48,7,31,9,1,29,19,0,0,5,0,1,4,0,5,0
79237,228,138,25,65,38,10,57,71,6,4,90,3,13,34,40,85,5
79239,100,70,16,23,30,1,30,31,6,3,30,2,3,14,11,30,0
79240,33,26,9,5,0,12,9,11,0,6,7,0,0,7,0,7,0
79241,1016,808,182,332,223,71,357,314,67,70,208,27,47,64,70,195,13
79243,50,29,0,11,14,4,7,22,0,0,21,3,4,5,9,21,0
79244,352,258,38,105,84,31,88,130,19,21,94,12,11,41,30,83,11
79245,1070,695,143,274,221,57,233,317,78,67,375,31,66,151,127,355,20
79247,38,24,5,13,6,0,9,14,1,0,14,0,0,10,4,6,8
79248,786,532,78,221,160,73,160,268,63,41,254,20,31,81,122,248,6
79250,577,452,64,226,120,42,178,200,35,39,125,12,14,55,44,121,4
79251,29,26,2,6,15,3,4,22,0,0,3,0,0,0,3,3,0
79252,1529,1035,208,407,298,122,348,516,109,62,494,50,115,134,195,465,29
79255,244,166,25,82,46,13,52,78,18,18,78,9,19,24,26,76,2
79256,149,100,11,38,34,17,27,55,6,12,49,2,11,16,20,44,5
79257,470,335,45,135,119,36,116,181,24,14,135,15,24,46,50,128,7
79259,15,10,0,0,0,10,0,5,0,5,5,5,0,0,0,5,0
79261,249,166,29,69,41,27,63,77,19,7,83,6,17,40,20,79,4
79311,1256,1015,201,423,305,86,409,448,79,79,241,19,45,92,85,221,20
79312,318,251,57,114,58,22,120,78,21,32,67,13,12,17,25,60,7
79313,605,465,79,218,144,24,201,185,45,34,140,15,28,58,39,131,9
79314,53,39,0,18,21,0,17,19,3,0,14,0,6,2,6,14,0
79316,3868,2916,678,1164,879,195,1042,1219,359,296,952,86,228,335,303,881,71
79320,29,22,4,14,2,2,12,10,0,0,7,3,0,2,2,7,0
79322,798,587,146,241,157,43,227,245,75,40,211,8,26,83,94,200,11
79323,1940,1598,361,794,359,84,740,615,141,102,342,32,87,135,88,335,7
79324,37,33,6,16,4,7,12,17,4,0,4,0,0,2,2,4,0
79325,791,615,130,285,146,54,264,260,52,39,176,18,52,51,55,167,9
79326,20,20,0,0,12,8,0,16,0,4,0,0,0,0,0,0,0
79329,1120,860,149,441,214,56,342,351,74,93,260,48,68,66,78,241,19
79330,10,10,0,0,10,0,0,10,0,0,0,0,0,0,0,0,0
79331,4448,3356,782,1347,932,295,1188,1493,408,267,1092,149,163,383,397,1062,30
79336,5871,4459,1131,2055,974,299,1721,1828,602,308,1412,288,392,349,383,1252,160
79339,2741,1982,413,871,484,214,690,828,280,184,759,70,184,288,217,709,50
79342,136,115,19,57,34,5,55,46,9,5,21,4,1,7,9,21,0
79343,657,499,118,220,132,29,183,218,65,33,158,15,43,55,45,147,11
79344,59,42,6,25,9,2,18,18,3,3,17,0,8,6,3,16,1
79345,324,285,58,133,76,18,138,116,14,17,39,3,9,15,12,39,0
79346,987,790,161,308,258,63,295,345,85,65,197,24,38,67,68,188,9
79347,2328,1758,355,744,521,138,735,814,143,66,570,68,92,196,214,526,44
79350,178,154,36,75,37,6,55,57,21,21,24,5,16,3,0,24,0
79351,574,444,81,196,127,40,187,199,36,22,130,10,28,42,50,127,3
79353,15,5,3,0,0,2,3,2,0,0,10,2,3,5,0,10,0
79355,663,533,84,281,139,29,234,232,47,20,130,22,47,35,26,112,18
79356,1734,1277,259,578,369,71,496,516,125,140,457,39,134,100,184,416,41
79357,962,729,191,274,199,65,288,296,90,55,233,21,34,77,101,209,24
79358,474,379,92,146,119,22,168,159,25,27,95,3,27,37,28,89,6
79359,1048,804,171,357,224,52,320,339,98,47,244,28,47,110,59,219,25
79360,3375,2743,738,1299,607,99,1314,1022,240,167,632,108,151,235,138,591,41
79363,1685,1337,277,674,324,62,650,486,99,102,348,57,108,112,71,313,35
79364,3054,2205,555,929,569,152,816,828,333,228,849,84,250,271,244,776,73
79366,603,468,41,218,194,15,142,296,12,18,135,18,44,61,12,112,23
79367,258,211,38,103,60,10,69,93,27,22,47,8,6,23,10,42,5
79369,43,33,10,20,3,0,14,9,7,3,10,3,3,0,4,10,0
79370,741,494,93,176,142,83,141,276,47,30,247,20,67,93,67,233,14
79371,460,326,47,159,86,34,124,141,28,33,134,20,18,49,47,126,8
79372,473,387,63,186,114,24,158,160,37,32,86,17,19,18,32,86,0
79373,1352,997,198,480,251,68,417,391,123,66,355,26,79,132,118,335,20
79376,29,21,7,9,5,0,7,14,0,0,8,0,0,6,2,8,0
79377,138,102,19,56,20,7,59,38,2,3,36,7,10,8,11,36,0
79378,88,68,6,39,15,8,37,27,2,2,20,5,3,10,2,20,0
79379,220,152,21,86,32,13,68,50,11,23,68,4,20,26,18,64,4
79380,70,46,3,21,22,0,17,27,2,0,24,6,4,6,8,24,0
79381,288,232,47,94,78,13,93,110,24,5,56,5,13,13,25,49,7
79382,1659,1359,344,695,274,46,586,535,150,88,300,44,105,83,68,265,35
79383,101,89,19,49,18,3,53,27,6,3,12,1,5,2,4,10,2
79401,4498,2097,785,928,311,73,692,682,523,200,2401,1462,556,302,81,1908,493
79403,4789,3778,872,1638,1005,263,1034,1155,797,792,1011,81,344,410,176,879,132
79404,3029,2297,648,1080,455,114,786,632,522,357,732,134,303,175,120,618,114
79405,1033,715,266,289,138,22,218,161,178,158,318,96,104,55,63,269,49
79406,41,0,0,0,0,0,0,0,0,0,41,41,0,0,0,41,0
79407,7096,4200,1303,1922,810,165,1440,1561,705,494,2896,1633,583,504,176,2205,691
79410,4167,2196,579,1012,386,219,698,938,298,262,1971,926,512,295,238,1459,512
79411,2184,1232,571,417,169,75,373,360,330,169,952,379,299,132,142,703,249
79412,5700,3998,1304,1519,850,325,1199,1514,820,465,1702,414,467,551,270,1461,241
79413,8659,5627,1153,2295,1575,604,1760,2611,615,641,3032,731,726,750,825,2435,597
79414,7414,4082,1431,1575,819,257,1276,1734,725,347,3332,1747,571,680,334,2382,950
79415,5985,3675,1092,1588,839,156,1235,1284,718,438,2310,1359,396,381,174,1770,540
79416,9631,5916,1740,2609,1207,360,2039,2492,775,610,3715,2049,702,508,456,2505,1210
79423,9268,6874,1710,3361,1413,390,2669,3129,666,410,2394,649,749,679,317,1893,501
79424,10812,7544,1582,3870,1785,307,3090,3632,462,360,3268,1478,811,550,429,2631,637
79501,1353,1023,188,459,278,98,373,463,106,81,330,37,53,103,137,311,19
79502,624,432,82,176,134,40,139,226,28,39,192,12,53,64,63,179,13
79503,92,69,24,33,9,3,36,25,6,2,23,0,3,5,15,21,2
79504,1219,849,137,360,276,76,247,463,74,65,370,28,53,153,136,335,35
79505,118,90,8,58,18,6,40,32,14,4,28,0,3,17,8,28,0
79506,350,261,20,95,105,41,43,180,33,5,89,6,23,28,32,83,6
79508,427,352,94,164,77,17,137,129,40,46,75,7,21,26,21,67,8
79510,2908,2244,427,1033,642,142,876,1038,184,146,664,72,152,245,195,614,50
79511,551,424,73,177,145,29,154,210,43,17,127,2,41,41,43,125,2
79512,2351,1687,369,719,439,160,524,740,236,187,664,44,139,241,240,625,39
79517,69,58,6,26,19,7,13,45,0,0,11,3,0,0,8,11,0
79518,55,38,0,24,9,5,21,12,3,2,17,0,7,8,2,17,0
79519,14,4,0,0,4,0,0,4,0,0,10,0,0,8,2,10,0
79520,1063,724,85,323,222,94,242,368,73,41,339,28,70,124,117,329,10
79521,1613,1112,166,447,387,112,377,569,111,55,501,49,146,117,189,474,27
79525,1060,871,183,392,236,60,317,444,75,35,189,23,49,84,33,160,29
79526,421,305,49,139,89,28,90,189,21,5,116,12,17,41,46,110,6
79527,99,73,25,26,17,5,35,24,7,7,26,4,6,8,8,21,5
79528,249,181,12,79,72,18,52,106,12,11,68,6,21,27,14,64,4
79529,591,392,65,174,121,32,128,204,43,17,199,26,33,58,82,188,11
79530,191,147,21,79,28,19,56,65,17,9,44,0,8,18,18,41,3
79532,381,251,36,117,73,25,84,104,29,34,130,8,34,51,37,124,6
79533,181,118,30,51,27,10,56,51,4,7,63,1,22,25,15,57,6
79534,87,70,10,22,24,14,14,49,3,4,17,0,6,5,6,16,1
79535,70,43,6,19,18,0,5,29,7,2,27,0,14,6,7,21,6
79536,1902,1351,260,700,313,78,556,546,159,90,551,83,128,237,103,470,81
79537,42,26,4,9,9,4,6,13,5,2,16,5,0,9,2,14,2
79538,92,69,7,25,33,4,18,48,3,0,23,3,7,8,5,22,1
79539,96,69,3,36,16,14,22,42,2,3,27,2,3,8,14,27,0
79540,45,21,0,8,6,7,4,13,4,0,24,4,5,15,0,21,3
79541,257,220,43,111,59,7,92,96,22,10,37,0,0,9,28,37,0
79543,499,361,55,126,137,43,110,183,39,29,138,7,33,54,44,128,10
79544,269,186,28,83,57,18,57,97,17,15,83,7,14,36,26,82,1
79545,693,526,99,210,171,46,158,267,54,47,167,19,37,67,44,150,17
79546,906,619,90,272,197,60,178,314,74,53,287,27,48,97,115,275,12
79547,349,260,36,103,80,41,82,148,17,13,89,2,13,30,44,85,4
79548,103,61,5,25,21,10,18,41,0,2,42,0,0,32,10,40,2
79549,5222,3764,787,1694,1018,265,1379,1674,452,259,1458,223,330,499,406,1319,139
79553,1553,1102,168,528,285,121,337,467,187,111,451,34,98,148,171,433,18
79556,5269,3666,888,1589,961,228,1195,1538,581,352,1603,224,351,568,460,1445,158
79560,80,56,11,22,7,16,21,25,2,8,24,0,4,7,13,21,3
79561,263,205,33,81,68,23,60,117,20,8,58,10,15,13,20,53,5
79562,980,765,153,413,187,12,347,357,36,25,215,19,67,78,51,202,13
79563,418,315,97,167,41,10,127,115,60,13,103,11,28,47,17,94,9
79565,106,75,19,33,12,11,29,32,11,3,31,2,6,10,13,31,0
79566,138,98,10,41,36,11,20,70,6,2,40,4,7,22,7,40,0
79567,1512,1106,250,443,316,97,384,516,120,86,406,16,87,146,157,379,27
79601,7125,4040,824,1878,973,365,1318,1790,498,434,3085,1243,600,597,645,2299,786
79602,6968,5025,1209,2383,1165,268,1857,2191,622,355,1943,505,530,622,286,1608,335
79603,8673,6331,1434,2842,1630,425,2023,2608,1055,645,2342,313,610,862,557,2058,284
79605,12877,8745,2446,3806,1826,667,2985,3660,1477,623,4132,1120,1072,1205,735,3533,599
79606,7376,5128,1246,2591,1056,235,2183,2366,397,182,2248,948,565,444,291,1894,354
79607,1132,1112,745,367,0,0,858,170,78,6,20,5,15,0,0,15,5
79701,8526,6216,1670,2776,1329,441,2568,1880,975,793,2310,226,610,783,691,2087,223
79703,6846,5071,1432,2450,964,225,2274,1733,718,346,1775,415,623,494,243,1580,195
79705,11011,7797,1232,3935,2025,605,2870,3527,898,502,3214,719,983,928,584,2880,334
79706,5254,4244,966,2283,850,145,1910,1685,464,185,1010,150,359,348,153,863,147
79707,10467,7335,1494,4218,1416,207,3183,2934,905,313,3132,1093,1124,573,342,2789,343
79713,224,173,26,69,63,15,69,91,4,9,51,8,8,18,17,47,4
79714,4586,3540,759,1756,805,220,1580,1426,341,193,1046,108,297,384,257,999,47
79718,257,190,39,62,84,5,62,92,22,14,67,0,18,32,17,66,1
79719,208,161,21,65,62,13,50,80,14,17,47,2,9,22,14,47,0
79720,10858,7597,1491,3501,2046,559,2475,3375,1064,683,3261,403,792,1199,867,2946,315
79730,100,81,7,35,36,3,43,23,5,10,19,3,5,11,0,19,0
79731,1303,1016,220,528,217,51,429,396,115,76,287,33,48,107,99,258,29
79733,90,78,8,37,31,2,24,37,12,5,12,2,3,0,7,12,0
79734,780,550,78,262,155,55,182,292,37,39,230,30,74,85,41,207,23
79735,4209,3258,831,1320,891,216,1271,1366,385,236,951,176,285,287,203,829,122
79738,87,63,5,41,15,2,24,28,7,4,24,6,4,10,4,24,0
79739,336,249,45,153,49,2,144,85,16,4,87,24,32,20,11,78,9
79740,15,15,0,6,9,0,0,15,0,0,0,0,0,0,0,0,0
79741,101,66,4,38,22,2,28,35,3,0,35,1,6,18,10,32,3
79742,201,144,28,65,36,15,47,72,21,4,57,9,8,28,12,54,3
79743,200,156,22,71,46,17,49,77,19,11,44,6,16,13,9,44,0
79744,511,420,72,255,71,22,200,178,37,5,91,21,23,22,25,80,11
79745,2221,1703,403,764,370,166,710,703,213,77,518,55,123,215,125,474,44
79748,73,65,13,29,22,1,28,32,2,3,8,2,2,2,2,8,0
79749,61,55,7,22,25,1,15,32,8,0,6,0,4,0,2,6,0
79752,801,581,98,298,154,31,222,252,71,36,220,23,54,86,57,205,15
79754,30,17,0,11,6,0,7,10,0,0,13,0,10,0,3,13,0
79755,73,62,12,38,10,2,38,20,2,2,11,0,5,6,0,9,2
79756,3286,2464,475,1193,655,141,948,1053,283,180,822,129,172,349,172,766,56
79758,665,513,68,285,132,28,185,273,31,24,152,24,46,58,24,132,20
79759,11,11,3,8,0,0,0,0,8,3,0,0,0,0,0,0,0
79761,10567,7467,1798,3328,1754,587,2646,2834,1214,773,3100,434,1080,901,685,2775,325
79762,14371,9882,2524,4647,2144,567,3500,4069,1699,614,4489,1210,1369,1248,662,3920,569
79763,10476,8105,2045,4118,1660,282,3493,2545,1326,741,2371,275,796,808,492,2096,275
79764,6105,4604,1153,2210,1074,167,1885,1684,695,340,1501,296,562,432,211,1293,208
79765,1587,1203,270,646,249,38,555,484,128,36,384,118,141,79,46,331,53
79766,572,506,137,251,115,3,199,199,89,19,66,0,23,43,0,63,3
79772,3541,2788,634,1187,779,188,1078,1015,409,286,753,76,155,316,206,707,46
79776,16,12,0,12,0,0,5,0,7,0,4,0,0,4,0,4,0
79777,80,54,9,27,14,4,25,22,3,4,26,1,10,11,4,26,0
79778,343,256,24,135,82,15,94,124,18,20,87,12,15,32,28,80,7
79780,235,146,25,28,82,11,44,90,5,7,89,0,28,61,0,89,0
79781,121,83,19,39,21,4,30,36,9,8,38,7,11,10,10,35,3
79782,1254,965,221,415,248,81,409,394,124,38,289,32,85,87,85,282,7
79783,68,52,13,27,12,0,25,23,4,0,16,2,5,9,0,14,2
79785,46,23,0,13,6,4,3,12,0,8,23,2,14,7,0,21,2
79788,155,117,27,48,31,11,44,44,19,10,38,7,11,14,6,30,8
79789,347,263,40,157,53,13,115,90,40,18,84,5,29,26,24,83,1
79821,1364,1184,316,587,244,37,611,256,205,112,180,4,52,69,55,166,14
79830,2967,1768,401,745,450,172,581,800,226,161,1199,359,278,334,228,1031,168
79831,120,79,13,29,37,0,45,26,8,0,41,9,8,13,11,11,30
79834,36,26,6,20,0,0,10,13,0,3,10,0,10,0,0,10,0
79835,2870,2498,597,1329,489,83,1314,660,308,216,372,42,104,168,58,321,51
79836,1490,1225,292,627,277,29,655,369,133,68,265,22,97,111,35,229,36
79837,234,179,33,85,47,14,70,81,23,5,55,4,15,27,9,55,0
79838,2208,1971,512,935,461,63,837,523,361,250,237,49,46,75,67,220,17
79839,553,457,124,224,101,8,245,117,65,30,96,10,24,26,36,85,11
79842,230,152,14,80,38,20,26,89,16,21,78,12,26,40,0,61,17
79843,1070,702,146,267,225,64,218,307,110,67,368,40,99,112,117,329,39
79845,1390,1122,247,499,282,94,521,381,129,91,268,45,61,97,65,256,12
79846,48,35,6,9,20,0,18,12,5,0,13,0,0,7,6,13,0
79847,16,10,3,7,0,0,3,7,0,0,6,0,3,0,3,3,3
79848,392,261,39,112,88,22,84,128,28,21,131,12,26,51,42,128,3
79849,2492,2312,656,1228,313,115,1352,487,319,154,180,44,39,60,37,180,0
79851,251,174,40,82,52,0,76,52,26,20,77,25,19,22,11,74,3
79852,286,195,62,67,57,9,78,78,15,24,91,8,41,42,0,80,11
79853,727,680,259,309,96,16,427,110,88,55,47,8,11,11,17,45,2
79854,107,71,8,28,27,8,30,32,5,4,36,0,3,23,10,33,3
79855,999,771,165,350,217,39,301,295,96,79,228,34,85,68,41,201,27
79901,4498,2877,691,1164,786,236,828,676,826,547,1621,164,254,739,464,1574,47
79902,8714,5288,1250,2117,1364,557,1730,1823,794,941,3426,1059,978,813,576,2903,523
79903,6579,4704,763,1993,1365,583,1471,1633,668,932,1875,169,457,705,544,1697,178
79904,10851,8461,2664,3376,1893,528,3365,2643,1502,951,2390,408,676,848,458,2038,352
79905,8558,6892,1341,2589,2071,891,2055,2309,1133,1395,1666,138,369,677,482,1565,101
79906,1201,1184,814,358,12,0,887,218,79,0,17,17,0,0,0,17,0
79907,15282,13546,2401,6949,3531,665,5042,3839,2347,2318,1736,242,401,690,403,1587,149
79908,318,318,82,236,0,0,205,47,66,0,0,0,0,0,0,0,0
79912,24364,16955,4147,8734,3277,797,7488,6023,2222,1222,7409,2393,2452,1621,943,6229,1180
79915,12808,10629,1801,4027,3960,841,3155,4056,1540,1878,2179,232,453,960,534,1963,216
79922,2789,2350,197,1334,640,179,945,989,173,243,439,65,150,123,101,369,70
79924,18855,14850,2931,7328,3965,626,5474,5200,2451,1725,4005,453,1140,1677,735,3565,440
79925,15284,10753,2414,4554,2945,840,3318,4243,1853,1339,4531,1122,1365,1183,861,3942,589
79927,13790,12679,3403,6687,2186,403,6940,3091,1622,1026,1111,193,395,402,121,958,153
79930,9285,6967,1585,2738,1886,758,2297,2252,1063,1355,2318,336,663,748,571,2039,279
79932,5158,4267,831,2257,1014,165,1709,1399,760,399,891,197,272,327,95,785,106
79934,2995,2671,677,1751,220,23,1552,672,298,149,324,68,170,79,7,281,43
79935,6635,5054,1251,2427,1238,138,1769,1808,926,551,1581,439,453,463,226,1371,210
79936,26894,23372,6741,13631,2634,366,12428,5558,3440,1946,3522,944,1604,725,249,2800,722
79938,4034,3597,959,2091,489,58,2008,760,537,292,437,44,170,180,43,395,42
80002,6769,4304,1169,2195,753,187,1406,1651,775,472,2465,614,1076,524,251,2034,431
80003,13752,9504,2259,4742,2136,367,3482,4102,1203,717,4248,1414,1605,989,240,3145,1103
80004,14324,10177,1682,5269,2572,654,3801,4500,1165,711,4147,620,1374,1189,964,3487,660
80005,9239,7080,871,4248,1804,157,2884,3203,578,415,2159,405,881,644,229,1738,421
80007,1951,1728,248,1110,319,51,841,760,88,39,223,41,80,92,10,165,58
80010,13938,9570,4059,3795,1335,381,3779,2365,1900,1526,4368,1118,1933,873,444,3372,996
80011,16499,11181,3331,5082,2287,481,3925,3773,2141,1342,5318,1089,2237,1395,597,4375,943
80012,18135,11033,3133,5075,2458,367,3456,4316,2095,1166,7102,2375,2856,1355,516,5773,1329
80013,20025,15253,3824,9400,1875,154,7161,5150,2091,851,4772,1529,2434,687,122,3541,1231
80014,16351,8393,1630,3900,2001,862,2236,4149,1139,869,7958,2230,2595,1670,1463,6706,1252
80015,17963,14523,3103,9774,1505,141,8124,4314,1458,627,3440,1176,1680,469,115,2495,945
80016,2427,2184,244,1419,479,42,1133,875,119,57,243,73,101,36,33,200,43
80017,11720,7685,2371,4331,900,83,3115,2572,1326,672,4035,1660,1723,536,116,3110,925
80018,937,770,315,321,115,19,299,271,161,39,167,42,86,39,0,121,46
80019,14,14,8,6,0,0,14,0,0,0,0,0,0,0,0,0,0
80020,16579,12912,2744,7654,2133,381,6119,4992,1191,610,3667,1073,1577,664,353,2744,923
80021,10394,7336,2056,4251,919,110,3503,2576,778,479,3058,1198,1308,409,143,2190,868
80022,8899,6684,1794,3136,1433,321,2338,2297,1099,950,2215,320,842,768,285,1722,493
80024,91,50,7,25,18,0,14,36,0,0,41,0,6,27,8,29,12
80025,86,27,0,27,0,0,0,27,0,0,59,28,23,8,0,43,16
80026,9619,6670,1586,3913,987,184,2834,2493,890,453,2949,875,1369,439,266,2128,821
80027,10853,7340,1505,4890,805,140,3719,2542,723,356,3513,1501,1490,367,155,2459,1054
80030,6412,4001,1195,1747,821,238,1453,1433,568,547,2411,538,811,649,413,2035,376
80031,10968,8061,1296,4561,1930,274,2879,3600,898,684,2907,785,1227,685,210,2212,695
80033,11162,6400,1411,2810,1491,688,1827,2836,1100,637,4762,798,1664,1130,1170,4037,725
80101,137,110,13,59,27,11,34,61,8,7,27,6,6,8,7,26,1
80102,1535,1206,233,746,176,51,587,467,102,50,329,54,162,85,28,283,46
80103,721,557,112,295,129,21,224,226,68,39,164,30,55,55,24,122,42
80104,10661,8652,1778,5056,1666,152,4229,3526,609,288,2009,565,915,361,168,1486,523
80105,432,316,79,151,75,11,130,140,31,15,116,20,35,29,32,96,20
80106,1122,972,122,671,159,20,462,455,39,16,150,14,89,39,8,128,22
80107,3586,3099,403,2088,533,75,1432,1337,182,148,487,59,311,88,29,363,124
80110,18649,10602,2594,4886,2202,920,3432,4366,1621,1183,8047,2317,3122,1407,1201,6350,1697
80111,9533,7068,742,4583,1614,129,3497,2678,604,289,2465,968,983,387,127,1960,505
80112,7705,5734,708,3451,1394,181,2539,2339,560,296,1971,431,900,507,133,1476,495
80116,1313,1153,22,804,271,56,463,619,38,33,160,23,70,40,27,148,12
80117,759,603,104,340,147,12,254,275,42,32,156,32,67,51,6,118,38
80118,1524,1320,120,784,346,70,474,772,58,16,204,16,130,43,15,146,58
80120,12472,7530,1380,3853,1847,450,2513,3450,1011,556,4942,924,1750,1338,930,4218,724
80121,6772,5361,553,2769,1688,351,2176,2493,348,344,1411,208,542,507,154,1152,259
80122,11896,9051,1008,5204,2428,411,3812,3817,839,583,2845,375,1264,828,378,2390,455
80123,16551,11263,2286,5932,2473,572,4545,5141,923,654,5288,1762,1871,1043,612,4239,1049
80124,4422,3625,674,2356,560,35,1811,1534,192,88,797,179,402,209,7,593,204
80125,1998,1713,371,1003,328,11,789,816,78,30,285,83,162,33,7,198,87
80126,23835,18933,5325,11328,2033,247,10619,6773,1191,350,4902,1833,2193,702,174,3576,1326
80127,13159,10862,1579,7615,1511,157,5706,3734,860,562,2297,627,967,495,208,1704,593
80128,12234,9428,1610,5769,1801,248,4302,3778,795,553,2806,791,1330,543,142,2194,612
80132,4629,4075,343,2592,980,160,1852,1917,207,99,554,48,281,174,51,454,100
80133,625,423,105,265,48,5,189,151,71,12,202,38,105,37,22,155,47
80134,10030,8670,2072,5437,1080,81,4893,3010,559,208,1360,432,661,213,54,1012,348
80135,1360,1106,85,627,369,25,422,583,63,38,254,26,94,97,37,230,24
80136,859,702,126,405,133,38,305,288,72,37,157,32,50,35,40,123,34
80137,325,252,13,163,59,17,86,138,14,14,73,12,36,13,12,51,22
80138,6872,5838,1253,3421,1019,145,2710,2551,439,138,1034,247,469,248,70,772,262
80202,2989,621,209,222,183,7,26,463,70,62,2368,695,779,562,332,2091,277
80203,11853,1802,938,490,301,73,222,949,308,323,10051,5262,3120,1226,443,8280,1771
80204,11147,6799,2796,2805,866,332,2355,1438,1924,1082,4348,1160,1526,1005,657,3332,1016
80205,10352,6027,2025,2507,1163,332,1706,1545,1559,1217,4325,1083,1602,1042,598,3406,919
80206,11503,3598,924,1767,733,174,917,1815,411,455,7905,3164,2885,1365,491,6032,1873
80207,7966,5415,1266,2326,1462,361,1365,1773,1189,1088,2551,389,1108,763,291,1993,558
80209,11521,4368,1043,2110,837,378,1265,2426,388,289,7153,2848,2538,953,814,5481,1672
80210,15527,6633,1635,3097,1178,723,1982,3255,736,660,8894,3503,3004,1131,1256,6548,2346
80211,13896,8315,2722,3625,1420,548,2656,2697,1417,1545,5581,1634,2030,1120,797,4136,1445
80212,8790,4461,1201,2105,784,371,1146,1903,829,583,4329,949,1595,901,884,3448,881
80214,6746,3573,1398,1422,550,203,1039,1212,816,506,3173,847,1409,611,306,2524,649
80215,13293,7541,1533,3404,1893,711,2283,3274,1172,812,5752,1232,2082,1297,1141,4643,1109
80216,2812,2259,719,949,519,72,865,584,461,349,553,92,192,176,93,463,90
80218,11457,2391,749,1076,396,170,523,1070,440,358,9066,4274,2996,1164,632,7199,1867
80219,19396,13979,4224,6153,2682,920,5383,4523,2222,1851,5417,857,2149,1475,936,4433,984
80220,15578,7936,2236,3980,1247,473,2688,3262,1232,754,7642,2545,3090,1378,629,6026,1616
80221,13062,9153,2315,4132,2221,485,3186,3465,1340,1162,3909,1005,1364,1009,531,2913,996
80222,9703,4580,1155,1992,981,452,1279,2141,601,559,5123,1284,2018,1083,738,4194,929
80223,6982,4065,1203,1859,791,212,1404,1293,661,707,2917,757,1127,775,258,2256,661
80224,8342,4323,968,1579,1219,557,1086,2128,532,577,4019,981,1340,1067,631,3175,844
80226,12019,7545,1762,3409,1782,592,2385,3302,1052,806,4474,1184,1383,1165,742,3402,1072
80227,13954,8579,1832,3971,2272,504,2650,4074,1148,707,5375,1815,1947,1215,398,4105,1270
80228,12812,8256,1633,4211,2167,245,3010,3714,946,586,4556,1794,1776,790,196,3416,1140
80229,14398,10294,3388,4810,1780,316,3911,3577,1743,1063,4104,1272,1627,916,289,3086,1018
80230,850,519,138,299,58,24,228,182,91,18,331,104,124,25,78,226,105
80231,27814,11583,3928,4575,2073,1007,2939,5491,1947,1206,16231,6198,5324,2743,1966,13066,3165
80232,8762,5938,1048,2805,1699,386,2048,2804,643,443,2824,718,1001,748,357,2335,489
80233,12986,9686,2466,5117,1926,177,3823,3749,1279,835,3300,834,1181,792,493,2592,708
80234,9428,6136,1797,2904,1259,176,2452,2658,710,316,3292,1250,1282,656,104,2406,886
80235,3256,1835,566,740,424,105,545,823,320,147,1421,568,511,272,70,1138,283
80236,5903,3834,931,1689,943,271,1174,1760,494,406,2069,459,744,534,332,1641,428
80237,8424,4092,948,1602,1085,457,1003,2256,459,374,4332,1582,1264,989,497,3467,865
80239,8462,6791,2305,3259,1140,87,2754,1837,1379,821,1671,512,757,373,29,1253,418
80241,9106,7408,1923,4551,832,102,3708,2718,628,354,1698,719,664,243,72,1241,457
80246,7063,2509,1017,902,427,163,734,984,387,404,4554,2503,1350,445,256,3587,967
80249,2631,2056,650,1227,172,7,938,736,294,88,575,230,251,94,0,388,187
80260,12174,7666,2747,2970,1564,385,2566,2889,1409,802,4508,1336,1659,1033,480,3520,988
80264,0,0,0,0,0,0,0,0,0,0,0,0,0,0,0,0,0
80290,0,0,0,0,0,0,0,0,0,0,0,0,0,0,0,0,0
80293,0,0,0,0,0,0,0,0,0,0,0,0,0,0,0,0,0
80294,0,0,0,0,0,0,0,0,0,0,0,0,0,0,0,0,0
80301,9689,5359,1057,3061,1083,158,2035,2294,707,323,4330,1575,1830,555,370,2897,1433
80302,11568,3973,954,1951,859,209,1401,1906,389,277,7595,4951,1534,718,392,4123,3472
80303,17933,8786,1682,4230,2253,621,2921,4206,916,743,9147,4885,2328,1181,753,5506,3641
80304,10356,5677,951,3296,1115,315,2257,2322,683,415,4679,1849,1847,726,257,2983,1696
80401,15663,10103,1500,5423,2648,532,3533,4901,1025,644,5560,1926,1902,1156,576,4116,1444
80403,6852,4833,807,2870,1030,126,1901,2393,347,192,2019,595,859,416,149,1353,666
80420,298,157,32,109,16,0,39,100,9,9,141,53,76,10,2,85,56
80421,3147,2442,373,1594,435,40,963,1195,209,75,705,140,368,175,22,541,164
80422,177,80,25,37,18,0,22,31,18,9,97,21,62,10,4,63,34
80423,42,26,14,12,0,0,0,16,0,10,16,0,6,10,0,16,0
80424,2999,1386,302,832,245,7,531,706,83,66,1613,986,483,144,0,648,965
80425,52,37,0,37,0,0,25,6,6,0,15,0,8,7,0,15,0
80426,26,26,7,11,8,0,18,8,0,0,0,0,0,0,0,0,0
80427,216,102,18,44,33,7,15,69,12,6,114,15,66,19,14,83,31
80428,149,95,23,53,12,7,50,38,0,7,54,12,35,7,0,34,20
80430,8,5,2,1,2,0,2,3,0,0,3,3,0,0,0,0,3
80432,122,74,4,29,41,0,9,57,4,4,48,0,21,22,5,48,0
80433,3138,2548,365,1674,461,48,1053,1277,148,70,590,96,316,158,20,437,153
80434,34,26,2,16,8,0,10,13,1,2,8,0,5,3,0,6,2
80435,2449,1314,434,658,215,7,492,575,136,111,1135,589,424,119,3,563,572
80436,131,93,14,40,34,5,29,59,0,5,38,18,14,6,0,20,18
80438,272,141,32,76,27,6,43,72,23,3,131,2,103,25,1,105,26
80439,9283,6984,683,4353,1734,214,2702,3589,411,282,2299,390,1035,639,235,1842,457
80440,688,449,106,255,84,4,166,206,54,23,239,66,131,33,9,170,69
80442,649,334,97,171,58,8,107,161,57,9,315,116,164,34,1,167,148
80443,1385,730,132,413,168,17,239,368,62,61,655,340,204,87,24,343,312
80444,582,323,38,212,63,10,96,151,61,15,259,65,119,68,7,204,55
80446,1231,834,130,482,210,12,338,384,75,37,397,126,160,85,26,290,107
80447,829,562,61,284,182,35,143,343,41,35,267,57,123,68,19,214,53
80448,91,45,5,30,10,0,29,8,8,0,46,8,19,15,4,40,6
80449,316,240,23,117,95,5,59,169,7,5,76,0,46,26,4,56,20
80451,243,159,45,89,18,7,68,66,19,6,84,24,37,23,0,64,20
80452,1230,780,132,437,173,38,270,367,99,44,450,113,190,99,48,330,120
80454,394,286,21,171,75,19,96,135,23,32,108,12,65,31,0,73,35
80455,192,100,10,48,39,3,33,49,5,13,92,6,71,15,0,71,21
80456,231,167,0,119,48,0,44,118,5,0,64,0,23,34,7,41,23
80457,170,127,17,93,17,0,60,33,34,0,43,25,13,0,5,31,12
80459,858,617,165,337,103,12,253,257,75,32,241,53,103,57,28,198,43
80461,2879,1876,626,866,343,41,769,738,254,115,1003,354,356,207,86,741,262
80463,100,74,11,39,15,9,19,46,0,9,26,0,10,7,9,26,0
80465,5481,4273,615,2654,971,33,1825,1995,324,129,1208,264,672,223,49,922,286
80466,1366,801,140,524,119,18,294,423,61,23,565,180,315,33,37,347,218
80467,750,485,131,272,72,10,213,211,50,11,265,50,132,62,21,191,74
80468,210,157,35,92,26,4,86,63,6,2,53,5,29,8,11,46,7
80469,132,94,26,33,23,12,28,56,3,7,38,5,0,21,12,33,5
80470,1277,953,107,563,246,37,446,441,37,29,324,45,205,56,18,200,124
80473,28,20,5,8,7,0,6,11,3,0,8,0,0,0,8,8,0
80474,172,90,0,72,18,0,23,67,0,0,82,15,33,24,10,75,7
80476,71,38,12,20,6,0,16,12,7,3,33,6,27,0,0,29,4
80478,313,196,49,92,55,0,65,131,0,0,117,40,45,23,9,60,57
80479,19,19,3,9,7,0,7,5,3,4,0,0,0,0,0,0,0
80480,597,397,58,199,121,19,148,192,32,25,200,23,64,84,29,175,25
80481,261,191,23,136,32,0,77,83,10,21,70,24,36,10,0,37,33
80482,725,333,51,171,110,1,111,198,11,13,392,168,153,67,4,235,157
80483,243,139,25,81,30,3,68,53,11,7,104,18,42,33,11,90,14
80487,5778,3379,578,2155,559,87,1413,1431,380,155,2399,1095,922,305,77,1403,996
80498,2273,1424,411,796,195,22,606,594,130,94,849,419,316,92,22,414,435
80501,20782,14278,3866,7265,2516,631,5780,5215,2214,1069,6504,1548,2464,1397,1095,5047,1457
80503,9619,7102,887,4308,1668,239,3051,3246,554,251,2517,528,1047,621,321,2012,505
80504,3036,2526,432,1391,638,65,1141,1094,156,135,510,92,250,152,16,412,98
80510,216,120,9,51,60,0,14,85,0,21,96,28,52,16,0,78,18
80512,861,588,91,340,119,38,182,349,47,10,273,49,141,72,11,182,91
80513,3879,3134,450,1857,739,88,1383,1433,198,120,745,112,335,196,102,564,181
80514,1090,775,161,390,187,37,287,360,53,75,315,60,113,92,50,247,68
80515,346,263,8,146,91,18,81,157,14,11,83,0,83,0,0,73,10
80516,2993,2380,515,1420,404,41,1100,1035,146,99,613,160,267,134,52,444,169
80517,4177,2666,185,1162,1080,239,629,1764,180,93,1511,259,532,456,264,1218,293
80520,431,348,63,225,55,5,152,147,36,13,83,17,46,18,2,65,18
80521,11659,5179,1669,2411,899,200,1611,2082,832,654,6480,4241,1111,643,485,3062,3418
80524,10844,6670,1532,3169,1508,461,2255,3148,764,503,4174,1626,1287,788,473,3015,1159
80525,16829,10915,2383,5848,2225,459,4555,4627,952,781,5914,2380,1785,925,824,4291,1623
80526,16179,10441,2869,5789,1444,339,4818,4015,1144,464,5738,2893,1649,781,415,3439,2299
80528,2081,1591,434,906,232,19,833,653,57,48,490,237,146,107,0,347,143
80530,785,621,215,282,101,23,278,217,89,37,164,23,69,45,27,124,40
80532,53,45,5,16,18,6,14,31,0,0,8,0,0,8,0,8,0
80534,1684,1332,357,687,222,66,620,564,101,47,352,73,122,86,71,266,86
80535,1255,889,132,525,217,15,334,423,102,30,366,87,194,50,35,256,110
80536,636,458,61,233,147,17,100,341,9,8,178,22,101,45,10,138,40
80537,13132,9379,1965,4922,2022,470,3472,4334,1008,565,3753,913,1236,986,618,3026,727
80538,13303,10125,1851,5149,2462,663,4061,4591,917,556,3178,575,1018,889,696,2656,522
80540,1616,1164,143,678,290,53,337,670,108,49,452,87,261,74,30,325,127
80542,272,231,44,152,33,2,115,90,18,8,41,7,18,16,0,32,9
80543,967,809,275,357,155,22,365,312,81,51,158,39,65,37,17,113,45
80545,335,228,13,101,109,5,38,174,9,7,107,0,38,52,17,79,28
80547,70,45,13,26,5,1,23,19,2,1,25,6,8,4,7,21,4
80549,1744,1344,358,683,271,32,554,590,133,67,400,134,149,79,38,278,122
80550,4116,3139,917,1576,544,102,1519,1197,258,165,977,161,507,199,110,771,206
80601,11256,8875,2325,4532,1650,368,3864,3541,882,588,2381,474,895,563,449,1872,509
80610,861,630,154,321,107,48,249,281,63,37,231,42,75,78,36,181,50
80611,209,151,28,72,45,6,49,96,0,6,58,8,20,15,15,52,6
80612,76,43,0,28,8,7,14,22,7,0,33,0,13,8,12,28,5
80615,2000,1529,277,816,346,90,621,665,171,72,471,84,145,127,115,415,56
80620,3376,2424,955,1095,312,62,1109,671,417,227,952,333,268,235,116,669,283
80621,3608,2869,602,1568,619,80,1233,1096,289,251,739,98,313,219,109,593,146
80623,311,269,69,158,37,5,141,91,25,12,42,0,15,20,7,38,4
80624,331,278,96,109,52,21,139,104,0,35,53,6,32,10,5,41,12
80631,15368,9405,3396,3679,1791,539,3584,3249,1617,955,5963,2857,1432,982,692,4024,1939
80634,15508,10998,2172,5814,2384,628,4493,5030,857,618,4510,1245,1268,1114,883,3554,956
80640,685,566,137,298,114,17,209,271,63,23,119,20,44,27,28,77,42
80642,944,776,152,411,182,31,365,304,59,48,168,32,76,42,18,133,35
80643,607,479,99,262,96,22,225,180,31,43,128,31,53,27,17,99,29
80644,892,747,145,423,139,40,360,284,68,35,145,23,28,73,21,131,14
80645,1354,1057,208,530,242,77,407,501,113,36,297,51,75,97,74,234,63
80648,250,198,41,101,49,7,85,85,21,7,52,5,17,20,10,47,5
80649,127,106,28,45,31,2,42,54,8,2,21,9,7,1,4,20,1
80650,504,381,45,217,106,13,171,168,22,20,123,19,55,25,24,107,16
80651,1396,1092,257,574,225,36,546,411,90,45,304,62,133,73,36,245,59
80652,238,174,40,60,60,14,75,81,18,0,64,11,21,19,13,53,11
80653,284,197,20,138,26,13,84,88,12,13,87,34,22,20,11,73,14
80654,712,569,110,308,123,28,261,218,45,45,143,34,49,36,24,125,18
80701,5362,3926,1057,1725,855,289,1600,1603,499,224,1436,252,386,448,350,1240,196
80705,323,266,88,130,42,6,131,79,43,13,57,5,23,24,5,43,14
80720,1091,735,119,328,199,89,274,349,64,48,356,56,95,129,76,316,40
80721,68,59,7,28,24,0,22,25,3,9,9,0,0,9,0,9,0
80722,169,132,15,80,37,0,67,56,9,0,37,5,15,7,10,17,20
80723,2500,1739,422,803,393,121,645,815,219,60,761,99,196,213,253,658,103
80726,158,102,14,42,39,7,38,36,18,10,56,4,17,13,22,56,0
80727,205,151,30,65,40,16,67,67,12,5,54,5,7,29,13,49,5
80728,340,249,38,103,84,24,92,133,15,9,91,5,20,38,28,86,5
80729,222,141,15,71,44,11,56,72,9,4,81,13,11,27,30,76,5
80731,654,450,81,196,128,45,153,240,39,18,204,19,50,72,63,182,22
80733,136,112,16,65,31,0,38,58,15,1,24,2,6,11,5,24,0
80734,1155,804,179,342,211,72,339,375,77,13,351,36,86,100,129,318,33
80735,139,103,15,54,29,5,52,51,0,0,36,13,0,5,18,30,6
80736,261,207,52,83,54,18,77,87,23,20,54,15,6,26,7,43,11
80737,767,516,115,174,143,84,161,280,42,33,251,37,58,98,58,231,20
80740,49,38,6,9,21,2,20,18,0,0,11,2,0,5,4,11,0
80741,325,264,52,100,75,37,98,145,11,10,61,7,18,20,16,49,12
80742,109,83,10,42,29,2,37,37,7,2,26,0,2,17,7,21,5
80743,428,319,50,148,87,34,100,167,26,26,109,13,32,32,32,106,3
80744,218,148,17,62,52,17,35,96,9,8,70,3,19,25,23,70,0
80745,61,51,6,30,12,3,14,27,10,0,10,0,2,8,0,10,0
80747,195,149,17,78,45,9,48,86,4,11,46,10,16,11,9,31,15
80749,176,131,21,66,31,13,52,72,3,4,45,10,15,13,7,44,1
80750,149,112,26,60,21,5,44,50,12,6,37,12,6,14,5,32,5
80751,6046,3915,862,1782,954,317,1552,1750,434,179,2131,428,578,564,561,1847,284
80754,64,45,7,18,16,4,14,23,0,8,19,4,4,9,2,19,0
80755,66,46,5,15,15,11,15,31,0,0,20,6,9,5,0,14,6
80757,114,88,11,44,29,4,25,44,4,15,26,4,12,6,4,26,0
80758,1449,987,208,444,248,87,367,499,92,29,462,80,111,152,119,422,40
80759,1698,1172,255,550,258,109,470,501,103,98,526,108,116,173,129,467,59
80801,66,49,6,29,8,6,20,23,6,0,17,0,13,4,0,17,0
80802,101,79,6,49,16,8,40,30,9,0,22,10,6,3,3,22,0
80804,172,113,14,59,27,13,34,53,15,11,59,2,21,21,15,44,15
80805,164,129,37,50,34,8,56,55,16,2,35,7,10,12,6,32,3
80807,1741,1222,257,584,284,97,513,535,98,76,519,110,115,154,140,465,54
80808,2074,1667,416,840,346,65,713,686,189,79,407,56,185,109,57,348,59
80809,622,407,39,243,102,23,146,204,45,12,215,54,121,24,16,172,43
80810,541,365,62,197,62,44,160,164,32,9,176,59,44,38,35,161,15
80812,96,76,8,37,23,8,32,37,2,5,20,10,7,3,0,14,6
80813,806,494,101,244,131,18,155,266,47,26,312,53,175,78,6,226,86
80814,1318,1047,130,635,271,11,352,608,43,44,271,19,154,95,3,221,50
80815,425,287,32,145,73,37,106,141,24,16,138,27,31,33,47,132,6
80816,1391,986,111,542,299,34,301,549,76,60,405,21,232,132,20,314,91
80817,5355,4328,1331,2239,642,116,2044,1346,691,247,1027,242,332,380,73,768,259
80818,156,102,21,35,34,12,38,52,6,6,54,14,12,12,16,46,8
80819,427,266,26,172,59,9,80,139,30,17,161,30,87,35,9,133,28
80820,346,224,34,92,89,9,58,145,13,8,122,5,46,51,20,96,26
80821,487,329,51,143,99,36,135,143,27,24,158,22,52,40,44,150,8
80822,106,93,20,29,36,8,34,59,0,0,13,6,7,0,0,13,0
80823,107,90,8,49,26,7,28,37,14,11,17,5,4,1,7,12,5
80824,100,76,0,46,30,0,34,42,0,0,24,0,0,24,0,24,0
80825,211,146,25,66,36,19,51,68,10,17,65,5,12,20,28,65,0
80827,242,159,20,82,47,10,35,89,16,19,83,7,33,31,12,62,21
80828,1062,712,139,372,157,44,320,270,97,25,350,73,88,105,84,316,34
80829,2673,1394,181,743,413,57,450,687,168,89,1279,420,522,203,134,968,311
80830,99,74,9,27,33,5,23,46,4,1,25,0,2,12,11,25,0
80831,3528,2946,530,1848,522,46,1367,1296,203,80,582,82,340,126,34,465,117
80832,273,200,42,87,54,17,74,92,16,18,73,7,30,22,14,63,10
80833,275,205,32,90,67,16,59,119,21,6,70,0,23,36,11,66,4
80834,175,109,14,45,33,17,31,61,6,11,66,14,23,11,18,57,9
80835,311,226,36,107,64,19,81,105,28,12,85,14,20,28,23,73,12
80836,462,342,51,163,99,29,136,167,25,14,120,21,28,38,33,107,13
80840,1136,1125,654,460,11,0,829,174,122,0,11,5,6,0,0,6,5
80860,278,170,36,96,25,13,48,99,19,4,108,26,39,34,9,89,19
80861,89,62,6,31,20,5,25,31,5,1,27,2,8,11,6,27,0
80862,25,18,0,4,14,0,4,12,0,2,7,0,2,3,2,7,0
80863,4273,3300,438,2174,625,63,1353,1581,277,89,973,170,482,229,92,753,220
80864,433,300,51,183,48,18,107,126,56,11,133,28,55,39,11,102,31
80866,37,25,9,5,11,0,14,11,0,0,12,0,7,5,0,0,12
80903,6472,2721,855,1245,486,135,758,1019,654,290,3751,1412,1302,623,414,2965,786
80904,9351,4973,933,2459,1106,475,1209,2362,907,495,4378,1098,1653,823,804,3567,811
80905,1548,778,198,400,153,27,299,307,91,81,770,250,317,127,76,609,161
80906,19754,12617,3038,5987,2843,749,4400,5553,1856,808,7137,2064,2322,1671,1080,5713,1424
80907,12245,7059,1646,3336,1546,531,2163,3185,1082,629,5186,1274,1862,1187,863,4235,951
80908,3153,2742,160,1777,743,62,1182,1374,87,99,411,78,223,79,31,335,76
80909,15940,9648,2395,3981,2435,837,2897,4213,1569,969,6292,1612,2235,1373,1072,5203,1089
80910,10026,6494,2526,2340,1335,293,2151,2351,1219,773,3532,1106,1106,900,420,2893,639
80911,9897,8120,1862,4121,1865,272,3401,3172,915,632,1777,292,582,679,224,1422,355
80913,1677,1607,1205,395,7,0,1233,151,211,12,70,50,20,0,0,58,12
80915,7486,5644,1516,2667,1227,234,1954,2444,863,383,1842,455,700,521,166,1391,451
80916,11731,8764,3975,3675,943,171,3853,2474,1718,719,2967,1224,1087,540,116,2170,797
80917,12259,8109,1967,4039,1833,270,2934,3447,987,741,4150,1444,1489,823,394,3287,863
80918,18655,13300,3232,7027,2665,376,5667,5526,1352,755,5355,1973,1933,1029,420,4103,1252
80919,10504,8063,1217,5028,1642,176,3685,3567,559,252,2441,941,952,403,145,1949,492
80920,10360,8767,1463,5848,1236,220,4792,2965,723,287,1593,514,711,237,131,1328,265
80921,2897,2554,285,1530,568,171,1217,1225,73,39,343,41,140,31,131,309,34
80922,4130,3595,1332,1983,251,29,2175,1044,299,77,535,187,258,69,21,364,171
80925,844,781,255,442,76,8,389,290,102,0,63,21,37,5,0,36,27
80926,565,465,129,199,116,21,122,251,61,31,100,32,41,14,13,76,24
80928,359,294,50,184,58,2,129,135,24,6,65,18,16,15,16,59,6
80929,85,58,10,40,8,0,30,8,16,4,27,3,11,13,0,19,8
80930,203,166,36,90,30,10,71,52,16,27,37,3,15,19,0,37,0
81001,11768,7874,1977,3588,1752,557,2482,3070,1440,882,3894,829,1140,1123,802,3296,598
81003,5458,3079,795,1333,645,306,919,1047,624,489,2379,528,641,660,550,2031,348
81004,11197,6896,1797,2795,1616,688,1689,2606,1581,1020,4301,811,1394,1058,1038,3697,604
81005,10672,7773,1144,3518,2403,708,2286,3712,974,801,2899,385,769,853,892,2539,360
81006,4297,3309,406,1612,1060,231,1162,1523,292,332,988,124,319,293,252,846,142
81007,6148,5020,1169,2505,1140,206,2082,2210,529,199,1128,348,308,393,79,854,274
81008,2672,1888,396,835,496,161,593,873,272,150,784,92,196,262,234,714,70
81020,409,280,33,87,129,31,31,161,37,51,129,13,20,52,44,112,17
81021,7,7,2,1,4,0,2,4,1,0,0,0,0,0,0,0,0
81022,541,436,76,195,113,52,195,199,16,26,105,0,40,44,21,90,15
81023,501,337,33,157,133,14,130,197,5,5,164,0,73,69,22,125,39
81024,60,41,0,19,22,0,5,31,5,0,19,8,4,7,0,15,4
81025,402,280,31,128,102,19,73,156,22,29,122,10,47,47,18,90,32
81027,72,49,5,29,7,8,21,14,8,6,23,0,5,9,9,23,0
81029,171,143,17,71,43,12,61,70,8,4,28,4,5,13,6,28,0
81030,73,39,6,21,5,7,9,18,10,2,34,4,22,5,3,31,3
81033,60,47,8,22,13,4,10,25,9,3,13,0,2,7,4,13,0
81036,445,286,44,135,76,31,95,148,23,20,159,23,45,33,58,151,8
81039,814,566,96,238,172,60,167,314,59,26,248,39,53,87,69,237,11
81040,246,146,7,95,44,0,42,81,15,8,100,21,40,25,14,73,27
81041,278,210,39,105,46,20,99,72,23,16,68,16,19,23,10,42,26
81043,36,28,5,6,14,3,5,11,6,6,8,2,3,3,0,8,0
81044,109,72,11,35,25,1,29,29,10,4,37,5,16,14,2,35,2
81045,54,43,6,25,8,4,14,24,5,0,11,2,6,3,0,11,0
81047,718,520,120,227,134,39,230,215,51,24,198,20,57,49,72,176,22
81049,133,85,14,27,28,16,20,59,6,0,48,6,19,18,5,45,3
81050,4211,2928,660,1304,784,180,968,1235,545,180,1283,170,347,432,334,1159,124
81052,4080,2844,907,1129,664,144,1225,1105,317,197,1236,239,407,290,300,1086,150
81054,1610,1101,182,538,300,81,340,509,146,106,509,86,82,192,149,462,47
81055,684,438,47,208,148,35,124,241,51,22,246,29,112,58,47,209,37
81057,164,137,26,64,34,13,67,47,17,6,27,8,10,6,3,23,4
81058,407,277,48,126,79,24,94,138,32,13,130,27,34,38,31,104,26
81059,50,45,7,24,9,5,18,14,9,4,5,0,2,0,3,4,1
81062,347,258,66,122,50,20,109,103,25,21,89,15,26,26,22,82,7
81063,727,496,109,225,120,42,176,181,79,60,231,28,59,61,83,207,24
81064,153,115,11,42,36,26,35,65,7,8,38,6,4,9,19,38,0
81066,26,12,8,0,4,0,8,4,0,0,14,6,0,3,5,9,5
81067,2371,1665,328,698,506,133,502,767,220,176,706,72,223,276,135,623,83
81069,991,745,69,343,294,39,204,449,50,42,246,43,79,96,28,201,45
81071,153,112,22,47,37,6,35,61,12,4,41,17,6,4,14,36,5
81073,931,582,90,228,167,97,171,289,70,52,349,40,106,113,90,324,25
81076,193,138,17,78,22,21,54,65,12,7,55,7,18,14,16,45,10
81077,166,117,17,58,26,16,51,56,3,7,49,6,14,17,12,46,3
81081,27,25,0,14,5,6,8,15,0,2,2,0,0,0,2,2,0
81082,5114,3359,553,1610,888,308,1051,1448,520,340,1755,231,524,564,436,1549,206
81084,65,44,4,20,15,5,8,33,1,2,21,2,5,7,7,21,0
81087,70,53,6,20,19,8,13,37,3,0,17,0,4,7,6,14,3
81089,2044,1262,233,467,393,169,338,634,186,104,782,99,211,295,177,706,76
81090,542,354,60,150,115,29,145,170,23,16,188,24,45,58,61,166,22
81091,267,192,12,87,79,14,58,113,9,12,75,0,28,37,10,69,6
81092,314,247,37,145,55,10,96,127,20,4,67,10,26,19,12,57,10
81101,5162,3451,973,1612,683,183,1266,1434,581,170,1711,446,557,462,246,1455,256
81120,965,680,140,244,216,80,211,259,112,98,285,16,95,116,58,262,23
81121,106,85,3,47,26,9,27,52,6,0,21,3,4,14,0,21,0
81122,2140,1547,264,851,376,56,640,640,142,125,593,112,241,160,80,473,120
81123,291,236,34,121,65,16,100,109,17,10,55,7,18,20,10,49,6
81124,59,47,8,39,0,0,29,12,6,0,12,0,7,0,5,12,0
81125,1202,923,217,439,208,59,390,337,120,76,279,52,100,79,48,236,43
81126,63,36,6,15,10,5,5,17,6,8,27,0,20,4,3,27,0
81127,13,13,0,0,11,2,0,13,0,0,0,0,0,0,0,0,0
81128,34,30,6,14,6,4,6,17,7,0,4,0,0,0,4,4,0
81130,364,242,26,116,77,23,78,132,12,20,122,22,47,35,18,104,18
81131,432,200,24,100,58,18,43,107,40,10,232,26,113,86,7,190,42
81132,1276,934,216,389,255,74,358,418,106,52,342,55,78,118,91,298,44
81133,330,235,27,115,74,19,64,128,31,12,95,5,37,41,12,85,10
81136,102,82,14,50,17,1,44,29,3,6,20,2,10,5,3,18,2
81137,1759,1290,304,648,299,39,506,499,176,109,469,87,179,155,48,380,89
81140,864,636,73,325,182,56,267,244,76,49,228,14,63,77,74,212,16
81141,483,371,97,148,90,36,138,140,64,29,112,16,27,44,25,102,10
81143,245,161,25,95,37,4,39,80,23,19,84,17,29,25,13,59,25
81144,2931,2146,408,1066,505,167,834,912,320,80,785,204,229,199,153,683,102
81146,193,160,29,83,41,7,54,84,21,1,33,3,17,9,4,27,6
81147,3809,2744,400,1377,857,110,878,1363,325,178,1065,167,492,313,93,839,226
81148,148,119,25,66,28,0,44,42,19,14,29,5,7,13,4,23,6
81149,393,267,40,114,92,21,72,139,33,23,126,20,35,44,27,108,18
81151,497,391,80,172,83,56,154,166,40,31,106,23,35,26,22,98,8
81152,587,382,66,160,112,44,108,150,58,66,205,8,41,95,61,183,22
81153,139,84,9,38,28,9,26,35,15,8,55,0,18,23,14,46,9
81154,515,371,49,147,147,28,109,234,17,11,144,19,60,56,9,139,5
81155,47,41,0,24,17,0,9,29,0,3,6,0,2,2,2,6,0
81201,3886,2449,324,1166,726,233,719,1292,282,156,1437,279,473,371,314,1225,212
81210,71,43,6,26,11,0,23,20,0,0,28,10,18,0,0,8,20
81211,2258,1580,216,726,548,90,494,912,120,54,678,117,222,192,147,536,142
81212,9963,6620,1272,2918,1784,646,2072,3209,832,507,3343,389,897,1088,969,2946,397
81220,66,55,0,9,46,0,0,55,0,0,11,0,11,0,0,11,0
81221,66,46,6,23,15,2,18,17,9,2,20,0,3,10,7,18,2
81222,156,128,13,64,32,19,35,69,15,9,28,2,13,10,3,26,2
81223,586,450,42,220,173,15,121,281,35,13,136,6,50,68,12,106,30
81224,1228,577,141,370,66,0,289,212,62,14,651,385,221,42,3,264,387
81225,252,110,28,50,32,0,40,59,6,5,142,82,48,12,0,52,90
81226,2325,1624,478,641,419,86,557,715,239,113,701,39,272,230,160,614,87
81230,3688,2004,459,1016,437,92,756,912,191,145,1684,972,401,191,120,1100,584
81233,399,296,20,101,151,24,56,220,10,10,103,14,36,37,16,83,20
81235,338,228,25,119,71,13,54,147,18,9,110,25,61,19,5,89,21
81236,484,358,36,131,173,18,72,286,0,0,126,0,62,31,33,115,11
81239,81,57,2,18,30,7,5,49,3,0,24,3,11,10,0,19,5
81240,1628,1300,190,703,366,41,464,659,124,53,328,58,100,127,43,283,45
81241,30,26,2,7,10,7,5,17,0,4,4,0,4,0,0,2,2
81243,27,19,0,0,19,0,0,19,0,0,8,0,0,8,0,8,0
81244,67,50,5,19,22,4,7,35,0,8,17,0,7,4,6,16,1
81248,39,0,0,0,0,0,0,0,0,0,39,0,39,0,0,39,0
81251,92,57,8,17,25,7,10,38,0,9,35,0,21,14,0,28,7
81252,1359,984,102,486,349,47,299,583,68,34,375,56,127,112,80,331,44
81253,142,111,7,65,29,10,31,76,4,0,31,0,16,15,0,21,10
81301,12693,7568,1257,4078,1882,351,2545,3491,939,593,5125,2081,1671,861,512,3279,1846
81320,139,104,3,42,52,7,23,70,5,6,35,2,11,11,11,33,2
81321,5278,3659,829,1591,1001,238,1344,1530,448,337,1619,282,517,512,308,1395,224
81323,1740,1252,245,576,362,69,425,606,148,73,488,36,205,182,65,416,72
81324,521,381,48,165,126,42,99,207,44,31,140,15,51,43,31,122,18
81325,55,35,2,12,21,0,7,26,0,2,20,0,7,8,5,17,3
81326,766,551,110,298,121,22,215,232,51,53,215,19,120,50,26,172,43
81327,201,175,30,71,61,13,55,87,27,6,26,0,5,6,15,26,0
81328,1423,1013,154,502,286,71,315,521,123,54,410,37,139,154,80,335,75
81330,14,0,0,0,0,0,0,0,0,0,14,0,14,0,0,10,4
81331,88,60,0,28,32,0,16,37,0,7,28,28,0,0,0,10,18
81332,120,53,23,21,9,0,17,22,9,5,67,24,37,3,3,52,15
81334,429,352,107,182,58,5,101,72,102,77,77,18,40,14,5,64,13
81335,74,54,0,37,17,0,27,17,10,0,20,6,7,0,7,14,6
81401,10265,7261,1335,3301,2014,611,2536,3403,713,609,3004,382,920,931,771,2553,451
81410,608,449,58,185,170,36,140,248,33,28,159,5,39,60,55,123,36
81411,107,85,11,35,34,5,24,61,0,0,22,5,6,6,5,17,5
81413,1982,1421,126,549,551,195,350,880,100,91,561,31,123,209,198,508,53
81415,570,407,63,172,145,27,116,228,51,12,163,14,72,42,35,143,20
81416,4468,3241,671,1311,954,305,1091,1525,380,245,1227,167,354,340,366,1098,129
81418,639,477,89,116,201,71,130,299,29,19,162,0,61,57,44,154,8
81419,1586,1150,159,513,376,102,382,619,90,59,436,26,182,108,120,371,65
81422,356,212,44,87,74,7,65,95,33,19,144,15,49,51,29,117,27
81423,545,361,50,217,77,17,146,182,27,6,184,40,74,50,20,144,40
81424,510,374,48,199,106,21,110,183,57,24,136,13,25,57,41,130,6
81425,1562,1220,340,498,279,103,505,576,95,44,342,28,149,98,67,271,71
81426,128,39,3,36,0,0,14,23,2,0,89,38,45,6,0,55,34
81427,437,280,33,119,107,21,84,157,29,10,157,40,45,54,18,143,14
81428,1472,1003,122,515,284,82,343,501,91,68,469,52,150,161,106,421,48
81430,42,20,0,18,2,0,10,10,0,0,22,11,11,0,0,16,6
81431,155,95,8,47,32,8,23,59,12,1,60,10,18,27,5,50,10
81432,891,649,62,350,208,29,216,364,54,15,242,34,143,42,23,192,50
81433,261,150,14,89,43,4,31,74,34,11,111,16,56,32,7,98,13
81434,87,50,8,11,23,8,0,50,0,0,37,21,0,8,8,28,9
81435,2276,1009,231,610,159,9,310,466,190,43,1267,645,483,130,9,757,510
81501,8952,4466,1252,1856,940,418,1229,1894,858,485,4486,1326,1381,978,801,3486,1000
81503,9051,6911,1000,3355,2028,528,2351,3601,591,368,2140,213,905,592,430,1746,394
81504,8587,6479,1479,3042,1455,503,2403,2844,821,411,2108,373,609,601,525,1776,332
81505,2699,1880,309,960,505,106,643,951,149,137,819,114,275,243,187,672,147
81506,4054,2730,275,1183,854,418,788,1653,179,110,1324,147,185,473,519,1242,82
81520,4424,3229,1038,1465,600,126,1152,1086,731,260,1195,354,377,299,165,874,321
81521,3318,2463,466,1251,635,111,969,1046,293,155,855,130,223,273,229,727,128
81522,28,21,0,13,8,0,0,21,0,0,7,0,0,7,0,7,0
81523,225,184,17,119,35,13,70,93,13,8,41,0,27,14,0,26,15
81524,576,445,64,251,99,31,184,207,33,21,131,38,23,42,28,122,9
81525,195,162,23,70,63,6,47,91,9,15,33,11,6,16,0,18,15
81526,2055,1501,165,739,493,104,526,770,129,76,554,89,172,190,103,444,110
81527,541,396,48,227,109,12,123,246,14,13,145,9,61,67,8,107,38
81601,4908,3215,637,1819,630,129,1334,1291,342,248,1693,483,663,323,224,1264,429
81610,173,132,28,64,38,2,59,51,10,12,41,6,17,12,6,35,6
81611,4220,1809,225,952,565,67,631,810,212,156,2411,870,1024,463,54,1643,768
81615,843,412,45,248,100,19,160,211,29,12,431,192,174,56,9,282,149
81620,3583,1783,633,926,213,11,804,685,200,94,1800,1170,437,190,3,750,1050
81621,1928,1208,319,733,148,8,553,414,161,80,720,181,394,120,25,462,258
81623,4693,3316,692,2024,511,89,1490,1348,334,144,1377,293,717,284,83,875,502
81624,469,348,37,172,121,18,127,193,20,8,121,16,41,37,27,101,20
81625,4623,3349,750,1852,609,138,1345,1382,468,154,1274,283,467,342,182,1103,171
81630,349,271,43,137,79,12,100,120,42,9,78,3,41,26,8,67,11
81631,1482,1153,256,712,160,25,609,441,67,36,329,79,159,56,35,239,90
81632,2896,1831,430,1051,320,30,810,708,248,65,1065,560,416,79,10,580,485
81635,2041,1431,333,524,436,138,483,721,148,79,610,102,171,202,135,517,93
81637,1606,1245,351,747,134,13,704,381,120,40,361,129,157,60,15,223,138
81638,88,67,10,29,23,5,31,26,6,4,21,5,7,9,0,21,0
81639,831,617,125,336,134,22,247,259,81,30,214,38,120,37,19,166,48
81640,111,73,6,43,17,7,31,30,6,6,38,7,0,23,8,22,16
81641,1374,940,131,468,267,74,320,484,97,39,434,94,165,117,58,374,60
81642,53,13,0,13,0,0,0,9,0,4,40,8,12,20,0,32,8
81643,271,211,18,116,62,15,67,118,16,10,60,2,22,33,3,52,8
81645,353,217,68,97,47,5,91,89,17,20,136,54,64,14,4,85,51
81646,74,53,3,25,17,8,15,34,0,4,21,3,9,3,6,21,0
81647,1607,1282,372,715,172,23,612,465,129,76,325,91,147,75,12,228,97
81648,912,692,141,387,152,12,299,273,89,31,220,66,70,57,27,190,30
81649,112,70,17,21,25,7,25,30,1,14,42,22,11,0,9,21,21
81650,3633,2601,715,1411,403,72,1176,951,317,157,1032,220,383,300,129,827,205
81652,1143,810,202,430,156,22,323,357,89,41,333,46,148,107,32,279,54
81653,12,6,0,6,0,0,6,0,0,0,6,6,0,0,0,6,0
81654,508,255,40,170,45,0,118,84,40,13,253,79,115,57,2,173,80
81655,31,9,0,0,9,0,0,9,0,0,22,12,10,0,0,0,22
81656,164,70,4,33,33,0,11,39,0,20,94,38,44,12,0,75,19
81657,2456,914,227,424,234,29,233,501,86,94,1542,796,535,198,13,779,763
82001,14037,8682,2537,3815,1810,520,3154,3479,1365,684,5355,1527,1584,1251,993,4634,721
82007,6082,4192,1331,1773,863,225,1417,1496,835,444,1890,425,726,498,241,1475,415
82009,10393,7818,1175,4285,2032,326,2832,4058,704,224,2575,582,782,729,482,2221,354
82050,75,64,7,45,10,2,31,30,2,1,11,0,3,3,5,11,0
82051,26,12,0,0,12,0,0,12,0,0,14,0,8,6,0,14,0
82052,20,12,0,7,5,0,0,12,0,0,8,8,0,0,0,8,0
82053,359,285,44,157,70,14,139,123,18,5,74,0,33,12,29,60,14
82054,271,226,42,144,34,6,117,88,7,14,45,13,18,14,0,39,6
82055,60,33,6,13,0,14,0,18,7,8,27,7,13,7,0,7,20
82058,6,0,0,0,0,0,0,0,0,0,6,6,0,0,0,6,0
82059,25,17,0,6,11,0,6,11,0,0,8,0,0,0,8,8,0
82060,72,42,11,0,25,6,11,31,0,0,30,18,12,0,0,30,0
82061,7,7,0,7,0,0,7,0,0,0,0,0,0,0,0,0,0
82063,82,47,7,26,14,0,13,19,0,15,35,0,16,8,11,28,7
82070,6835,3834,1014,1744,847,229,1326,1777,389,342,3001,1484,812,417,288,2184,817
82072,6106,3022,1074,1272,491,185,1053,1346,393,230,3084,2113,517,318,136,1894,1190
82081,22,18,7,6,0,5,7,11,0,0,4,4,0,0,0,4,0
82082,694,479,88,214,129,48,187,216,43,33,215,47,41,64,63,187,28
82083,147,118,42,33,38,5,29,72,15,2,29,6,13,10,0,26,3
82084,7,7,0,0,7,0,0,7,0,0,0,0,0,0,0,0,0
82190,22,10,0,10,0,0,2,4,4,0,12,0,6,6,0,12,0
82201,2717,1927,296,885,546,200,668,1047,127,85,790,173,213,244,160,736,54
82210,164,142,47,47,38,10,86,42,8,6,22,2,10,8,2,21,1
82212,215,133,18,51,53,11,40,75,13,5,82,4,23,31,24,66,16
82213,242,141,11,72,49,9,45,82,6,8,101,7,26,43,25,88,13
82214,533,368,77,150,123,18,118,187,48,15,165,19,64,36,46,138,27
82215,71,48,4,15,16,13,11,26,7,4,23,0,9,10,4,21,2
82217,37,24,8,0,8,8,8,16,0,0,13,0,0,13,0,13,0
82218,126,110,52,29,29,0,65,29,9,7,16,0,0,0,16,16,0
82219,28,14,0,5,6,3,0,9,2,3,14,0,6,2,6,6,8
82221,132,98,34,39,20,5,40,40,14,4,34,5,16,4,9,33,1
82222,47,39,9,16,14,0,12,21,3,3,8,0,0,3,5,5,3
82223,444,345,43,161,119,22,113,199,15,18,99,15,32,40,12,83,16
82224,35,29,8,3,18,0,2,19,8,0,6,0,6,0,0,6,0
82225,852,567,80,267,154,66,192,293,54,28,285,35,63,108,79,261,24
82227,97,65,10,13,33,9,10,42,6,7,32,0,14,11,7,32,0
82240,3856,2536,494,1078,705,259,836,1231,246,223,1320,199,319,462,340,1149,171
82242,18,12,0,10,2,0,10,2,0,0,6,3,0,3,0,3,3
82243,44,44,6,30,0,8,21,23,0,0,0,0,0,0,0,0,0
82244,144,116,11,65,25,15,35,73,6,2,28,0,11,14,3,26,2
82301,3650,2487,542,1253,543,149,950,1060,318,159,1163,239,476,232,216,960,203
82310,59,37,0,21,10,6,7,30,0,0,22,0,8,7,7,22,0
82321,264,192,20,96,64,12,64,103,22,3,72,12,27,22,11,51,21
82322,47,33,4,19,10,0,14,14,3,2,14,3,5,6,0,14,0
82323,52,32,7,12,9,4,8,20,0,4,20,1,11,8,0,18,2
82324,138,94,7,52,27,8,25,66,2,1,44,22,4,7,11,35,9
82325,393,261,41,101,96,23,65,159,31,6,132,6,47,43,36,130,2
82327,354,245,44,132,58,11,102,95,34,14,109,8,37,49,15,85,24
82329,164,131,5,81,30,15,37,66,20,8,33,2,7,14,10,33,0
82331,1013,682,99,336,219,28,233,384,50,15,331,64,115,82,70,292,39
82332,62,24,7,10,0,7,7,7,10,0,38,8,7,9,14,38,0
82335,37,0,0,0,0,0,0,0,0,0,37,0,0,37,0,37,0
82336,147,106,24,40,35,7,25,63,10,8,41,8,18,13,2,33,8
82401,2962,2100,373,1051,513,163,742,975,224,159,862,153,217,254,238,771,91
82410,672,463,57,204,153,49,144,274,20,25,209,15,68,65,61,186,23
82411,186,145,28,77,23,17,82,47,12,4,41,8,11,9,13,36,5
82412,205,153,29,63,52,9,53,67,20,13,52,4,28,7,13,47,5
82414,6008,4156,645,2188,1121,202,1397,2221,409,129,1852,382,566,561,343,1596,256
82420,261,203,35,96,59,13,82,90,21,10,58,9,14,25,10,51,7
82421,250,184,28,89,52,15,79,83,12,10,66,15,15,19,17,59,7
82422,45,32,5,19,8,0,16,12,4,0,13,4,5,0,4,10,3
82423,12,12,2,4,6,0,0,4,4,4,0,0,0,0,0,0,0
82426,1089,741,113,342,218,68,235,360,91,55,348,62,79,133,74,309,39
82428,65,39,5,15,15,4,4,31,0,4,26,6,9,4,7,23,3
82430,39,24,2,5,17,0,0,24,0,0,15,0,6,7,2,15,0
82431,1239,902,159,406,270,67,319,430,107,46,337,78,49,104,106,289,48
82432,130,96,18,47,27,4,40,45,9,2,34,4,7,15,8,27,7
82433,321,224,33,119,62,10,104,101,12,7,97,23,26,33,15,97,0
82434,62,50,6,22,22,0,20,24,2,4,12,0,6,0,6,12,0
82435,3902,2660,411,1202,771,276,958,1322,248,132,1242,307,401,274,260,982,260
82440,24,19,0,13,6,0,13,6,0,0,5,0,0,5,0,5,0
82441,90,68,7,29,24,8,16,46,3,3,22,4,9,4,5,22,0
82442,339,219,25,87,92,15,66,122,23,8,120,4,45,43,28,108,12
82443,2078,1348,157,638,433,120,467,719,82,80,730,114,186,261,169,655,75
82501,6274,4331,770,2134,1116,311,1433,1943,597,358,1943,314,678,570,381,1641,302
82510,206,180,27,73,68,12,27,63,51,39,26,1,17,8,0,19,7
82512,116,84,15,28,34,7,23,41,10,10,32,2,15,13,2,22,10
82513,806,501,51,238,170,42,145,287,46,23,305,39,109,119,38,256,49
82514,539,415,126,189,89,11,134,81,132,68,124,23,50,36,15,107,17
82515,222,150,26,61,35,28,40,77,17,16,72,0,15,41,16,70,2
82516,217,149,6,83,53,7,43,78,14,14,68,14,28,7,19,51,17
82520,4336,3040,443,1638,805,154,999,1342,430,269,1296,162,464,416,254,1110,186
82523,339,262,43,131,78,10,84,141,21,16,77,15,22,25,15,68,9
82601,9710,5828,1370,2816,1311,331,1907,2538,969,414,3882,1041,1274,748,819,3220,662
82604,9259,6674,1216,3462,1624,372,2524,3008,745,397,2585,612,785,765,423,2054,531
82609,6558,4419,907,2270,1011,231,1448,1989,686,296,2139,511,766,632,230,1761,378
82620,78,69,24,10,31,4,34,35,0,0,9,9,0,0,0,9,0
82633,3185,2326,487,1256,446,137,966,987,295,78,859,131,306,276,146,742,117
82635,63,34,4,17,11,2,22,8,4,0,29,5,14,8,2,27,2
82636,487,368,49,226,87,6,145,194,22,7,119,10,65,44,0,102,17
82637,1498,1101,200,569,288,44,387,526,142,46,397,67,119,155,56,338,59
82639,321,221,49,78,65,29,95,104,14,8,100,18,33,29,20,96,4
82640,17,6,0,0,6,0,0,0,0,6,11,0,6,5,0,6,5
82642,32,22,2,10,8,2,6,13,2,1,10,0,4,4,2,10,0
82643,161,113,26,63,13,11,53,38,17,5,48,2,13,22,11,42,6
82644,473,267,72,80,94,21,78,122,38,29,206,41,72,75,18,165,41
82649,407,324,49,146,108,21,129,158,24,13,83,13,25,27,18,79,4
82701,1959,1425,223,707,412,83,502,726,127,70,534,90,154,142,148,476,58
82710,170,147,0,85,29,33,38,104,5,0,23,4,7,12,0,19,4
82711,61,61,0,29,32,0,6,14,18,23,0,0,0,0,0,0,0
82712,71,39,2,0,34,3,0,26,0,13,32,14,2,0,16,32,0
82714,27,17,0,7,10,0,7,10,0,0,10,0,0,0,10,10,0
82716,5697,3902,976,2107,705,114,1594,1499,598,211,1795,537,703,351,204,1405,390
82717,22,11,0,11,0,0,11,0,0,0,11,0,11,0,0,11,0
82718,5437,4372,1017,2779,550,26,2215,1559,472,126,1065,307,506,198,54,841,224
82720,389,275,37,130,96,12,99,143,29,4,114,19,42,31,22,94,20
82721,884,603,99,330,153,21,249,286,58,10,281,43,100,98,40,259,22
82723,167,112,9,45,52,6,19,68,7,18,55,5,22,14,14,41,14
82725,57,43,14,16,7,6,8,21,14,0,14,0,0,14,0,14,0
82727,345,291,34,198,48,11,167,103,21,0,54,0,29,8,17,39,15
82729,732,524,57,262,182,23,192,259,57,16,208,34,52,69,53,174,34
82730,533,383,63,192,81,47,166,188,21,8,150,18,33,50,49,141,9
82731,79,48,24,24,0,0,12,17,0,19,31,0,17,0,14,31,0
82732,538,408,99,255,54,0,206,143,38,21,130,39,71,20,0,107,23
82801,9323,5815,1155,2762,1466,432,1952,2857,653,353,3508,644,1014,1033,817,2990,518
82831,54,36,0,29,7,0,10,24,2,0,18,2,11,5,0,8,10
82832,174,109,5,74,27,3,40,58,5,6,65,11,15,25,14,65,0
82833,177,132,19,66,39,8,41,74,17,0,45,0,27,6,12,37,8
82834,2619,1792,256,835,513,188,547,949,197,99,827,75,232,264,256,740,87
82835,127,88,11,61,16,0,39,37,10,2,39,6,20,11,2,35,4
82836,377,259,42,133,70,14,95,132,19,13,118,8,34,52,24,112,6
82837,10,8,0,8,0,0,6,2,0,0,2,0,0,2,0,2,0
82838,116,94,3,62,25,4,31,60,3,0,22,0,7,15,0,15,7
82839,416,303,42,180,65,16,104,139,44,16,113,14,38,25,36,93,20
82842,413,280,32,110,115,23,91,149,30,10,133,2,63,43,25,110,23
82844,14,8,0,3,3,2,0,8,0,0,6,0,2,4,0,6,0
82845,16,10,2,2,6,0,3,6,0,1,6,3,0,0,3,6,0
82901,8909,6217,1425,3357,1147,288,2394,2586,868,369,2692,769,912,606,405,2279,413
82922,91,54,10,22,18,4,11,37,6,0,37,0,19,14,4,32,5
82923,177,130,6,92,24,8,59,57,14,0,47,4,39,0,4,43,4
82925,102,74,0,35,36,3,13,61,0,0,28,4,10,7,7,28,0
82929,24,16,16,0,0,0,10,0,6,0,8,0,8,0,0,8,0
82930,4763,3552,918,1935,590,109,1657,1185,527,183,1211,243,575,249,144,1030,181
82932,227,183,16,121,40,6,95,82,6,0,44,0,27,11,6,25,19
82933,339,254,60,118,63,13,95,115,26,18,85,17,37,24,7,76,9
82934,76,55,10,24,18,3,22,26,7,0,21,0,9,8,4,16,5
82935,4371,3387,641,2078,591,77,1479,1395,396,117,984,211,388,185,200,842,142
82936,19,19,3,14,2,0,9,8,2,0,0,0,0,0,0,0,0
82937,1001,795,167,463,141,24,397,289,78,31,206,33,80,56,37,184,22
82938,73,57,0,34,19,4,15,29,13,0,16,0,0,16,0,16,0
82939,651,513,116,271,111,15,224,212,58,19,138,40,61,23,14,125,13
82941,1092,743,153,319,221,50,228,405,83,27,349,64,150,98,37,274,75
82942,39,10,0,0,10,0,0,10,0,0,29,0,18,11,0,29,0
82943,86,64,29,18,8,9,30,25,0,9,22,0,8,14,0,22,0
82944,71,62,9,35,14,4,32,30,0,0,9,0,5,3,1,6,3
82945,106,66,2,37,26,1,22,34,8,2,40,2,26,12,0,33,7
83001,5584,3149,611,1811,617,110,1213,1338,341,257,2435,1076,926,332,101,1382,1053
83011,99,49,0,36,13,0,16,27,6,0,50,14,10,19,7,24,26
83012,195,98,7,79,12,0,48,40,5,5,97,39,52,0,6,69,28
83013,221,124,20,53,51,0,53,71,0,0,97,62,17,18,0,84,13
83014,1424,767,82,389,262,34,262,405,76,24,657,257,279,99,22,429,228
83101,1062,739,127,443,137,32,329,300,77,33,323,49,128,88,58,282,41
83110,1322,1060,194,489,300,77,511,449,81,19,262,44,84,70,64,233,29
83111,198,188,46,90,44,8,83,72,20,13,10,0,0,10,0,10,0
83112,172,138,9,89,30,10,29,102,7,0,34,0,13,0,21,34,0
83113,729,564,99,308,137,20,247,260,44,13,165,51,53,44,17,141,24
83114,282,216,26,105,64,21,91,102,12,11,66,11,9,23,23,60,6
83115,171,122,11,79,27,5,58,59,4,1,49,0,29,17,3,44,5
83116,370,235,29,104,84,18,74,129,16,16,135,17,56,29,33,125,10
83118,216,179,38,109,26,6,87,74,12,6,37,0,16,21,0,37,0
83119,18,18,6,8,0,4,14,4,0,0,0,0,0,0,0,0,0
83120,128,114,13,46,43,12,48,50,16,0,14,0,5,9,0,14,0
83121,17,6,0,3,2,1,3,3,0,0,11,0,2,0,9,9,2
83122,136,93,31,38,13,11,44,38,11,0,43,11,21,7,4,43,0
83123,230,154,17,94,39,4,74,61,15,4,76,10,36,23,7,55,21
83124,45,33,7,19,7,0,18,15,0,0,12,0,9,3,0,9,3
83126,75,53,9,34,5,5,15,33,5,0,22,0,6,8,8,22,0
83127,667,516,87,181,210,38,190,301,23,2,151,21,25,56,49,107,44
83128,392,273,81,111,74,7,94,154,17,8,119,32,48,31,8,65,54
83201,13257,9079,2705,3954,1852,568,3427,3839,1167,646,4178,1646,1015,825,692,3109,1069
83202,5651,4522,1231,2092,1003,196,1980,1686,515,341,1129,243,332,332,222,972,157
83203,151,104,33,50,21,0,20,30,40,14,47,11,16,10,10,44,3
83204,6658,4453,1363,2035,836,219,1766,1819,557,311,2205,707,758,437,303,1770,435
83210,1061,832,246,342,198,46,432,301,70,29,229,18,72,75,64,216,13
83211,2027,1545,378,716,362,89,664,626,172,83,482,84,141,135,122,435,47
83212,67,57,4,38,12,3,25,20,4,8,10,0,0,6,4,10,0
83213,679,466,85,212,128,41,159,228,51,28,213,21,50,95,47,193,20
83214,183,157,16,104,24,13,99,53,3,2,26,5,3,6,12,21,5
83215,13,8,0,0,5,3,0,8,0,0,5,0,3,2,0,5,0
83217,282,214,40,97,55,22,102,96,8,8,68,2,8,14,44,64,4
83218,41,41,9,9,12,11,13,21,5,2,0,0,0,0,0,0,0
83220,59,36,0,15,15,6,8,21,0,7,23,0,0,23,0,23,0
83221,7965,6457,1573,2950,1511,423,2796,2528,753,380,1508,252,471,434,351,1375,133
83223,86,76,8,40,20,8,38,32,1,5,10,0,4,0,6,10,0
83226,961,648,102,319,185,42,230,328,70,20,313,24,104,113,72,278,35
83227,116,88,18,49,11,10,36,46,2,4,28,0,6,22,0,21,7
83228,182,157,34,71,34,18,71,62,19,5,25,0,5,8,12,25,0
83232,73,61,19,25,17,0,25,31,5,0,12,2,0,0,10,12,0
83234,406,294,46,121,84,43,122,119,23,30,112,4,27,41,40,112,0
83235,30,23,12,7,4,0,19,4,0,0,7,0,0,7,0,7,0
83236,691,551,104,261,141,45,257,211,56,27,140,22,26,41,51,128,12
83237,264,214,84,86,35,9,136,53,9,16,50,2,7,22,19,50,0
83238,26,18,0,7,5,6,12,6,0,0,8,0,0,8,0,8,0
83239,183,156,41,77,33,5,90,54,12,0,27,1,0,10,16,25,2
83241,721,545,89,233,151,72,221,274,27,23,176,32,37,43,64,165,11
83243,40,36,0,18,12,6,20,12,0,4,4,0,0,4,0,4,0
83244,114,100,16,50,31,3,40,55,0,5,14,6,8,0,0,10,4
83245,533,424,72,230,93,29,176,206,26,16,109,0,70,32,7,85,24
83246,384,241,28,97,84,32,78,123,27,13,143,11,59,37,36,129,14
83250,705,585,81,294,188,22,246,291,31,17,120,5,40,50,25,108,12
83251,433,274,36,135,81,22,107,133,24,10,159,12,37,69,41,141,18
83252,1396,1077,200,497,269,111,479,494,63,41,319,24,77,96,122,316,3
83253,69,58,12,24,19,3,29,26,0,3,11,0,4,7,0,11,0
83254,1483,1097,217,483,298,99,445,506,93,53,386,38,86,125,137,351,35
83255,376,310,29,145,101,35,120,152,22,16,66,8,15,30,13,58,8
83261,222,166,36,67,44,19,79,74,9,4,56,8,8,17,23,56,0
83262,422,335,41,198,77,19,160,136,26,13,87,20,17,17,33,82,5
83263,2616,2164,573,886,539,166,1095,859,121,89,452,34,136,103,179,425,27
83271,179,151,22,60,51,18,57,79,7,8,28,0,10,12,6,25,3
83272,85,71,11,15,35,10,22,48,0,1,14,0,2,2,10,14,0
83274,2569,2184,508,1047,538,91,1088,833,183,80,385,64,114,116,91,352,33
83276,1530,1202,218,667,276,41,564,497,116,25,328,50,108,115,55,285,43
83277,42,35,4,26,5,0,20,15,0,0,7,0,0,7,0,7,0
83278,109,53,9,31,10,3,18,29,6,0,56,11,36,9,0,42,14
83281,49,49,11,26,6,6,14,35,0,0,0,0,0,0,0,0,0
83283,39,29,8,16,5,0,21,8,0,0,10,3,0,3,4,10,0
83285,40,26,3,20,0,3,10,16,0,0,14,0,6,0,8,14,0
83286,312,266,59,128,50,29,161,76,15,14,46,3,10,14,19,43,3
83287,71,49,5,23,18,3,8,40,0,1,22,0,2,10,10,22,0
83301,15789,10933,2638,4827,2581,887,3826,4724,1507,876,4856,1149,1340,1282,1085,3937,919
83302,103,66,22,40,2,2,37,10,19,0,37,7,0,22,8,37,0
83311,160,128,5,56,50,17,51,69,6,2,32,2,7,15,8,27,5
83312,15,15,0,5,5,5,5,10,0,0,0,0,0,0,0,0,0
83313,1157,862,176,485,165,36,348,391,57,66,295,42,178,60,15,222,73
83314,327,247,79,111,48,9,140,75,18,14,80,5,35,29,11,60,20
83316,3423,2511,436,1189,672,214,882,1168,252,209,912,129,207,262,314,772,140
83318,5329,4103,975,1879,942,307,1876,1561,451,215,1226,232,270,422,302,1083,143
83320,275,221,41,118,36,26,114,86,10,11,54,6,13,16,19,47,7
83321,207,149,33,58,50,8,51,69,20,9,58,6,18,15,19,51,7
83322,19,14,0,6,8,0,2,12,0,0,5,5,0,0,0,5,0
83323,659,564,117,332,108,7,337,163,39,25,95,15,31,26,23,82,13
83324,181,146,29,77,35,5,80,48,8,10,35,4,11,16,4,28,7
83325,399,295,51,146,75,23,107,159,14,15,104,26,41,7,30,96,8
83327,351,257,36,119,91,11,95,137,15,10,94,20,15,33,26,78,16
83328,1671,1238,277,596,285,80,507,528,119,84,433,63,107,139,124,359,74
83330,2188,1572,281,685,467,139,583,696,206,87,616,80,109,209,218,544,72
83332,950,674,117,278,192,87,220,362,54,38,276,28,38,133,77,216,60
83333,3158,2175,435,1322,360,58,1057,799,241,78,983,232,482,200,69,710,273
83334,694,512,114,232,138,28,211,199,76,26,182,22,85,39,36,131,51
83335,564,468,103,220,107,38,251,184,28,5,96,19,12,30,35,78,18
83336,1680,1350,285,641,325,99,549,577,121,103,330,61,99,108,62,279,51
83337,9,5,3,2,0,0,5,0,0,0,4,0,2,0,2,4,0
83338,5410,4114,890,2020,908,296,1738,1731,444,201,1296,205,372,365,354,1075,221
83340,2698,1311,178,697,389,47,388,719,136,68,1387,383,566,389,49,996,391
83341,1591,1255,253,632,278,92,599,533,75,48,336,55,78,123,80,292,44
83342,383,310,50,128,79,53,104,171,27,8,73,17,20,28,8,64,9
83344,369,311,75,137,77,22,142,144,12,13,58,8,21,13,16,53,5
83346,430,339,79,131,97,32,172,132,24,11,91,5,16,30,40,89,2
83347,1125,823,156,345,262,60,343,372,65,43,302,40,85,78,99,256,46
83348,56,30,7,0,23,0,13,12,0,5,26,11,9,6,0,26,0
83349,302,221,49,103,61,8,102,100,12,7,81,12,13,31,25,69,12
83350,4314,3324,777,1437,800,310,1391,1405,302,226,990,100,293,314,283,884,106
83352,929,654,125,314,158,57,257,286,60,51,275,42,82,83,68,229,46
83353,348,214,15,77,104,18,52,147,10,5,134,21,41,48,24,109,25
83354,62,27,8,6,10,3,4,17,3,3,35,5,8,15,7,23,12
83355,1585,1261,370,556,238,97,608,497,119,37,324,54,99,111,60,259,65
83401,9998,7526,1903,3615,1551,457,3289,2857,981,399,2472,569,730,637,536,2114,358
83402,9160,6334,1651,3092,1291,300,2851,2322,727,434,2826,590,991,857,388,2351,475
83404,6556,5072,940,2446,1346,340,2062,2274,485,251,1484,288,460,395,341,1265,219
83406,2469,2103,450,1121,420,112,1165,782,132,24,366,55,99,152,60,330,36
83420,850,646,133,267,178,68,268,322,39,17,204,14,41,78,71,185,19
83421,88,88,0,34,39,15,22,66,0,0,0,0,0,0,0,0,0
83422,726,542,134,304,80,24,259,192,51,40,184,50,75,31,28,136,48
83423,308,235,58,120,51,6,120,70,32,13,73,5,25,30,13,63,10
83424,54,54,6,41,7,0,35,15,4,0,0,0,0,0,0,0,0
83425,189,162,47,76,32,7,105,43,3,11,27,1,7,8,11,23,4
83427,205,185,31,72,48,34,72,78,10,25,20,4,4,3,9,19,1
83428,115,84,4,43,31,6,26,54,1,3,31,0,5,15,11,26,5
83429,329,231,21,91,102,17,51,167,8,5,98,24,27,47,0,76,22
83431,252,197,49,98,37,13,96,79,15,7,55,12,19,13,11,52,3
83433,12,6,0,6,0,0,3,2,1,0,6,2,4,0,0,6,0
83434,492,410,57,218,115,20,198,147,38,27,82,8,12,20,42,72,10
83435,170,128,27,67,22,12,68,42,8,10,42,12,5,18,7,35,7
83436,182,171,39,70,33,29,75,69,27,0,11,0,3,0,8,10,1
83440,6623,4414,1537,1749,933,195,2206,1656,347,205,2209,1457,239,268,245,834,1375
83442,3973,3316,746,1606,783,181,1660,1310,189,157,657,72,178,227,180,593,64
83443,277,213,56,80,61,16,89,90,27,7,64,8,13,17,26,60,4
83444,355,305,57,145,94,9,149,118,23,15,50,4,5,17,24,44,6
83445,2127,1682,368,753,438,123,824,677,130,51,445,81,125,120,119,404,41
83446,8,8,0,4,4,0,4,4,0,0,0,0,0,0,0,0,0
83448,586,509,77,276,111,45,274,187,29,19,77,14,16,38,9,71,6
83449,145,112,12,49,42,9,32,72,5,3,33,2,10,9,12,29,4
83450,295,246,79,117,32,18,152,64,17,13,49,12,7,14,16,38,11
83451,217,174,38,100,24,12,89,54,17,14,43,4,8,19,12,37,6
83452,360,239,52,126,55,6,109,107,15,8,121,34,43,27,17,101,20
83455,925,636,173,312,104,47,278,272,59,27,289,78,121,74,16,204,85
83462,257,210,4,100,83,23,65,145,0,0,47,0,29,11,7,37,10
83463,29,22,5,6,11,0,5,17,0,0,7,0,0,7,0,7,0
83464,133,101,15,61,22,3,54,37,8,2,32,3,6,18,5,30,2
83465,36,26,9,12,4,1,14,11,1,0,10,0,0,9,1,8,2
83466,109,49,0,29,20,0,11,38,0,0,60,0,37,23,0,55,5
83467,2572,1685,284,731,503,167,529,876,194,86,887,84,240,296,267,741,146
83468,74,59,4,38,12,5,30,27,2,0,15,0,4,3,8,15,0
83469,12,12,0,0,12,0,0,12,0,0,0,0,0,0,0,0,0
83501,13449,8756,1846,3853,2210,847,2790,4202,1072,692,4693,1204,1409,1040,1040,3685,1008
83520,37,27,5,16,6,0,11,10,5,1,10,4,6,0,0,7,3
83522,639,471,74,228,128,41,220,184,36,31,168,31,54,54,29,140,28
83523,362,255,30,125,84,16,74,144,26,11,107,24,28,28,27,94,13
83524,320,242,33,116,74,19,78,122,21,21,78,9,38,26,5,67,11
83525,172,89,0,67,22,0,25,64,0,0,83,7,33,37,6,83,0
83526,86,62,13,23,20,6,24,30,4,4,24,4,6,8,6,20,4
83530,2091,1454,240,689,391,134,598,622,140,94,637,86,183,197,171,560,77
83533,66,57,6,35,13,3,23,27,0,7,9,3,0,4,2,7,2
83535,428,318,45,130,101,42,101,179,16,22,110,16,32,30,32,99,11
83536,1516,1080,139,506,336,99,339,561,130,50,436,42,97,192,105,382,54
83537,471,339,68,132,111,28,124,169,33,13,132,18,35,37,42,114,18
83539,1206,855,82,397,316,60,188,533,97,37,351,11,91,151,98,300,51
83540,744,574,117,288,142,27,163,231,105,75,170,22,49,65,34,141,29
83541,460,330,34,152,102,42,87,219,12,12,130,7,41,52,30,108,22
83542,91,62,0,22,28,12,29,33,0,0,29,8,7,8,6,21,8
83543,267,190,25,92,61,12,76,97,11,6,77,5,25,24,23,73,4
83544,2326,1619,239,727,513,140,500,848,173,98,707,95,175,248,189,611,96
83545,220,163,15,78,56,14,44,91,20,8,57,5,10,32,10,50,7
83546,296,240,38,114,81,7,82,130,15,13,56,13,15,27,1,49,7
83547,123,97,0,25,60,12,12,77,8,0,26,0,6,20,0,11,15
83548,43,30,7,12,7,4,17,11,2,0,13,3,5,2,3,11,2
83549,361,220,23,98,64,35,40,119,27,34,141,14,53,30,44,123,18
83552,117,80,6,45,23,6,30,39,8,3,37,4,14,14,5,28,9
83553,447,338,42,150,135,11,105,183,45,5,109,8,46,30,25,96,13
83554,201,156,0,67,81,8,27,121,6,2,45,2,13,26,4,41,4
83555,171,133,10,59,50,14,38,77,9,9,38,5,11,10,12,32,6
83601,45,28,0,17,11,0,0,28,0,0,17,0,0,17,0,17,0
83602,19,7,0,7,0,0,0,7,0,0,12,0,4,4,4,12,0
83604,316,242,50,118,61,13,118,102,5,17,74,4,24,22,24,67,7
83605,9076,6421,1904,2794,1287,436,2499,2387,968,567,2655,558,688,760,649,2162,493
83607,5490,4568,1044,1986,1228,310,1808,2116,443,201,922,192,355,254,121,742,180
83610,406,278,32,122,91,33,97,141,21,19,128,11,37,46,34,106,22
83611,898,663,88,280,258,37,186,379,72,26,235,11,70,109,45,209,26
83612,696,505,49,224,198,34,154,292,35,24,191,20,59,72,40,168,23
83615,269,198,30,70,51,47,62,111,13,12,71,23,32,14,2,43,28
83616,5162,4251,638,2612,773,228,2117,1679,334,121,911,129,369,263,150,780,131
83617,5199,3928,739,1737,1053,399,1473,1831,345,279,1271,146,376,369,380,1099,172
83619,2145,1625,401,683,406,135,575,656,275,119,520,85,132,156,147,436,84
83620,94,71,6,18,43,4,13,53,3,2,23,2,7,6,8,20,3
83622,717,522,51,248,190,33,156,303,41,22,195,16,81,62,36,156,39
83623,707,522,122,235,125,40,204,217,66,35,185,19,53,45,68,159,26
83624,419,285,67,135,67,16,103,130,44,8,134,34,38,46,16,121,13
83626,372,309,53,186,48,22,127,119,49,14,63,6,29,10,18,60,3
83627,188,145,23,79,25,18,79,63,3,0,43,0,16,16,11,35,8
83628,1450,1068,278,452,262,76,476,417,112,63,382,36,102,139,105,342,40
83629,606,447,93,211,121,22,169,202,40,36,159,18,53,42,46,127,32
83631,486,337,66,165,99,7,107,154,62,14,149,19,84,32,14,119,30
83632,96,62,2,26,28,6,19,39,2,2,34,2,9,17,6,31,3
83633,150,116,12,48,54,2,29,75,4,8,34,4,4,14,12,28,6
83634,3258,2741,1008,1307,336,90,1424,921,328,68,517,156,156,95,110,408,109
83637,84,51,4,16,23,8,7,36,2,6,33,0,16,13,4,28,5
83638,2018,1422,174,767,422,59,493,787,91,51,596,100,238,193,65,517,79
83639,899,700,155,326,171,48,268,319,66,47,199,40,65,45,49,155,44
83641,926,696,137,335,181,43,315,309,44,28,230,41,50,89,50,198,32
83642,15595,12690,3685,6286,2329,390,6117,4712,1245,616,2905,760,1093,640,412,2203,702
83643,48,41,0,19,22,0,5,27,7,2,7,0,0,7,0,7,0
83644,2171,1697,482,837,293,85,781,697,158,61,474,58,182,140,94,391,83
83645,251,189,21,74,81,13,65,108,9,7,62,2,15,23,22,52,10
83647,6395,4500,1175,2210,958,157,1746,1880,603,271,1895,647,595,447,206,1591,304
83648,1467,1427,969,452,6,0,993,315,119,0,40,16,24,0,0,12,28
83650,200,150,13,96,29,12,61,75,6,8,50,11,21,7,11,36,14
83651,7700,5336,1536,2141,1163,496,2085,2147,670,434,2364,429,571,629,735,2030,334
83654,511,377,60,178,114,25,109,211,43,14,134,13,76,18,27,112,22
83655,1338,1029,207,471,269,82,436,450,99,44,309,49,82,89,89,258,51
83656,101,76,19,34,20,3,39,19,10,8,25,0,4,19,2,21,4
83657,56,42,0,0,36,6,0,42,0,0,14,5,0,9,0,5,9
83660,1807,1438,260,694,344,140,567,652,113,106,369,74,58,122,115,321,48
83661,3558,2612,573,1162,648,229,1017,1124,302,169,946,200,238,326,182,817,129
83666,25,19,0,6,11,2,2,17,0,0,6,0,0,4,2,6,0
83669,1029,803,263,351,147,42,326,359,85,33,226,57,82,61,26,163,63
83670,113,77,7,25,27,18,33,39,5,0,36,0,21,15,0,21,15
83671,8,8,0,0,8,0,0,8,0,0,0,0,0,0,0,0,0
83672,3098,2269,499,916,642,212,875,1025,189,180,829,90,197,261,281,720,109
83676,1237,1017,182,500,279,56,428,429,94,66,220,12,73,83,52,196,24
83677,37,16,0,4,12,0,0,16,0,0,21,0,10,11,0,21,0
83686,10470,8304,2529,3677,1569,529,3603,3283,1007,411,2166,555,686,517,408,1710,456
83687,6302,4885,1893,1945,840,207,2160,1821,636,268,1417,404,462,346,205,1072,345
83702,10400,5018,1260,2534,847,377,1662,2292,702,362,5382,2377,1684,899,422,4081,1301
83703,10196,6914,1741,3571,1302,300,2735,2895,887,397,3282,906,1158,704,514,2482,800
83704,14555,9904,2328,4893,2012,671,3729,4136,1278,761,4651,1175,1517,1079,880,3626,1025
83705,11558,6663,2178,2798,1196,491,2167,2574,1261,661,4895,1635,1498,888,874,3714,1181
83706,12909,7385,2034,3605,1291,455,2718,3090,991,586,5524,2345,1762,788,629,4100,1424
83709,11525,9399,1657,5076,2282,384,3915,4070,848,566,2126,418,868,555,285,1595,531
83712,3646,2168,385,1156,466,161,735,1045,213,175,1478,531,402,311,234,1116,362
83713,7669,6050,1654,3224,971,201,2955,2167,647,281,1619,404,660,384,171,1279,340
83714,3177,2004,803,755,343,103,602,695,490,217,1173,214,521,288,150,885,288
83716,3790,2840,951,1484,352,53,1351,1112,300,77,950,315,448,148,39,655,295
83788,0,0,0,0,0,0,0,0,0,0,0,0,0,0,0,0,0
83801,1786,1384,281,724,308,71,475,739,123,47,402,48,143,141,70,305,97
83802,57,32,4,13,15,0,6,17,5,4,25,5,10,10,0,20,5
83803,133,71,0,3,57,11,0,59,3,9,62,0,22,13,27,51,11
83804,441,318,41,128,149,0,74,190,34,20,123,14,47,19,43,104,19
83805,2402,1742,311,838,459,134,634,784,217,107,660,109,164,230,157,591,69
83806,130,88,33,36,19,0,54,25,6,3,42,3,15,20,4,30,12
83808,51,33,5,13,15,0,7,20,5,1,18,0,9,4,5,16,2
83809,188,147,11,81,43,12,38,92,10,7,41,0,16,25,0,27,14
83810,468,355,26,205,120,4,111,202,32,10,113,7,31,40,35,108,5
83811,507,335,21,172,129,13,92,191,27,25,172,10,83,46,33,144,28
83812,32,27,5,9,8,5,11,16,0,0,5,0,2,3,0,5,0
83813,402,313,41,140,109,23,88,197,20,8,89,8,27,34,20,65,24
83814,9231,5750,1309,2575,1448,418,1722,2638,893,497,3481,967,1153,732,629,2677,804
83815,8683,6181,1235,2945,1510,491,2255,2741,765,420,2502,544,651,690,617,2011,491
83821,106,56,0,12,30,14,12,44,0,0,50,0,28,7,15,42,8
83822,749,529,120,205,167,37,119,279,88,43,220,27,71,78,44,177,43
83823,484,358,44,206,72,36,110,182,36,30,126,23,41,47,15,84,42
83824,89,76,15,41,18,2,32,22,10,12,13,0,9,3,1,9,4
83826,69,44,0,21,23,0,0,33,11,0,25,0,13,12,0,25,0
83827,70,57,2,26,25,4,6,41,4,6,13,0,2,6,5,11,2
83830,221,143,16,87,26,14,66,46,9,22,78,17,9,32,20,78,0
83832,588,456,93,214,116,33,196,199,31,30,132,21,54,38,19,112,20
83833,599,411,38,161,172,40,123,250,22,16,188,13,76,68,31,159,29
83834,85,48,13,18,17,0,13,35,0,0,37,0,10,11,16,37,0
83835,5613,4374,790,2162,1142,280,1773,2025,353,223,1239,239,364,436,200,1002,237
83836,444,330,16,150,114,50,87,211,29,3,114,9,33,58,14,96,18
83837,1309,827,205,376,177,69,243,390,156,38,482,86,115,158,123,414,68
83839,652,477,51,271,146,9,170,255,40,12,175,31,34,58,52,148,27
83841,123,113,0,64,24,25,9,88,16,0,10,10,0,0,0,0,10
83842,61,48,6,24,12,6,11,33,4,0,13,2,2,2,7,13,0
83843,9173,4988,1580,2188,985,235,1992,2255,483,258,4185,2532,914,368,371,2608,1577
83845,559,438,78,221,125,14,172,205,48,13,121,35,65,16,5,83,38
83846,310,193,36,86,44,27,62,94,25,12,117,12,40,30,35,100,17
83847,598,402,28,238,120,16,101,238,51,12,196,43,82,65,6,149,47
83848,116,71,5,46,7,13,12,54,5,0,45,0,19,26,0,45,0
83849,952,639,77,276,239,47,162,364,67,46,313,29,81,128,75,261,52
83850,1011,686,134,261,215,76,168,403,78,37,325,13,116,113,83,266,59
83851,557,422,98,166,136,22,132,183,50,57,135,26,41,52,16,114,21
83852,105,66,5,46,9,6,15,32,11,8,39,0,10,11,18,30,9
83853,62,54,4,21,29,0,16,31,0,7,8,0,0,8,0,8,0
83854,9999,7522,1977,3458,1670,417,2935,3117,1040,430,2477,549,936,520,472,1963,514
83855,814,609,132,277,147,53,225,297,50,37,205,30,46,70,59,174,31
83856,2351,1693,307,840,468,78,610,829,193,61,658,72,267,236,83,493,165
83857,297,221,49,104,51,17,101,106,14,0,76,4,40,0,32,58,18
83858,3515,2895,604,1627,596,68,1241,1171,389,94,620,128,225,202,65,496,124
83860,2058,1513,185,753,478,97,521,834,126,32,545,114,190,200,41,429,116
83861,2550,1828,346,849,532,101,659,913,177,79,722,107,206,246,163,598,124
83864,6563,4374,765,2309,1077,223,1524,2036,594,220,2189,413,779,584,413,1760,429
83866,141,74,0,26,41,7,20,54,0,0,67,6,28,33,0,53,14
83867,104,84,22,33,22,7,33,43,8,0,20,0,15,5,0,15,5
83868,311,155,38,70,34,13,41,65,31,18,156,19,65,55,17,116,40
83869,1291,1011,207,494,272,38,440,428,108,35,280,25,137,82,36,235,45
83870,161,121,19,56,40,6,20,69,21,11,40,5,20,5,10,35,5
83871,685,533,118,245,146,24,202,276,53,2,152,31,29,53,39,136,16
83872,234,172,15,106,43,8,61,103,8,0,62,0,29,25,8,50,12
83873,1043,656,122,303,182,49,165,329,104,58,387,37,137,117,96,354,33
83874,30,15,3,7,5,0,3,12,0,0,15,0,0,15,0,15,0
83876,486,368,68,172,109,19,113,173,41,41,118,26,25,43,24,106,12
84001,264,224,47,104,59,14,112,91,16,5,40,10,10,9,11,33,7
84002,42,34,5,11,18,0,14,18,2,0,8,1,1,0,6,7,1
84003,7725,6870,1821,3410,1379,260,3995,2184,449,242,855,208,193,223,231,749,106
84004,1776,1657,221,992,396,48,1032,513,68,44,119,30,25,22,42,105,14
84006,272,214,102,62,14,36,92,60,57,5,58,0,15,17,26,46,12
84007,159,124,25,66,31,2,66,38,16,4,35,5,4,18,8,35,0
84010,14221,11500,2538,4642,3400,920,4724,5261,823,692,2721,530,789,704,698,2377,344
84013,226,210,74,86,45,5,120,78,7,5,16,0,5,2,9,16,0
84014,3975,3423,537,2015,739,132,1822,1216,198,187,552,106,199,137,110,477,75
84015,13567,10985,3935,4921,1555,574,5368,3487,1446,684,2582,828,921,535,298,2043,539
84017,1012,800,189,384,170,57,403,313,42,42,212,37,81,45,49,183,29
84018,23,20,15,5,0,0,15,5,0,0,3,3,0,0,0,0,3
84020,6530,5683,1933,2831,825,94,3196,1941,348,198,847,307,317,201,22,697,150
84021,862,626,148,262,187,29,266,284,56,20,236,20,68,105,43,208,28
84022,454,354,149,150,55,0,210,109,33,2,100,4,79,10,7,86,14
84023,101,63,14,31,16,2,27,36,0,0,38,19,12,7,0,34,4
84024,33,28,4,19,5,0,10,18,0,0,5,0,0,5,0,5,0
84025,3244,2977,505,1706,667,99,1657,999,207,114,267,52,88,84,43,229,38
84026,334,274,46,140,80,8,75,62,72,65,60,11,18,22,9,56,4
84027,121,89,10,33,43,3,35,46,0,8,32,4,2,24,2,26,6
84028,164,119,10,57,52,0,43,61,9,6,45,5,17,10,13,36,9
84029,2032,1665,393,783,379,110,785,599,162,119,367,61,95,133,78,322,45
84031,71,60,13,20,26,1,27,23,6,4,11,0,3,6,2,11,0
84032,3528,2903,830,1360,577,136,1504,971,249,179,625,161,194,162,108,490,135
84033,275,241,61,111,58,11,118,94,23,6,34,0,6,5,23,34,0
84034,29,12,0,4,8,0,0,8,4,0,17,0,1,0,16,16,1
84035,242,183,59,65,46,13,99,78,6,0,59,19,20,5,15,59,0
84036,1280,1024,206,526,256,36,477,419,84,44,256,54,73,69,60,210,46
84037,6788,5975,1221,3222,1246,286,3527,1768,417,263,813,160,159,306,188,715,98
84038,121,106,6,53,36,11,48,54,2,2,15,4,3,4,4,15,0
84039,215,182,50,77,41,14,94,75,6,7,33,10,3,12,8,24,9
84040,6385,5825,962,3556,1120,187,3271,1916,363,275,560,115,224,143,78,448,112
84041,12356,9524,3939,3887,1372,326,4627,2853,1343,701,2832,1068,915,565,284,2211,621
84042,2017,1885,479,1018,334,54,1236,550,90,9,132,26,74,23,9,110,22
84043,6324,5771,2629,2272,742,128,3704,1570,355,142,553,97,198,126,132,484,69
84044,6625,5561,1913,2595,804,249,2815,1644,681,421,1064,270,386,222,186,846,218
84046,243,186,35,71,68,12,58,97,19,12,57,0,20,32,5,55,2
84047,10848,6992,2673,2365,1446,508,2335,2646,1134,877,3856,1479,1245,677,455,2925,931
84049,960,768,151,366,204,47,354,340,50,24,192,20,69,65,38,168,24
84050,2036,1778,258,947,503,70,914,706,87,71,258,12,45,106,95,243,15
84051,84,72,25,30,14,3,35,29,4,4,12,0,3,2,7,12,0
84052,381,318,87,135,82,14,152,115,23,28,63,2,24,25,12,55,8
84053,181,158,36,73,42,7,77,63,12,6,23,3,11,4,5,22,1
84054,2846,2215,679,954,493,89,985,862,222,146,631,176,199,142,114,488,143
84055,163,135,25,83,27,0,60,58,5,12,28,0,18,5,5,22,6
84056,1165,1159,704,444,11,0,859,204,93,3,6,6,0,0,0,6,0
84057,10062,8331,3150,3555,1287,339,4413,2509,809,600,1731,479,460,418,374,1384,347
84058,8106,6315,2621,2352,1123,219,3240,2023,568,484,1791,1004,352,242,193,1089,702
84060,2701,1735,368,1006,339,22,723,731,215,66,966,418,376,140,32,563,403
84061,185,157,26,102,19,10,79,66,10,2,28,0,13,12,3,15,13
84062,6959,6276,1953,2988,1108,227,3815,1791,375,295,683,145,205,221,112,601,82
84063,167,133,25,70,31,7,39,49,22,23,34,2,21,3,8,29,5
84064,253,203,35,91,54,23,108,84,7,4,50,6,7,22,15,46,4
84065,8435,7813,2282,4434,887,210,5027,2134,498,154,622,121,206,189,106,530,92
84066,2724,2242,596,1040,449,157,1082,762,287,111,482,98,167,144,73,415,67
84067,11164,9074,2865,4141,1677,391,4343,3182,959,590,2090,504,756,536,294,1714,376
84069,147,125,15,58,37,15,51,51,5,18,22,5,10,5,2,17,5
84070,7648,5756,2028,2550,1016,162,2690,2058,563,445,1892,443,633,417,399,1519,373
84071,167,114,19,64,26,5,59,45,5,5,53,2,26,14,11,51,2
84072,127,110,9,68,32,1,50,42,10,8,17,2,2,7,6,13,4
84073,85,65,10,24,24,7,22,40,0,3,20,5,3,4,8,20,0
84074,9314,7576,2704,3207,1409,256,3785,2649,723,419,1738,326,604,407,401,1538,200
84075,2777,2548,873,1195,443,37,1537,872,109,30,229,31,60,86,52,219,10
84076,95,87,12,49,23,3,44,25,7,11,8,2,2,2,2,6,2
84078,6425,5111,1241,2407,1171,292,2337,1965,565,244,1314,276,377,392,269,1113,201
84080,95,75,16,39,12,8,38,32,5,0,20,2,5,11,2,18,2
84082,225,208,40,104,57,7,111,92,1,4,17,0,4,5,8,15,2
84083,437,315,139,132,40,4,188,64,39,24,122,51,46,13,12,80,42
84084,12163,10582,3658,5512,1229,183,6080,2888,1043,571,1581,428,815,217,121,1245,336
84085,139,103,28,39,31,5,14,22,37,30,36,11,4,21,0,28,8
84086,113,92,27,33,15,17,51,31,3,7,21,0,6,6,9,14,7
84087,2786,2487,721,1189,549,28,1351,781,174,181,299,68,92,74,65,269,30
84088,10625,9278,3292,4712,1169,105,5559,2290,965,464,1347,500,556,176,115,928,419
84092,8057,7399,641,4946,1621,191,4192,2559,421,227,658,140,300,184,34,486,172
84093,7207,6449,708,3975,1552,214,3272,2417,442,318,758,81,315,263,99,584,174
84094,8260,7060,1533,3934,1470,123,3537,2406,692,425,1200,341,481,301,77,876,324
84095,7608,6955,1170,4357,1168,260,4219,2204,299,233,653,131,180,167,175,562,91
84097,5353,4713,905,2276,1285,247,2507,1638,300,268,640,184,187,169,100,460,180
84098,4720,3482,552,2386,527,17,1844,1306,255,77,1238,367,701,159,11,865,373
84101,1249,486,220,140,84,42,123,181,69,113,763,293,203,176,91,602,161
84102,8532,3306,1440,1253,381,232,956,1383,437,530,5226,2951,1235,489,551,3644,1582
84103,10401,4788,1504,1871,1032,381,1507,2352,443,486,5613,2291,1849,847,626,4334,1279
84104,6573,4890,1590,2133,756,411,2076,1237,813,764,1683,392,570,456,265,1337,346
84105,9631,5313,1773,2448,751,341,1874,2057,784,598,4318,1526,1565,634,593,3128,1190
84106,13608,8431,2928,2960,1594,949,2841,3561,1126,903,5177,1353,1531,894,1399,4087,1090
84107,12623,7898,2659,2785,1772,682,2552,3401,1051,894,4725,1515,1410,1051,749,3754,971
84108,8020,5960,1588,2447,1238,687,2306,2815,492,347,2060,431,587,536,506,1629,431
84109,8602,6084,1042,2713,1510,819,2246,2784,511,543,2518,683,624,559,652,1951,567
84111,5131,1786,840,639,213,94,504,666,331,285,3345,1093,1142,690,420,2746,599
84112,165,52,42,10,0,0,28,18,6,0,113,113,0,0,0,54,59
84113,0,0,0,0,0,0,0,0,0,0,0,0,0,0,0,0,0
84115,9892,5387,2266,2172,680,269,1848,1725,1132,682,4505,1180,1759,912,654,3454,1051
84116,9676,7033,2376,3019,1274,364,2897,2170,1046,920,2643,612,941,624,466,2153,490
84117,9573,6262,1329,2431,1805,697,1998,3044,621,599,3311,770,990,823,728,2674,637
84118,17879,15558,4604,7994,2524,436,7879,4648,1866,1165,2321,588,1028,458,247,1687,634
84119,15491,10885,3919,4432,2153,381,4113,3766,1703,1303,4606,1387,1660,1177,382,3551,1055
84120,12494,10801,2986,5437,2113,265,4915,3532,1407,947,1693,362,722,463,146,1275,418
84121,15014,11544,1820,5590,3452,682,4438,5312,938,856,3470,1048,1142,880,400,2627,843
84123,13372,9176,3076,4101,1606,393,3766,3278,1195,937,4196,1279,1453,1038,426,3287,909
84124,7628,5632,1012,2256,1735,629,2077,2734,404,417,1996,474,598,444,480,1565,431
84128,5458,4850,1751,2370,685,44,2854,1194,493,309,608,164,290,126,28,437,171
84180,0,0,0,0,0,0,0,0,0,0,0,0,0,0,0,0,0
84301,147,127,21,46,43,17,43,69,1,14,20,4,3,0,13,20,0
84302,6673,5423,1378,2257,1430,358,2571,2083,461,308,1250,233,310,352,355,1131,119
84304,10,10,0,10,0,0,0,10,0,0,0,0,0,0,0,0,0
84305,213,179,39,82,46,12,100,65,5,9,34,3,6,13,12,31,3
84306,51,51,0,32,12,7,26,19,6,0,0,0,0,0,0,0,0
84307,394,341,90,175,59,17,178,129,27,7,53,3,7,16,27,52,1
84309,175,136,11,84,39,2,73,47,3,13,39,3,3,14,19,39,0
84310,981,839,115,480,231,13,444,363,24,8,142,17,64,61,0,101,41
84311,206,187,49,85,42,11,95,74,7,11,19,3,5,5,6,17,2
84312,1026,863,235,394,194,40,471,310,52,30,163,19,41,59,44,145,18
84313,52,34,7,0,5,22,7,27,0,0,18,0,18,0,0,18,0
84314,345,311,67,132,85,27,158,120,11,22,34,6,8,14,6,30,4
84315,1716,1538,311,840,327,60,839,588,51,60,178,13,104,23,38,148,30
84316,62,50,16,16,13,5,30,20,0,0,12,7,0,5,0,12,0
84317,623,527,54,320,127,26,279,182,34,32,96,5,39,28,24,83,13
84318,710,635,113,386,118,18,391,177,43,24,75,10,14,26,25,67,8
84319,1807,1609,551,752,269,37,1023,460,83,43,198,37,33,70,58,157,41
84320,685,584,153,286,98,47,324,191,37,32,101,8,29,21,43,97,4
84321,12261,8111,3964,2495,1165,487,3510,3454,620,527,4150,2348,798,484,520,2315,1835
84324,223,194,16,119,50,9,110,75,7,2,29,0,13,9,7,26,3
84325,361,318,70,151,82,15,176,105,17,20,43,10,13,13,7,39,4
84326,291,263,47,158,39,19,163,79,10,11,28,6,5,11,6,23,5
84327,238,209,61,89,46,13,131,62,12,4,29,0,1,14,14,26,3
84328,328,271,47,144,64,16,156,91,7,17,57,6,10,13,28,54,3
84329,75,61,38,0,23,0,30,24,0,7,14,0,14,0,0,14,0
84330,124,102,40,43,18,1,62,20,13,7,22,2,3,7,10,22,0
84331,85,61,11,31,16,3,37,20,2,2,24,5,5,12,2,19,5
84332,1287,1127,252,565,239,71,615,410,63,39,160,3,57,50,50,151,9
84333,624,525,134,247,118,26,261,178,52,34,99,12,34,24,29,92,7
84334,52,39,6,20,6,7,24,15,0,0,13,0,0,0,13,13,0
84335,2357,2037,487,1004,430,116,1130,714,118,75,320,50,65,97,108,287,33
84336,121,98,21,54,22,1,57,25,6,10,23,0,3,13,7,20,3
84337,2650,2248,559,1148,442,99,1190,738,221,99,402,90,71,98,143,368,34
84338,152,116,41,50,12,13,78,30,2,6,36,4,6,17,9,31,5
84339,1252,1133,267,571,231,64,655,383,53,42,119,25,17,37,40,100,19
84340,750,605,105,328,153,19,273,275,42,15,145,32,40,39,34,125,20
84341,5021,4077,1644,1588,683,162,1960,1506,356,255,944,552,151,134,107,485,459
84401,9470,6187,2223,2534,1090,340,2364,2081,1093,649,3283,781,1118,812,572,2714,569
84403,12248,8857,2257,3786,1978,836,3335,3977,898,647,3391,1002,973,716,700,2660,731
84404,15719,11724,3635,4920,2418,751,4712,4372,1583,1057,3995,712,1255,1185,843,3411,584
84405,8675,6668,1731,2917,1528,492,2588,2829,799,452,2007,482,565,530,430,1693,314
84414,6117,5386,931,2852,1362,241,2665,2136,355,230,731,70,318,176,167,656,75
84501,4453,3287,755,1558,690,284,1432,1328,303,224,1166,235,343,282,306,995,171
84510,231,208,54,104,46,4,90,25,37,56,23,0,0,23,0,23,0
84511,1243,1018,284,478,198,58,489,300,147,82,225,24,70,79,52,210,15
84512,347,270,32,126,81,31,87,84,57,42,77,19,20,22,16,67,10
84513,546,471,87,261,101,22,246,165,41,19,75,11,10,27,27,68,7
84516,104,95,17,45,24,9,44,45,4,2,9,0,3,3,3,9,0
84518,191,169,38,87,37,7,95,58,9,7,22,0,4,12,6,22,0
84520,561,376,64,168,103,41,91,169,56,60,185,9,44,54,78,162,23
84521,271,234,50,118,61,5,116,110,3,5,37,7,5,16,9,35,2
84522,139,107,5,51,44,7,23,67,12,5,32,0,12,15,5,32,0
84523,546,434,62,236,114,22,205,176,46,7,112,10,34,33,35,108,4
84525,411,287,64,108,96,19,114,128,26,19,124,22,20,58,24,112,12
84526,1552,1096,245,497,284,70,364,494,154,84,456,49,135,133,139,408,48
84528,899,702,183,324,178,17,335,276,57,34,197,33,35,84,45,182,15
84529,73,36,6,6,22,2,8,20,6,2,37,0,29,2,6,37,0
84530,62,40,0,20,20,0,13,27,0,0,22,17,5,0,0,22,0
84531,186,162,29,95,32,6,60,41,40,21,24,0,0,14,10,24,0
84532,3474,2211,455,1036,597,123,718,885,368,240,1263,249,556,282,176,1018,245
84533,48,11,0,11,0,0,11,0,0,0,37,23,14,0,0,17,20
84534,473,389,80,178,120,11,190,62,80,57,84,25,9,36,14,84,0
84535,842,660,144,269,193,54,310,282,46,22,182,35,62,52,33,160,22
84536,332,286,65,158,59,4,147,39,68,32,46,14,9,23,0,40,6
84537,434,339,70,173,77,19,174,139,25,1,95,8,38,31,18,84,11
84539,166,117,29,55,18,15,52,55,7,3,49,5,9,17,18,44,5
84540,37,16,5,11,0,0,5,6,5,0,21,0,21,0,0,21,0
84542,633,512,135,239,126,12,230,188,72,22,121,29,44,29,19,110,11
84601,8526,6592,3669,1990,723,210,3251,2262,545,534,1934,836,499,320,279,1327,607
84604,12195,8506,3387,2574,1854,691,3650,3871,358,627,3689,2436,398,320,535,1261,2428
84606,8439,4998,3547,982,340,129,1792,2206,390,610,3441,2760,354,187,140,820,2621
84620,300,263,55,121,63,24,133,116,8,6,37,5,6,6,20,34,3
84621,51,47,0,23,18,6,15,32,0,0,4,0,4,0,0,4,0
84622,379,312,81,141,84,6,176,89,30,17,67,12,12,31,12,58,9
84623,42,33,3,18,3,9,15,13,0,5,9,0,5,0,4,9,0
84624,1729,1415,259,741,321,94,749,481,117,68,314,48,47,115,104,290,24
84626,49,49,13,17,19,0,12,24,11,2,0,0,0,0,0,0,0
84627,1182,823,256,358,169,40,387,305,88,43,359,226,10,62,61,171,188
84628,293,214,53,94,58,9,71,85,45,13,79,11,20,24,24,72,7
84629,658,541,94,215,176,56,261,234,23,23,117,16,26,48,27,105,12
84630,63,47,6,29,10,2,20,21,6,0,16,0,4,6,6,16,0
84631,1113,865,165,413,203,84,432,314,68,51,248,20,42,86,100,236,12
84632,313,250,71,101,64,14,121,102,16,11,63,8,23,14,18,58,5
84633,277,225,66,90,61,8,126,67,14,18,52,4,15,20,13,49,3
84634,551,430,99,169,121,41,193,201,27,9,121,7,22,31,61,113,8
84635,283,231,30,119,75,7,92,113,11,15,52,7,25,11,9,52,0
84636,158,124,13,48,49,14,50,55,6,13,34,2,10,8,14,30,4
84637,34,34,2,4,26,2,6,28,0,0,0,0,0,0,0,0,0
84638,66,54,10,23,16,5,31,23,0,0,12,4,2,0,6,12,0
84639,249,204,65,68,47,24,97,82,20,5,45,2,24,11,8,45,0
84640,45,40,6,20,12,2,17,17,4,2,5,0,2,2,1,5,0
84642,1078,857,218,363,209,67,421,308,92,36,221,14,39,77,91,209,12
84643,197,155,27,61,59,8,68,76,5,6,42,5,6,15,16,42,0
84645,317,286,75,164,33,14,159,79,32,16,31,1,12,10,8,20,11
84646,481,391,75,200,81,35,206,129,34,22,90,2,17,23,48,88,2
84647,1060,798,173,357,197,71,391,331,53,23,262,50,26,95,91,234,28
84648,1517,1224,318,572,261,73,647,443,85,49,293,39,61,87,106,271,22
84649,202,175,19,104,39,13,117,49,1,8,27,0,4,9,14,27,0
84650,32,26,8,4,7,7,12,7,0,7,6,0,0,6,0,6,0
84651,5017,4319,1361,1886,896,176,2314,1409,401,195,698,79,153,258,208,647,51
84652,237,221,65,118,27,11,128,72,18,3,16,1,5,5,5,16,0
84653,1392,1264,258,674,281,51,747,435,43,39,128,8,48,35,37,118,10
84654,933,725,192,309,170,54,338,280,76,31,208,31,52,74,51,185,23
84655,1658,1489,548,665,226,50,939,394,90,66,169,20,53,60,36,147,22
84656,119,90,14,24,33,19,27,56,1,6,29,6,2,9,12,29,0
84657,152,126,34,43,42,7,59,42,14,11,26,0,0,16,10,26,0
84660,6253,5447,1953,2298,980,216,3145,1724,330,248,806,187,214,155,250,715,91
84662,413,338,62,163,96,17,148,144,29,17,75,11,22,21,21,63,12
84663,6275,5353,1875,2221,888,369,2892,1772,411,278,922,136,286,314,186,788,134
84664,1512,1389,237,695,358,99,770,509,68,42,123,14,27,51,31,102,21
84667,95,82,20,35,20,7,40,34,4,4,13,0,9,0,4,11,2
84701,2399,1944,524,773,486,161,918,778,176,72,455,53,70,173,159,427,28
84710,49,41,6,24,11,0,27,8,6,0,8,0,4,2,2,8,0
84711,152,137,34,59,41,3,60,58,8,11,15,2,1,8,4,15,0
84712,47,41,8,17,12,4,12,18,11,0,6,0,1,5,0,5,1
84713,1197,937,193,365,305,74,367,442,81,47,260,22,70,74,94,245,15
84714,275,252,50,118,47,37,104,106,16,26,23,0,13,5,5,14,9
84715,134,108,26,46,20,16,43,49,14,2,26,2,4,6,14,24,2
84716,133,79,17,40,20,2,30,35,14,0,54,32,18,2,2,54,0
84717,26,20,0,20,0,0,12,4,4,0,6,6,0,0,0,6,0
84718,55,42,4,9,21,8,11,31,0,0,13,0,0,11,2,13,0
84719,42,34,4,7,23,0,6,26,2,0,8,2,3,3,0,8,0
84720,9110,6948,2622,2636,1380,310,3281,2747,556,364,2162,929,528,364,341,1402,760
84722,213,176,19,66,74,17,55,108,13,0,37,5,10,16,6,31,6
84723,180,134,20,44,59,11,50,71,10,3,46,5,11,6,24,46,0
84724,258,200,59,76,49,16,79,78,33,10,58,4,15,18,21,55,3
84725,431,372,70,187,90,25,185,140,23,24,59,0,9,32,18,56,3
84726,367,276,48,122,84,22,103,141,24,8,91,12,34,21,24,69,22
84728,56,47,0,29,18,0,29,18,0,0,9,0,0,9,0,9,0
84729,135,97,24,32,36,5,46,44,3,4,38,2,10,15,11,36,2
84730,158,135,16,62,45,12,60,67,1,7,23,5,7,3,8,23,0
84731,51,42,16,17,9,0,27,15,0,0,9,0,9,0,0,9,0
84732,23,18,2,4,9,3,6,12,0,0,5,0,3,2,0,5,0
84733,86,74,30,16,28,0,27,25,19,3,12,0,4,0,8,10,2
84734,83,55,19,20,14,2,35,18,2,0,28,5,10,7,6,25,3
84735,53,46,8,22,16,0,19,24,2,1,7,0,2,5,0,7,0
84736,75,51,12,19,16,4,22,25,0,4,24,0,3,18,3,23,1
84737,3810,3055,745,1058,964,288,1308,1364,219,164,755,96,207,334,118,655,100
84738,1454,1255,335,449,372,99,536,587,84,48,199,12,52,108,27,164,35
84739,151,131,18,71,34,8,61,48,9,13,20,5,7,5,3,15,5
84740,33,28,7,10,11,0,11,15,0,2,5,0,0,2,3,5,0
84741,1809,1297,214,528,435,120,485,664,100,48,512,67,185,152,108,447,65
84743,76,60,6,18,18,18,23,29,2,6,16,2,4,7,3,16,0
84744,103,86,17,33,28,8,31,51,4,0,17,3,4,0,10,17,0
84745,1049,834,221,317,231,65,370,295,109,60,215,18,72,76,49,177,38
84747,293,236,55,106,53,22,112,102,18,4,57,10,6,19,22,53,4
84749,82,69,12,34,19,4,31,33,3,2,13,3,2,5,3,13,0
84750,180,137,17,57,52,11,48,65,11,13,43,0,8,17,18,39,4
84751,499,378,102,183,73,20,174,128,49,27,121,27,14,25,55,107,14
84752,260,215,51,102,37,25,117,80,13,5,45,0,12,14,19,42,3
84753,26,18,11,0,7,0,11,7,0,0,8,0,0,4,4,8,0
84754,1206,949,162,399,306,82,395,440,65,49,257,16,80,99,62,239,18
84755,44,38,5,10,23,0,9,25,0,4,6,6,0,0,0,6,0
84757,304,265,25,105,122,13,86,152,9,18,39,14,14,7,4,32,7
84758,174,138,27,61,30,20,71,52,5,10,36,7,7,18,4,30,6
84759,656,507,98,208,151,50,218,229,33,27,149,14,32,61,42,129,20
84760,215,182,27,91,50,14,71,91,9,11,33,4,3,2,24,31,2
84761,958,733,135,282,250,66,298,333,60,42,225,16,63,81,65,201,24
84762,25,25,0,15,5,5,15,10,0,0,0,0,0,0,0,0,0
84764,20,17,5,6,0,6,11,6,0,0,3,0,3,0,0,0,3
84765,1185,1093,177,568,263,85,640,386,40,27,92,7,22,26,37,82,10
84766,55,43,10,27,0,6,28,15,0,0,12,0,7,0,5,12,0
84770,10833,7917,2380,2522,1985,1030,2836,3730,875,476,2916,728,575,808,805,2351,565
84772,50,30,11,19,0,0,24,6,0,0,20,0,0,14,6,20,0
84773,119,87,19,36,30,2,29,54,4,0,32,2,11,12,7,29,3
84774,98,78,14,34,23,7,34,36,5,3,20,3,10,4,3,20,0
84775,193,124,11,51,52,10,28,83,9,4,69,15,33,13,8,52,17
84776,156,135,24,62,26,23,65,53,6,11,21,4,7,8,2,15,6
84779,243,170,32,67,48,23,61,86,8,15,73,11,43,9,10,61,12
84780,2783,2279,536,759,661,323,894,1134,140,111,504,41,95,194,174,468,36
84781,17,17,0,0,17,0,0,17,0,0,0,0,0,0,0,0,0
84782,227,175,36,80,43,16,87,74,9,5,52,0,26,21,5,52,0
84783,204,178,16,53,102,7,41,122,10,5,26,3,13,8,2,19,7
84790,7033,5701,1085,2003,1802,811,2256,2882,376,187,1332,284,240,439,369,1061,271
85003,3177,1440,426,732,199,83,370,420,354,296,1737,405,714,437,181,1405,332
85004,2042,750,315,244,165,26,236,205,137,172,1292,210,451,416,215,1100,192
85006,8969,6183,2517,2739,752,175,2564,1139,1492,988,2786,878,1106,564,238,2014,772
85007,4951,3004,1016,1289,513,186,1087,725,711,481,1947,380,781,608,178,1540,407
85008,18123,11259,4644,4600,1445,570,4478,2796,2371,1614,6864,2516,2704,1115,529,5003,1861
85009,12827,9965,3471,4482,1501,511,4380,2017,1989,1579,2862,491,916,892,563,2199,663
85012,2758,1336,238,545,384,169,338,599,191,208,1422,365,485,324,248,1161,261
85013,9677,4575,1211,2199,797,368,1396,1615,870,694,5102,1393,1955,1107,647,3958,1144
85014,12959,6066,2206,2432,1033,395,1863,1986,1388,829,6893,2032,3296,1035,530,5523,1370
85015,15635,9577,3800,4130,1076,571,3177,2479,2441,1480,6058,1549,2388,1211,910,4674,1384
85016,16714,8069,2440,3295,1699,635,2431,3162,1269,1207,8645,2566,3086,1797,1196,6895,1750
85017,12980,8819,3580,3633,1177,429,3518,2175,1977,1149,4161,1184,1615,868,494,3112,1049
85018,17778,9414,2040,4053,2328,993,2974,4076,1201,1163,8364,2280,2922,1912,1250,6899,1465
85019,7759,5911,1740,2715,1226,230,2194,1932,1146,639,1848,406,653,532,257,1461,387
85020,15327,8175,2128,3466,2010,571,2269,3502,1380,1024,7152,1738,2567,1819,1028,5686,1466
85021,15027,8750,2647,3676,1832,595,2891,3330,1454,1075,6277,2389,1944,1169,775,4649,1628
85022,19026,11518,2947,5480,2584,507,3860,4854,1685,1119,7508,2421,2794,1603,690,5738,1770
85023,13347,8790,2322,4313,1811,344,3331,3350,1252,857,4557,1625,1804,836,292,3553,1004
85024,7713,5436,1607,2622,1031,176,2127,2442,541,326,2277,588,912,486,291,1691,586
85027,15087,9905,3201,4658,1713,333,3715,3696,1718,776,5182,1663,2078,1013,428,3742,1440
85028,8145,5927,655,3108,1821,343,2009,3068,501,349,2218,372,813,681,352,1680,538
85029,17654,11359,3182,5215,2397,565,3765,4451,1851,1292,6295,1885,2215,1444,751,4629,1666
85031,7827,6181,2015,2620,1224,322,2605,1698,1076,802,1646,306,567,529,244,1280,366
85032,26469,16852,4640,8431,3034,747,6138,6102,2778,1834,9617,2830,3588,2036,1163,7362,2255
85033,14839,12376,4463,5590,1972,351,5015,2976,2944,1441,2463,626,969,694,174,1935,528
85034,2390,1698,551,767,253,127,554,338,506,300,692,67,231,233,161,552,140
85035,12005,9691,4022,4208,1265,196,4276,2080,2155,1180,2314,667,807,512,328,1598,716
85037,9905,8181,2869,4176,1035,101,3825,2256,1317,783,1724,464,853,343,64,1209,515
85040,17694,13160,4341,5991,2341,487,5022,3351,2814,1973,4534,1263,1784,1091,396,3235,1299
85041,8346,6971,1810,3249,1526,386,2797,1889,1213,1072,1375,204,538,451,182,1055,320
85043,3088,2401,940,1114,284,63,1247,506,390,258,687,95,321,223,48,507,180
85044,16875,10297,2319,5572,1920,486,3877,4557,1183,680,6578,2969,2316,943,350,4673,1905
85045,1526,1265,329,808,124,4,689,439,87,50,261,80,150,31,0,148,113
85048,11700,9188,1667,6245,1124,152,4712,3168,1019,289,2512,1156,1065,254,37,1777,735
85050,7186,5279,1393,2860,795,231,2316,2097,494,372,1907,558,745,456,148,1397,510
85051,15439,10144,2718,4511,2407,508,3189,3887,1934,1134,5295,1671,1878,1188,558,3931,1364
85053,10482,7243,1986,3641,1404,212,2692,2905,1084,562,3239,1109,1142,855,133,2326,913
85054,850,735,140,455,129,11,344,334,9,48,115,19,58,38,0,82,33
85085,233,147,9,79,48,11,10,108,13,16,86,8,60,11,7,74,12
85086,2556,2095,286,1263,475,71,889,943,161,102,461,94,194,123,50,307,154
85087,1447,1045,126,570,329,20,333,560,98,54,402,62,198,135,7,278,124
85201,19045,11275,4382,4577,1800,516,3859,3748,2293,1375,7770,2642,2467,1484,1177,6031,1739
85202,16970,9823,3215,4384,1817,407,3241,3739,1696,1147,7147,3692,2116,888,451,4970,2177
85203,12742,9078,2409,4236,1935,498,3449,3364,1346,919,3664,1049,1507,620,488,2781,883
85204,20990,15033,4891,6795,2535,812,6317,4922,2331,1463,5957,1823,1988,1301,845,4380,1577
85205,16905,11284,1719,4432,3390,1743,3632,6060,1030,562,5621,302,1100,2054,2165,4909,712
85206,12810,8534,1798,2472,2330,1934,2240,4935,774,585,4276,370,711,986,2209,3771,505
85207,9315,7179,1375,3619,1785,400,2747,3340,648,444,2136,330,701,707,398,1646,490
85208,17339,12643,2466,3847,4113,2217,3803,7184,824,832,4696,417,870,1768,1641,4002,694
85210,13435,8636,3060,4194,1174,208,3422,2502,1630,1082,4799,2132,1665,731,271,3367,1432
85212,3509,2920,1277,963,566,114,1426,1211,179,104,589,252,176,112,49,374,215
85213,10939,8281,1481,4159,2027,614,3437,3711,688,445,2658,488,594,842,734,2127,531
85215,6773,4961,577,1897,1775,712,1206,3213,273,269,1812,166,353,714,579,1522,290
85219,10543,7654,806,2621,3403,824,1479,5216,610,349,2889,299,847,1125,618,2245,644
85220,13592,9107,2097,2498,3152,1360,2453,5202,753,699,4485,499,1307,1596,1083,3591,894
85221,529,471,118,250,98,5,110,66,197,98,58,0,45,13,0,50,8
85222,13237,9853,2204,4236,2775,638,3080,4318,1738,717,3384,653,912,1147,672,2773,611
85223,1728,1333,173,505,475,180,340,834,100,59,395,61,107,150,77,314,81
85224,15711,10972,3022,6237,1374,339,4654,3930,1587,801,4739,1726,1846,682,485,3404,1335
85225,22010,16337,5535,7874,2365,563,6899,5405,2523,1510,5673,1942,2154,1173,404,4072,1601
85226,14419,10347,2433,6511,1321,82,5163,3261,1304,619,4072,1676,1752,532,112,2871,1201
85228,3586,2768,562,1223,796,187,791,1072,553,352,818,74,315,315,114,680,138
85230,33,33,7,11,0,15,14,0,0,19,0,0,0,0,0,0,0
85231,2864,2269,695,1035,472,67,938,552,531,248,595,121,225,196,53,464,131
85232,2997,2113,370,653,800,290,515,1154,281,163,884,156,245,331,152,751,133
85233,12986,10228,3009,5689,1367,163,5043,3623,1008,554,2758,970,1243,397,148,1955,803
85234,11834,9634,2277,5537,1656,164,4850,3196,1015,573,2200,453,1190,466,91,1688,512
85235,454,318,43,129,109,37,73,150,51,44,136,12,37,59,28,121,15
85236,2505,2244,567,1304,314,59,1310,702,124,108,261,90,125,41,5,200,61
85237,1046,800,154,297,291,58,263,395,84,58,246,26,68,83,69,222,24
85239,2450,1881,497,805,507,72,702,762,231,186,569,63,270,193,43,433,136
85241,139,113,2,58,39,14,38,42,16,17,26,1,14,7,4,24,2
85242,4060,3390,839,1816,626,109,1632,1177,361,220,670,132,296,178,64,496,174
85245,92,71,17,30,21,3,35,26,5,5,21,4,8,9,0,19,2
85247,1084,910,234,477,150,49,139,87,380,304,174,34,96,33,11,136,38
85248,14578,11227,1905,3748,4131,1443,3089,7401,404,333,3351,575,691,1205,880,2773,578
85249,3613,2719,613,866,1095,145,985,1564,81,89,894,99,214,436,145,724,170
85250,8240,4432,544,1739,1613,536,949,2459,502,522,3808,765,1184,1146,713,3030,778
85251,18670,8345,1860,3234,2064,1187,2023,3983,1213,1126,10325,3618,2773,2156,1778,7765,2560
85253,6955,5188,296,2406,2079,407,1891,2836,262,199,1767,375,522,570,300,1315,452
85254,18584,13721,1790,8200,3126,605,5747,6243,1074,657,4863,1354,1961,1086,462,3645,1218
85255,8802,6855,820,3273,2404,358,2007,4374,301,173,1947,426,727,566,228,1594,353
85256,1225,961,214,549,161,37,247,175,345,194,264,25,50,114,75,222,42
85257,12377,6728,1239,2760,1910,819,1603,3110,991,1024,5649,1399,1719,1522,1009,4305,1344
85258,12122,7418,550,2892,2977,999,1688,4786,480,464,4704,1013,1536,1532,623,3841,863
85259,10182,7751,1114,4590,1799,248,3439,3463,593,256,2431,643,1008,647,133,1927,504
85260,15126,9424,1561,4999,2438,426,3435,4388,901,700,5702,2033,1949,1177,543,4468,1234
85262,4227,3420,76,1130,1921,293,505,2792,77,46,807,74,268,341,124,629,178
85263,771,678,6,37,462,173,6,672,0,0,93,0,7,44,42,86,7
85264,240,198,52,94,50,2,30,52,72,44,42,9,24,9,0,36,6
85268,8640,6466,620,2824,2430,592,1711,4125,364,266,2174,298,665,820,391,1726,448
85272,401,312,45,158,92,17,122,94,46,50,89,29,35,10,15,52,37
85273,1273,874,129,338,308,99,191,445,143,95,399,18,128,152,101,366,33
85281,20302,8044,3552,3024,1154,314,2299,2945,1458,1342,12258,8200,2731,993,334,6911,5347
85282,21426,11651,3337,4778,2765,771,3315,4995,1707,1634,9775,5002,2338,1441,994,6233,3542
85283,16970,10285,2371,5280,2331,303,3262,4427,1538,1058,6685,3484,2068,826,307,4341,2344
85284,5934,4933,450,3387,1006,90,2423,2030,313,167,1001,278,487,171,65,742,259
85292,776,584,72,282,203,27,144,278,94,68,192,16,51,86,39,163,29
85296,10048,8714,2954,4724,953,83,5002,2680,631,401,1334,575,488,211,60,872,462
85301,21629,14239,5168,5721,2668,682,4780,3992,3592,1875,7390,1962,2626,1898,904,5986,1404
85302,14077,9131,2276,4348,2104,403,3094,3673,1433,931,4946,1662,1529,994,761,3852,1094
85303,6828,5517,1897,2722,754,144,2408,1582,907,620,1311,380,523,305,103,901,410
85304,9083,7504,1282,4459,1481,282,3082,2920,945,557,1579,411,609,400,159,1162,417
85305,1643,1376,345,811,188,32,713,497,115,51,267,57,149,61,0,127,140
85306,9405,6618,1368,3701,1330,219,2567,2544,753,754,2787,923,878,376,610,2094,693
85307,3434,2821,1307,1270,219,25,1605,746,363,107,613,242,285,71,15,482,131
85308,23229,17970,3911,10334,3325,400,7844,7317,1720,1089,5259,1504,2284,1210,261,3865,1394
85309,0,0,0,0,0,0,0,0,0,0,0,0,0,0,0,0,0
85310,7338,6251,1340,3884,980,47,3360,2211,426,254,1087,334,494,207,52,694,393
85320,347,243,21,121,52,49,95,111,13,24,104,13,27,36,28,71,33
85321,2041,1387,172,444,593,178,254,742,232,159,654,46,143,302,163,573,81
85322,168,114,33,38,41,2,31,48,19,16,54,12,19,14,9,34,20
85323,9931,8172,2466,4270,1290,146,3640,2706,1164,662,1759,501,662,423,173,1288,471
85324,1291,796,85,336,316,59,172,487,56,81,495,31,131,204,129,388,107
85325,539,337,13,72,191,61,20,264,29,24,202,0,42,97,63,167,35
85326,5774,4615,1100,2151,1128,236,1650,1902,647,416,1159,188,441,363,167,944,215
85328,84,39,0,21,18,0,6,33,0,0,45,7,7,31,0,18,27
85329,685,578,116,259,172,31,211,171,80,116,107,12,19,57,19,81,26
85331,9116,7175,1210,3935,1813,217,2772,3867,297,239,1941,316,900,547,178,1396,545
85332,929,664,35,169,373,87,92,529,21,22,265,10,38,146,71,225,40
85333,229,175,29,84,60,2,79,60,23,13,54,6,15,31,2,47,7
85334,381,256,47,121,88,0,116,110,30,0,125,31,41,34,19,91,34
85335,2063,1702,744,541,369,48,717,446,319,220,361,76,121,122,42,270,91
85336,345,329,97,197,30,5,235,48,39,7,16,0,4,4,8,16,0
85337,870,633,166,314,134,19,263,175,119,76,237,28,69,100,40,205,32
85338,5822,4719,990,2057,1526,146,1663,2495,375,186,1103,206,404,398,95,814,289
85339,1829,1448,192,818,405,33,424,464,283,277,381,31,141,168,41,288,93
85340,2513,1999,219,970,635,175,664,1090,137,108,514,53,166,187,108,424,90
85342,676,466,51,187,163,65,135,271,27,33,210,22,53,65,70,155,55
85344,4025,2778,499,1229,849,201,815,1250,430,283,1247,135,480,446,186,989,258
85345,18770,13545,3687,6632,2399,827,5366,4861,2191,1127,5225,819,1646,1512,1248,4195,1030
85346,2068,1372,41,202,777,352,112,1145,47,68,696,7,83,395,211,590,106
85347,420,308,76,141,77,14,134,126,28,20,112,9,32,47,24,91,21
85348,832,527,55,121,308,43,95,381,43,8,305,16,36,166,87,265,40
85349,2920,2820,734,1501,498,87,1619,500,452,249,100,11,30,44,15,77,23
85350,3185,2904,674,1429,622,179,1448,758,377,321,281,26,74,127,54,232,49
85351,17651,9374,44,208,4732,4390,53,8756,31,534,8277,16,139,2723,5399,7886,391
85353,2096,1685,402,719,478,86,670,548,200,267,411,31,175,119,86,322,89
85354,956,745,153,361,214,17,271,334,95,45,211,32,85,74,20,174,37
85355,1071,958,95,668,180,15,443,391,60,64,113,0,51,48,14,72,41
85356,1432,1118,133,410,467,108,369,613,93,43,314,45,49,149,71,269,45
85357,259,200,40,62,79,19,51,100,22,27,59,16,15,23,5,38,21
85360,136,88,17,31,35,5,30,39,9,10,48,0,20,23,5,44,4
85361,1266,1010,190,479,291,50,323,450,117,120,256,20,92,109,35,202,54
85362,556,308,27,87,151,43,50,204,25,29,248,7,79,131,31,220,28
85363,1661,760,106,118,336,200,87,520,51,102,901,24,105,382,390,841,60
85364,23844,17825,4816,8056,3695,1258,7092,6287,2913,1533,6019,1052,1719,1874,1374,5007,1012
85365,12838,9897,2002,3595,3332,968,3333,5331,770,463,2941,284,613,1164,880,2438,503
85367,8680,6596,405,1107,3742,1342,762,5491,196,147,2084,30,320,1160,574,1715,369
85373,6802,4203,238,340,1861,1764,322,3649,86,146,2599,26,90,827,1656,2430,169
85374,11552,8985,1818,1883,4261,1023,1870,6210,500,405,2567,359,452,1277,479,2122,445
85375,15342,10709,47,246,5931,4485,84,10265,27,333,4633,8,88,1836,2701,4388,245
85379,404,339,176,121,42,0,183,123,13,20,65,25,15,19,6,43,22
85381,7558,5860,850,3692,1022,296,2913,2212,520,215,1698,210,436,352,700,1380,318
85382,14585,11103,2179,4594,3198,1132,4001,5887,671,544,3482,617,820,1037,1008,2878,604
85390,3558,2305,282,790,942,291,569,1386,204,146,1253,136,315,429,373,1108,145
85501,5205,3609,694,1538,1080,297,1150,1637,497,325,1596,93,535,562,406,1446,150
85530,439,368,78,196,92,2,133,73,94,68,71,18,27,26,0,71,0
85531,119,106,32,54,20,0,60,27,19,0,13,0,1,5,7,12,1
85533,631,497,107,203,145,42,175,226,64,32,134,20,40,45,29,113,21
85534,1303,942,190,417,264,71,353,418,104,67,361,43,92,135,91,314,47
85535,42,42,15,12,12,3,15,20,7,0,0,0,0,0,0,0,0
85536,116,90,14,43,26,7,32,52,4,2,26,0,7,7,12,26,0
85539,2065,1469,300,620,449,100,451,732,161,125,596,46,177,202,171,540,56
85540,1347,968,219,599,138,12,505,319,108,36,379,84,188,63,44,360,19
85541,8487,5911,693,2053,2324,841,1440,3553,476,442,2576,230,690,1119,537,2195,381
85542,323,283,43,149,85,6,115,80,35,53,40,0,11,29,0,40,0
85543,1077,849,216,321,239,73,354,355,94,46,228,27,51,78,72,187,41
85544,1391,974,46,362,485,81,179,700,47,48,417,25,134,184,74,340,77
85545,324,193,28,40,90,35,11,143,34,5,131,0,42,62,27,115,16
85546,5836,4210,962,1668,1226,354,1417,1756,665,372,1626,192,423,563,448,1446,180
85550,1445,1245,303,677,240,25,470,235,378,162,200,25,93,66,16,168,32
85552,1791,1382,295,603,342,142,558,570,171,83,409,105,45,164,95,312,97
85553,448,290,5,94,149,42,41,213,3,33,158,5,31,87,35,136,22
85554,285,200,11,81,87,21,43,116,12,29,85,2,32,33,18,79,6
85601,410,229,0,97,109,23,57,153,14,5,181,12,60,63,46,156,25
85602,3665,2575,319,1010,967,279,618,1593,206,158,1090,33,257,513,287,943,147
85603,3648,2079,367,881,629,202,525,939,384,231,1569,176,564,497,332,1316,253
85605,295,194,20,79,72,23,65,107,12,10,101,15,8,70,8,89,12
85606,617,401,50,158,143,50,118,241,15,27,216,12,72,80,52,191,25
85607,6107,4703,1012,2088,1294,309,1687,1396,931,689,1404,148,284,663,309,1297,107
85608,23,21,0,12,9,0,2,14,0,5,2,0,0,2,0,2,0
85609,196,134,6,40,79,9,23,90,9,12,62,9,15,24,14,50,12
85610,499,370,57,173,115,25,139,187,27,17,129,17,22,68,22,113,16
85611,211,139,8,61,53,17,29,88,13,9,72,6,35,31,0,59,13
85613,1811,1713,1124,573,16,0,1093,349,263,8,98,98,0,0,0,68,30
85614,10331,6599,214,395,3564,2426,261,6018,60,260,3732,71,299,1467,1895,3413,319
85615,2525,1907,296,895,593,123,637,1010,141,119,618,25,320,215,58,510,108
85616,1960,1340,229,623,428,60,442,637,159,102,620,83,228,231,78,503,117
85617,568,380,53,155,132,40,87,232,30,31,188,11,49,85,43,167,21
85618,631,521,108,231,155,27,148,233,84,56,110,13,38,30,29,97,13
85619,23,23,0,12,11,0,12,11,0,0,0,0,0,0,0,0,0
85621,6658,5550,1008,2747,1535,260,2360,1681,852,657,1108,116,295,411,286,1023,85
85623,1652,1159,162,557,356,84,357,561,183,58,493,55,160,188,90,409,84
85624,607,364,48,163,106,47,114,185,41,24,243,5,97,95,46,202,41
85625,1055,715,47,239,286,143,97,524,52,42,340,3,92,138,107,296,44
85627,80,70,10,44,14,2,40,19,3,8,10,0,7,3,0,6,4
85629,2865,2174,372,1000,638,164,845,1029,152,148,691,60,166,177,288,602,89
85630,897,614,43,245,238,88,203,302,21,88,283,9,70,135,69,247,36
85631,1468,1212,262,530,369,51,516,523,129,44,256,46,120,82,8,218,38
85632,293,196,30,67,81,18,47,111,18,20,97,13,27,44,13,79,18
85633,43,23,6,4,13,0,0,10,13,0,20,6,11,3,0,20,0
85634,1614,1227,239,616,303,69,191,250,414,372,387,53,169,118,47,330,57
85635,12160,7917,1801,3454,2140,522,2460,3632,1266,559,4243,1150,1410,1163,520,3572,671
85637,599,442,19,171,191,61,110,312,9,11,157,8,59,52,38,132,25
85638,900,560,45,221,241,53,121,329,61,49,340,23,67,157,93,292,48
85639,113,82,17,32,24,9,17,7,28,30,31,12,5,9,5,15,16
85640,230,158,10,75,62,11,21,108,9,20,72,8,11,39,14,58,14
85641,2396,1854,230,1117,444,63,734,890,154,76,542,54,329,94,65,406,136
85643,2916,2152,464,947,587,154,814,925,269,144,764,48,184,326,206,717,47
85645,899,688,98,369,188,33,247,296,84,61,211,8,72,76,55,180,31
85646,456,310,0,114,143,53,63,234,0,13,146,8,24,61,53,114,32
85648,3047,2654,754,1465,357,78,1532,680,329,113,393,76,193,100,24,323,70
85650,4012,3249,338,1416,1199,296,1033,1839,183,194,763,39,350,248,126,669,94
85653,3759,2961,573,1302,941,145,1004,1412,342,203,798,142,320,243,93,645,153
85654,73,49,15,20,14,0,0,12,23,14,24,7,6,5,6,6,18
85701,2323,746,234,336,106,70,137,253,201,155,1577,561,480,356,180,1251,326
85704,12297,7088,973,3126,2154,835,1870,3971,616,631,5209,1181,1408,1143,1477,4320,889
85705,24136,12542,3901,5260,2461,920,3439,4332,2985,1786,11594,3317,3931,2823,1523,9224,2370
85706,20173,15820,4457,7075,3327,961,5705,4838,3367,1910,4353,735,1537,1351,730,3362,991
85708,1548,1479,906,535,33,5,1121,204,134,20,69,29,15,25,0,62,7
85710,24709,14287,2760,5876,4074,1577,3882,6833,2131,1441,10422,2471,2500,2801,2650,8869,1553
85711,17902,10596,3131,4697,1956,812,3149,3870,2128,1449,7306,2016,2671,1430,1189,5933,1373
85712,16141,7236,2153,2904,1540,639,1862,2873,1429,1072,8905,2510,3176,1842,1377,7359,1546
85713,15911,11221,2665,4512,2960,1084,3569,3958,1942,1752,4690,763,1402,1453,1072,3934,756
85714,4365,3349,904,1409,786,250,1186,959,700,504,1016,161,423,268,164,884,132
85715,6873,4533,529,2182,1363,459,1425,2409,438,261,2340,512,788,564,476,1983,357
85716,16420,7515,2410,3266,1082,757,1863,2818,1718,1116,8905,3456,3045,1551,853,6826,2079
85718,12102,7401,689,3225,2568,919,2188,4298,552,363,4701,1349,1301,1052,999,3868,833
85719,18278,6801,2701,2737,991,372,1921,2300,1493,1087,11477,6494,2935,1164,884,7641,3836
85730,14666,10694,2739,5280,2194,481,3886,4136,1637,1035,3972,953,1518,1059,442,3242,730
85735,2931,2208,404,1084,613,107,791,1031,215,171,723,68,255,326,74,593,130
85736,1574,1170,257,599,276,38,485,451,130,104,404,46,201,111,46,300,104
85737,12376,9485,955,3994,3593,943,3115,5629,377,364,2891,484,850,976,581,2351,540
85739,5181,4104,267,1260,2099,478,766,2907,202,229,1077,50,200,616,211,869,208
85741,11869,8467,1907,4629,1557,374,3507,3260,1133,567,3402,1145,1225,687,345,2665,737
85742,7827,6240,1008,3803,1207,222,2620,2606,658,356,1587,301,761,375,150,1191,396
85743,6773,5249,1168,2739,1189,153,2254,2310,433,252,1524,259,641,502,122,1161,363
85745,12014,8070,1679,3693,2087,611,2409,3594,948,1119,3944,1227,1372,853,492,2867,1077
85746,14008,11064,2596,5734,2181,553,4335,3542,2012,1175,2944,419,1171,903,451,2233,711
85747,4313,3670,1186,1794,660,30,1818,1398,367,87,643,180,330,105,28,444,199
85748,6059,4548,654,2420,1234,240,1594,2420,294,240,1511,295,538,470,208,1166,345
85749,6847,5586,387,3232,1733,234,2125,2777,377,307,1261,90,561,475,135,1040,221
85750,10810,7249,762,3549,2344,594,2397,4064,485,303,3561,954,1336,923,348,3097,464
85901,4354,3275,631,1452,991,201,1146,1524,435,170,1079,140,329,440,170,893,186
85911,366,282,87,106,71,18,71,19,113,79,84,10,53,11,10,84,0
85920,109,70,5,15,45,5,5,62,0,3,39,0,15,21,3,33,6
85922,6,3,0,3,0,0,0,3,0,0,3,0,3,0,0,3,0
85923,203,175,25,68,71,11,53,96,15,11,28,10,0,12,6,18,10
85924,896,599,73,248,242,36,163,345,37,54,297,14,103,155,25,247,50
85925,741,589,69,339,150,31,232,244,85,28,152,19,47,62,24,141,11
85926,21,21,0,8,13,0,0,13,8,0,0,0,0,0,0,0,0
85927,81,54,13,10,24,7,8,41,5,0,27,9,10,0,8,18,9
85928,347,263,66,105,74,18,112,131,8,12,84,0,39,37,8,78,6
85929,2167,1620,294,733,513,80,592,729,197,102,547,58,207,158,124,458,89
85930,107,75,20,47,8,0,32,16,24,3,32,4,21,3,4,30,2
85931,132,97,0,30,52,15,10,85,2,0,35,4,6,21,4,30,5
85932,133,108,5,56,44,3,21,78,0,9,25,4,3,6,12,21,4
85933,1262,868,44,292,460,72,182,602,54,30,394,50,74,190,80,320,74
85934,136,110,6,56,42,6,20,90,0,0,26,0,19,7,0,26,0
85935,2139,1589,201,701,594,93,496,896,147,50,550,78,201,185,86,457,93
85936,1148,930,168,436,259,67,438,355,71,66,218,21,66,89,42,198,20
85937,1929,1523,295,714,420,94,669,576,154,124,406,29,121,175,81,341,65
85938,1529,1140,228,568,297,47,456,472,153,59,389,29,130,144,86,339,50
85939,1043,843,224,349,257,13,422,315,75,31,200,26,44,61,69,179,21
85940,211,163,33,53,66,11,51,95,13,4,48,2,20,19,7,33,15
85941,2485,2089,517,1134,411,27,797,345,534,413,396,57,216,123,0,316,80
85942,65,31,0,19,12,0,19,8,0,4,34,0,19,0,15,34,0
86001,12781,7025,2210,3555,1084,176,2720,2707,1104,494,5756,3202,1588,687,279,3320,2436
86004,12316,8973,2088,4826,1815,244,3417,3462,1415,679,3343,1141,1377,663,162,2259,1084
86015,105,66,22,19,9,16,6,34,10,16,39,16,16,7,0,22,17
86016,29,25,7,18,0,0,12,0,13,0,4,0,0,0,4,4,0
86017,621,406,41,190,147,28,112,268,7,19,215,17,65,127,6,158,57
86018,409,307,21,195,89,2,97,168,27,15,102,3,47,45,7,71,31
86020,575,445,79,230,99,37,135,127,67,116,130,33,25,36,36,110,20
86021,559,524,267,199,45,13,418,41,43,22,35,10,12,10,3,32,3
86022,596,465,116,200,113,36,180,167,71,47,131,14,49,53,15,109,22
86023,961,527,166,304,57,0,188,179,85,75,434,136,251,46,1,299,135
86024,287,220,7,75,122,16,36,178,4,2,67,2,32,28,5,50,17
86025,2299,1728,339,793,506,90,673,595,292,168,571,95,222,154,100,483,88
86030,172,126,28,59,22,17,44,15,41,26,46,11,9,9,17,46,0
86031,651,526,66,237,156,67,170,163,70,123,125,0,51,53,21,114,11
86032,34,31,9,8,12,2,20,11,0,0,3,0,0,1,2,3,0
86033,2189,1783,346,1033,336,68,721,395,416,251,406,37,153,142,74,375,31
86034,568,398,69,191,107,31,173,125,60,40,170,35,80,51,4,165,5
86035,425,339,38,140,130,31,86,116,61,76,86,22,0,50,14,74,12
86036,88,53,22,23,8,0,5,15,33,0,35,16,13,6,0,31,4
86039,641,438,49,211,116,62,124,108,96,110,203,40,46,92,25,197,6
86040,3214,2491,564,1369,482,76,1027,871,450,143,723,120,369,139,95,568,155
86042,406,318,61,146,98,13,106,62,61,89,88,13,31,38,6,64,24
86043,397,329,50,198,76,5,87,70,104,68,68,6,36,26,0,63,5
86044,1356,1065,166,546,242,111,409,265,210,181,291,21,83,141,46,277,14
86045,2568,2098,397,1164,463,74,786,434,521,357,470,47,198,180,45,400,70
86046,1957,1384,287,647,404,46,449,625,179,131,573,77,251,163,82,482,91
86047,4001,3028,733,1452,655,188,1182,885,596,365,973,122,304,317,230,868,105
86052,21,13,0,13,0,0,2,11,0,0,8,4,4,0,0,8,0
86053,503,474,104,201,146,23,249,143,33,49,29,0,9,15,5,29,0
86054,414,320,72,143,87,18,123,102,56,39,94,25,14,55,0,94,0
86301,8294,5093,567,1900,1978,648,1159,3040,539,355,3201,688,758,898,857,2562,639
86303,7601,4507,481,1537,1899,590,870,2918,397,322,3094,510,907,1015,662,2494,600
86305,4984,3392,323,1260,1417,392,721,2141,285,245,1592,206,427,606,353,1266,326
86314,10104,7504,1686,3040,2032,746,2598,3622,874,410,2600,433,825,866,476,2030,570
86320,321,233,36,112,70,15,77,106,31,19,88,10,29,37,12,75,13
86321,746,567,136,285,138,8,217,254,56,40,179,20,81,48,30,160,19
86322,3953,2764,414,1028,965,357,792,1530,235,207,1189,150,444,371,224,978,211
86323,4830,3535,609,1611,1091,224,1224,1781,357,173,1295,96,465,482,252,1035,260
86324,1451,997,164,362,321,150,275,587,82,53,454,30,167,143,114,358,96
86325,1454,1030,147,508,283,92,323,494,149,64,424,26,254,117,27,292,132
86326,8308,5651,1076,2216,1650,709,1702,2901,640,408,2657,216,777,848,816,2219,438
86327,2973,2167,118,717,1041,291,370,1571,89,137,806,31,189,317,269,673,133
86331,142,68,5,42,16,5,7,36,17,8,74,4,48,19,3,58,16
86332,422,277,27,61,137,52,53,199,5,20,145,7,33,78,27,117,28
86333,2068,1383,123,575,523,162,349,796,112,126,685,38,199,317,131,562,123
86334,873,740,233,316,182,9,309,329,87,15,133,22,78,33,0,98,35
86335,1334,849,154,325,256,114,182,460,131,76,485,90,134,153,108,376,109
86336,5525,3216,313,1217,1214,472,671,2067,247,231,2309,201,691,902,515,1824,485
86337,439,282,34,128,101,19,65,174,34,9,157,6,65,63,23,131,26
86338,144,103,16,34,40,13,19,70,14,0,41,3,14,8,16,34,7
86343,72,39,0,22,17,0,10,27,2,0,33,7,12,14,0,33,0
86351,2736,1598,110,520,770,198,252,1129,146,71,1138,54,320,399,365,955,183
86401,15502,10753,2181,4231,3432,909,3212,5509,1279,753,4749,497,1422,1855,975,3873,876
86403,5706,3680,526,1268,1421,465,706,2197,462,315,2026,287,461,747,531,1568,458
86404,5671,4122,397,1428,1847,450,869,2674,393,186,1549,94,377,720,358,1224,325
86406,7791,5829,763,1946,2429,691,1412,3644,427,346,1962,170,433,890,469,1620,342
86413,3189,2218,198,1014,883,123,485,1362,226,145,971,67,295,504,105,760,211
86426,3435,2599,455,1005,961,178,695,1336,354,214,836,47,180,471,138,627,209
86429,2054,1383,230,412,623,118,189,840,225,129,671,154,196,239,82,462,209
86430,32,20,0,6,14,0,0,20,0,0,12,0,12,0,0,12,0
86431,191,89,0,19,48,22,13,54,8,14,102,7,9,69,17,82,20
86432,435,315,98,109,98,10,115,156,24,20,120,11,44,48,17,98,22
86433,49,24,0,5,12,7,0,24,0,0,25,0,0,11,14,25,0
86434,449,368,81,192,80,15,106,118,94,50,81,14,35,25,7,72,9
86435,117,89,21,55,10,3,41,10,21,17,28,8,17,3,0,24,4
86436,918,572,52,141,267,112,72,394,53,53,346,8,68,175,95,283,63
86437,17,13,5,0,8,0,0,10,0,3,4,0,4,0,0,4,0
86438,141,94,7,40,44,3,12,70,10,2,47,7,17,19,4,42,5
86440,2607,1838,267,842,595,134,472,966,245,155,769,77,230,356,106,585,184
86441,1122,657,65,162,337,93,105,453,44,55,465,25,91,259,90,390,75
86442,11952,7939,1567,3024,2588,760,1984,3948,1197,810,4013,601,1069,1550,793,3073,940
86444,425,291,13,77,165,36,37,220,5,29,134,4,35,74,21,104,30
86502,380,306,32,142,112,20,100,94,46,66,74,0,28,36,10,74,0
86503,2889,2296,569,1103,490,134,832,463,597,404,593,81,265,184,63,536,57
86504,1480,1150,217,672,233,28,415,151,269,315,330,32,137,121,40,293,37
86505,2612,1979,295,972,542,170,765,416,420,378,633,98,254,240,41,592,41
86506,428,298,34,177,65,22,134,59,77,28,130,16,48,32,34,121,9
86507,566,435,88,229,107,11,188,86,69,92,131,19,34,65,13,121,10
86508,306,185,33,67,80,5,43,40,47,55,121,12,49,51,9,117,4
86510,1409,1181,308,571,253,49,447,271,253,210,228,22,86,103,17,215,13
86511,870,688,77,424,164,23,288,156,101,143,182,40,85,57,0,166,16
86512,646,474,98,255,109,12,220,73,109,72,172,40,72,44,16,147,25
86514,1033,780,146,374,208,52,322,192,137,129,253,37,60,119,37,246,7
86515,1184,978,309,459,202,8,347,174,276,181,206,66,109,24,7,141,65
86520,665,490,106,240,109,35,226,96,79,89,175,5,69,68,33,175,0
86535,316,254,57,103,94,0,103,67,66,18,62,0,27,26,9,48,14
86538,723,509,122,277,88,22,250,73,84,102,214,46,77,70,21,200,14
86540,195,125,15,66,34,10,26,39,36,24,70,14,18,22,16,70,0
86544,402,297,60,132,77,28,62,85,99,51,105,7,29,43,26,90,15
86545,513,418,68,236,86,28,166,112,87,53,95,32,21,34,8,95,0
86547,220,197,55,78,43,21,45,51,72,29,23,0,0,16,7,23,0
86549,233,165,34,62,59,10,69,18,24,54,68,0,20,32,16,68,0
86556,477,367,85,179,88,15,148,87,73,59,110,20,43,26,21,110,0
87001,815,707,101,352,217,37,204,208,134,161,108,29,53,20,6,77,31
87002,7740,5593,1091,2518,1465,519,1830,2428,794,541,2147,263,715,750,419,1756,391
87004,2730,2009,450,1040,386,133,678,580,451,300,721,163,266,210,82,575,146
87005,266,230,54,123,39,14,103,72,36,19,36,0,28,2,6,36,0
87006,218,162,23,92,40,7,49,63,34,16,56,16,23,8,9,47,9
87007,227,213,62,78,52,21,59,46,60,48,14,0,0,0,14,14,0
87008,1250,901,74,516,256,55,316,439,76,70,349,16,157,149,27,281,68
87010,401,179,71,71,31,6,56,88,35,0,222,26,121,60,15,173,49
87011,7,3,3,0,0,0,3,0,0,0,4,4,0,0,0,4,0
87012,140,109,29,38,31,11,51,32,14,12,31,2,6,13,10,26,5
87013,1632,1242,260,583,310,89,474,395,220,153,390,23,151,134,82,352,38
87014,494,426,100,191,119,16,126,146,77,77,68,0,54,9,5,49,19
87015,3709,3027,519,1866,554,88,1394,1114,312,207,682,124,332,201,25,540,142
87016,1374,1079,199,512,306,62,380,443,147,109,295,16,111,135,33,268,27
87017,185,143,26,69,34,14,53,55,24,11,42,5,1,23,13,39,3
87018,374,274,51,154,51,18,96,72,61,45,100,14,8,68,10,90,10
87020,4982,3618,914,1576,930,198,1238,1384,653,343,1364,187,437,585,155,1163,201
87022,278,198,39,83,42,34,33,35,66,64,80,3,32,22,23,68,12
87023,293,172,47,52,73,0,51,84,23,14,121,16,39,56,10,86,35
87024,580,476,58,241,129,48,140,113,82,141,104,15,51,30,8,87,17
87025,599,454,58,270,103,23,126,259,41,28,145,4,72,56,13,121,24
87026,1014,805,185,402,191,27,304,195,165,141,209,31,82,73,23,195,14
87027,57,50,0,28,16,6,12,30,8,0,7,0,7,0,0,0,7
87028,73,45,6,33,0,6,5,24,16,0,28,0,20,8,0,28,0
87029,108,85,12,44,24,5,23,51,7,4,23,0,6,12,5,23,0
87031,11703,9238,2304,4759,1863,312,3773,3105,1537,823,2465,528,981,739,217,1975,490
87032,119,87,25,48,14,0,41,30,11,5,32,0,19,8,5,24,8
87034,668,560,85,259,177,39,148,171,122,119,108,17,38,45,8,84,24
87035,2651,1923,450,990,395,88,810,659,269,185,728,82,304,251,91,604,124
87036,750,490,95,206,150,39,143,217,83,47,260,23,61,102,74,238,22
87037,290,219,29,78,86,26,53,91,21,54,71,12,17,35,7,71,0
87038,99,84,5,51,17,11,38,23,11,12,15,3,4,0,8,15,0
87040,171,121,28,39,54,0,30,27,20,44,50,0,15,24,11,50,0
87041,219,178,47,77,33,21,76,72,6,24,41,6,6,22,7,18,23
87042,975,806,176,366,207,57,267,362,93,84,169,59,59,38,13,101,68
87043,1628,1198,77,674,428,19,281,801,82,34,430,43,225,108,54,338,92
87044,149,116,10,59,26,21,26,56,25,9,33,0,7,26,0,33,0
87045,556,475,106,190,147,32,197,99,104,75,81,14,33,26,8,74,7
87047,1252,989,47,694,188,60,363,468,80,78,263,25,139,99,0,194,69
87048,2982,2279,130,1356,706,87,889,1173,132,85,703,87,264,260,92,524,179
87049,75,67,6,30,14,17,14,23,12,18,8,0,8,0,0,8,0
87052,567,517,37,283,158,39,106,121,139,151,50,13,15,17,5,50,0
87053,244,190,37,73,64,16,57,61,28,44,54,7,20,23,4,52,2
87056,313,266,19,183,46,18,116,150,0,0,47,5,32,10,0,34,13
87059,3872,2938,421,1821,624,72,1148,1416,213,161,934,114,571,206,43,748,186
87060,25,18,0,18,0,0,9,9,0,0,7,7,0,0,0,0,7
87061,137,77,9,29,39,0,9,43,16,9,60,10,18,23,9,46,14
87062,676,515,130,237,91,57,190,190,92,43,161,34,60,51,16,140,21
87063,62,42,1,14,25,2,14,27,1,0,20,2,5,10,3,17,3
87064,46,28,3,17,3,5,5,23,0,0,18,0,9,2,7,14,4
87068,1635,1285,151,713,345,76,442,609,133,101,350,57,114,163,16,276,74
87070,50,50,12,28,6,4,18,27,5,0,0,0,0,0,0,0,0
87072,168,151,18,65,54,14,37,60,22,32,17,2,5,5,5,17,0
87083,214,127,21,40,47,19,21,78,9,19,87,9,30,37,11,87,0
87102,8654,4196,1190,1905,762,339,1186,1148,980,882,4458,1666,1393,837,562,3580,878
87104,4760,2880,602,1212,776,290,681,1223,614,362,1880,321,767,502,290,1560,320
87105,17860,13606,2847,6417,3449,893,4495,4631,2263,2217,4254,618,1730,1293,613,3387,867
87106,11289,4988,1581,2204,872,331,1394,1761,1120,713,6301,3129,1880,848,444,4463,1838
87107,12467,7886,1522,3788,1950,626,2238,2984,1508,1156,4581,931,1641,1348,661,3769,812
87108,16533,8242,2674,3525,1391,652,2394,2580,2113,1155,8291,2039,3334,1737,1181,6683,1608
87109,17975,10665,2214,5129,2556,766,3256,4560,1762,1087,7310,2681,2008,1832,789,5765,1545
87110,17276,9814,1508,4280,2722,1304,2791,4444,1281,1298,7462,1711,2715,1727,1309,6102,1360
87111,23904,15124,2036,7542,4485,1061,4787,7543,1607,1187,8780,2409,2988,2134,1249,7330,1450
87112,18245,11815,2315,5498,3134,868,3636,5153,1842,1184,6430,1375,2235,1743,1077,5226,1204
87113,2785,1996,572,1014,311,99,775,645,376,200,789,231,263,165,130,602,187
87114,12193,8499,2380,4097,1689,333,3194,3480,1176,649,3694,1410,1259,737,288,2777,917
87116,1305,1090,877,213,0,0,667,302,121,0,215,215,0,0,0,215,0
87118,298,265,124,135,6,0,232,26,7,0,33,33,0,0,0,33,0
87120,16161,11924,3227,6840,1607,250,5277,4036,1782,829,4237,1201,1921,912,203,3194,1043
87121,11940,9648,3552,4565,1349,182,3493,2410,2462,1283,2292,604,967,476,245,1727,565
87122,4678,3790,293,2258,1145,94,1654,1910,187,39,888,151,446,202,89,735,153
87123,15260,9900,2475,4291,2450,684,2987,4033,1808,1072,5360,1098,1875,1470,917,4399,961
87124,19300,14430,3043,7716,2719,952,6155,5520,1763,992,4870,794,1969,1279,828,3994,876
87301,7486,5401,1348,2635,1143,275,1802,1479,1354,766,2085,359,857,604,265,1708,377
87305,1337,1074,245,555,227,47,533,232,160,149,263,20,117,79,47,236,27
87310,231,192,50,70,55,17,79,63,28,22,39,10,18,11,0,39,0
87311,978,793,202,360,201,30,263,120,233,177,185,32,86,35,32,171,14
87312,216,176,30,87,46,13,55,67,21,33,40,0,6,25,9,34,6
87313,1766,1404,301,792,256,55,555,318,304,227,362,97,85,121,59,347,15
87315,119,79,5,31,24,19,14,32,17,16,40,3,1,24,12,29,11
87316,393,327,66,189,72,0,136,58,74,59,66,7,27,25,7,66,0
87317,513,431,74,230,117,10,200,117,82,32,82,0,58,24,0,70,12
87319,489,364,80,176,93,15,114,89,115,46,125,0,40,31,54,119,6
87320,189,167,0,70,77,20,54,62,11,40,22,0,22,0,0,14,8
87321,859,631,123,305,166,37,248,187,128,68,228,46,94,73,15,228,0
87322,125,99,25,47,22,5,28,21,35,15,26,8,9,0,9,26,0
87323,1225,875,169,470,192,44,387,207,162,119,350,67,114,135,34,294,56
87325,724,520,102,254,137,27,205,109,90,116,204,63,57,84,0,170,34
87326,414,317,71,180,59,7,115,36,82,84,97,16,38,24,19,97,0
87327,1853,1634,318,888,340,88,554,377,301,402,219,37,81,78,23,191,28
87328,802,647,175,317,123,32,180,115,244,108,155,13,67,58,17,149,6
87347,124,115,43,53,19,0,76,39,0,0,9,0,9,0,0,9,0
87357,0,0,0,0,0,0,0,0,0,0,0,0,0,0,0,0,0
87364,834,662,91,318,196,57,246,117,134,165,172,10,84,52,26,150,22
87375,1216,989,248,451,261,29,364,246,224,155,227,24,105,40,58,205,22
87401,14031,10307,2510,5105,2130,562,3873,3593,1907,934,3724,775,1318,953,678,3142,582
87402,3116,2489,487,1302,641,59,1011,1143,227,108,627,134,234,135,124,506,121
87410,5502,4136,1036,1973,940,187,1696,1599,536,305,1366,242,650,337,137,1135,231
87412,281,186,32,81,61,12,69,81,25,11,95,6,42,31,16,84,11
87413,4370,3579,881,1797,729,172,1522,1282,515,260,791,94,293,261,143,681,110
87415,573,453,47,249,124,33,160,198,43,52,120,0,45,31,44,86,34
87416,1303,1123,219,629,252,23,464,241,239,179,180,32,62,60,26,157,23
87417,1882,1623,325,946,303,49,723,470,307,123,259,36,96,79,48,227,32
87418,376,280,26,212,32,10,113,140,16,11,96,9,28,33,26,64,32
87419,267,156,14,46,96,0,15,130,11,0,111,11,65,35,0,89,22
87420,2864,2424,582,1243,517,82,1024,524,529,347,440,48,157,205,30,406,34
87421,377,319,68,148,77,26,105,134,43,37,58,9,9,40,0,58,0
87455,474,377,29,207,105,36,96,135,73,73,97,15,22,23,37,82,15
87461,646,441,90,148,158,45,144,107,70,120,205,27,69,83,26,177,28
87501,18437,10341,1535,4832,3078,896,2695,4920,1512,1214,8096,1639,3307,2124,1026,6512,1584
87505,26938,17368,3476,9278,3798,816,6118,6616,3033,1601,9570,1630,4204,2709,1027,7469,2101
87510,456,302,50,147,98,7,84,139,46,33,154,16,106,32,0,132,22
87511,737,554,150,298,99,7,222,142,154,36,183,46,60,61,16,141,42
87512,71,63,16,27,16,4,26,20,13,4,8,3,0,5,0,8,0
87513,283,186,45,71,70,0,49,80,46,11,97,33,25,31,8,79,18
87514,529,310,34,187,68,21,109,128,50,23,219,42,138,39,0,149,70
87515,109,90,16,40,23,11,38,36,8,8,19,4,6,6,3,19,0
87516,40,28,2,14,10,2,15,7,4,2,12,0,2,7,3,12,0
87517,109,54,32,15,7,0,35,11,8,0,55,0,36,14,5,38,17
87518,44,30,0,12,13,5,9,19,0,2,14,0,5,5,4,14,0
87519,193,128,7,46,60,15,40,56,17,15,65,9,9,32,15,65,0
87520,700,465,64,207,152,42,139,246,53,27,235,23,86,100,26,195,40
87521,319,208,25,111,58,14,98,79,10,21,111,27,22,35,27,103,8
87522,1459,1060,227,530,270,33,371,368,193,128,399,54,177,113,55,361,38
87524,119,64,0,49,3,12,28,27,9,0,55,5,10,25,15,55,0
87525,159,84,16,58,10,0,45,32,7,0,75,16,43,16,0,51,24
87527,511,312,38,145,115,14,62,134,71,45,199,37,92,56,14,162,37
87528,869,664,149,397,108,10,218,144,202,100,205,35,63,84,23,176,29
87529,1279,751,93,397,219,42,247,353,87,64,528,91,207,179,51,424,104
87530,371,283,40,143,77,23,104,95,42,42,88,4,30,41,13,77,11
87531,204,132,17,68,29,18,27,65,21,19,72,0,29,38,5,61,11
87532,6480,4682,1019,2276,1121,266,1582,1678,916,506,1798,229,653,601,315,1524,274
87533,8,3,1,2,0,0,2,1,0,0,5,0,0,5,0,5,0
87535,618,449,112,241,85,11,160,175,100,14,169,29,80,47,13,126,43
87537,796,593,161,275,113,44,193,167,104,129,203,31,124,44,4,194,9
87539,136,76,14,38,22,2,36,31,7,2,60,7,31,0,22,51,9
87540,280,178,24,97,57,0,66,90,22,0,102,39,51,12,0,51,51
87543,93,65,7,36,17,5,42,11,6,6,28,5,11,12,0,19,9
87544,7500,5399,720,2804,1510,365,2130,2674,428,167,2101,489,847,509,256,1862,239
87548,277,201,43,105,46,7,81,53,43,24,76,20,35,17,4,67,9
87549,423,311,76,133,79,23,81,122,64,44,112,5,52,35,20,90,22
87551,183,126,9,57,50,10,31,74,8,13,57,6,21,13,17,52,5
87552,1172,836,193,456,151,36,316,304,153,63,336,56,156,95,29,266,70
87553,573,415,92,174,115,34,128,134,76,77,158,26,43,71,18,144,14
87556,1033,678,116,344,173,45,258,249,109,62,355,38,126,109,82,323,32
87557,2429,1522,328,741,380,73,478,523,341,180,907,113,323,310,161,725,182
87558,294,194,21,69,95,9,43,129,12,10,100,16,41,33,10,83,17
87560,413,330,50,142,108,30,97,139,39,55,83,9,40,34,0,78,5
87562,169,137,27,80,16,14,28,48,36,25,32,8,4,6,14,32,0
87564,182,112,6,75,31,0,40,33,29,10,70,18,6,39,7,39,31
87565,409,258,65,113,70,10,115,80,25,38,151,8,72,50,21,125,26
87566,1068,809,197,395,170,47,284,227,161,137,259,48,99,87,25,212,47
87567,844,576,185,262,100,29,197,232,109,38,268,44,128,47,49,171,97
87569,140,90,46,44,0,0,62,22,6,0,50,0,28,22,0,38,12
87571,4425,2634,341,1486,658,149,725,936,585,388,1791,223,786,495,287,1522,269
87573,7,0,0,0,0,0,0,0,0,0,7,0,0,7,0,7,0
87575,247,176,25,72,66,13,49,92,10,25,71,13,16,28,14,61,10
87577,144,73,11,32,30,0,34,28,0,11,71,0,45,21,5,56,15
87578,517,382,48,179,127,28,112,167,32,71,135,8,32,61,34,135,0
87579,223,164,25,69,54,16,54,57,27,26,59,0,11,26,22,54,5
87580,109,57,24,14,19,0,31,26,0,0,52,0,37,15,0,52,0
87581,44,25,2,14,7,2,15,5,0,5,19,2,8,0,9,14,5
87582,696,491,138,211,121,21,166,155,119,51,205,10,58,100,37,161,44
87583,74,61,0,40,16,5,29,28,0,4,13,0,6,7,0,13,0
87701,7668,5028,1099,2387,1176,366,1459,1489,1241,839,2640,527,984,741,388,2191,449
87710,635,458,45,214,185,14,117,270,60,11,177,17,70,73,17,138,39
87711,290,235,33,104,76,22,93,89,31,22,55,0,13,27,15,55,0
87712,176,138,6,52,64,16,45,64,19,10,38,4,12,22,0,32,6
87713,67,35,0,8,24,3,0,27,0,8,32,5,15,8,4,32,0
87714,511,350,50,165,113,22,115,165,47,23,161,8,71,47,35,142,19
87715,196,118,15,48,35,20,32,43,15,28,78,9,16,34,19,55,23
87718,246,160,17,71,57,15,47,80,19,14,86,25,45,14,2,71,15
87722,174,114,0,86,24,4,34,55,20,5,60,7,39,0,14,60,0
87723,205,166,34,72,37,23,32,80,32,22,39,8,17,8,6,39,0
87724,63,47,16,23,8,0,16,8,23,0,16,0,9,7,0,16,0
87728,179,138,18,58,45,17,44,75,7,12,41,6,15,10,10,32,9
87729,52,41,1,19,21,0,17,24,0,0,11,0,6,5,0,5,6
87730,14,10,0,5,5,0,5,5,0,0,4,0,0,4,0,4,0
87731,32,20,10,4,6,0,4,16,0,0,12,0,5,0,7,7,5
87732,582,406,94,180,101,31,98,134,130,44,176,22,67,53,34,166,10
87733,125,84,5,39,23,17,25,37,6,16,41,6,9,14,12,40,1
87734,91,54,3,18,29,4,12,36,4,2,37,5,3,18,11,25,12
87735,36,23,0,10,0,13,4,13,6,0,13,0,6,0,7,13,0
87736,79,69,19,21,25,4,24,28,10,7,10,0,0,5,5,10,0
87740,3479,2360,466,960,711,223,693,1081,365,221,1119,113,344,358,304,1024,95
87742,252,198,32,71,86,9,41,120,20,17,54,18,14,17,5,31,23
87743,212,120,9,41,48,22,25,67,15,13,92,3,24,35,30,84,8
87745,353,262,47,147,61,7,104,105,30,23,91,9,47,15,20,91,0
87747,697,497,99,183,165,50,137,231,80,49,200,15,64,76,45,194,6
87750,8,4,0,0,4,0,4,0,0,0,4,2,2,0,0,4,0
87752,225,135,20,52,47,16,38,72,16,9,90,10,36,23,21,78,12
87753,83,71,15,33,11,12,15,34,15,7,12,0,7,5,0,12,0
87801,3915,2537,579,1188,615,155,683,1020,595,239,1378,491,373,285,229,1133,245
87820,62,38,2,23,9,4,18,13,0,7,24,2,7,10,5,20,4
87821,221,154,16,51,82,5,49,75,10,20,67,4,17,41,5,61,6
87823,473,333,49,115,126,43,90,194,29,20,140,43,30,36,31,114,26
87824,80,59,8,9,38,4,13,41,0,5,21,3,9,4,5,18,3
87825,859,652,123,334,159,36,239,218,127,68,207,30,65,63,49,174,33
87827,54,29,0,12,8,9,6,23,0,0,25,3,11,8,3,18,7
87828,146,111,17,59,28,7,49,29,27,6,35,0,18,0,17,22,13
87829,422,291,31,140,109,11,70,173,34,14,131,11,47,48,25,116,15
87830,471,308,36,103,135,34,65,175,34,34,163,12,46,75,30,146,17
87831,101,62,5,25,32,0,18,41,0,3,39,4,19,8,8,36,3
87832,301,198,23,98,56,21,96,79,14,9,103,17,26,52,8,79,24
87901,3654,1990,350,655,696,289,499,1039,287,165,1664,143,419,614,488,1495,169
87930,190,148,38,67,43,0,72,37,25,14,42,15,6,21,0,15,27
87931,305,204,27,55,80,42,55,133,0,16,101,0,61,32,8,88,13
87933,49,30,0,15,15,0,11,9,4,6,19,0,7,12,0,12,7
87935,931,633,29,149,364,91,62,508,23,40,298,14,66,150,68,248,50
87936,149,130,12,66,42,10,56,64,4,6,19,0,0,5,14,19,0
87937,1089,840,216,399,184,41,386,240,159,55,249,23,67,87,72,218,31
87939,75,67,11,37,19,0,32,35,0,0,8,0,0,0,8,8,0
87940,157,133,32,39,46,16,56,60,17,0,24,0,10,0,14,21,3
87941,275,221,43,101,54,23,115,56,27,23,54,5,7,29,13,37,17
87942,630,406,44,182,121,59,129,183,39,55,224,6,42,122,54,205,19
87943,78,50,0,6,31,13,0,47,3,0,28,0,14,14,0,28,0
88001,13577,8457,2790,3292,1870,505,2421,2870,2070,1096,5120,2294,1272,961,593,3564,1556
88002,482,393,173,207,13,0,221,135,37,0,89,27,57,5,0,81,8
88003,3,0,0,0,0,0,0,0,0,0,3,3,0,0,0,0,3
88004,0,0,0,0,0,0,0,0,0,0,0,0,0,0,0,0,0
88005,17030,11995,2422,5509,3314,750,4093,5013,1963,926,5035,1205,1578,1490,762,4044,991
88008,1766,1437,424,653,284,76,722,556,98,61,329,8,195,104,22,293,36
88009,82,64,10,47,7,0,37,19,8,0,18,3,9,6,0,18,0
88011,7305,4601,880,2045,1315,361,1460,2195,547,399,2704,1015,716,585,388,2017,687
88012,5108,3965,1006,1945,883,131,1625,1367,671,302,1143,204,494,349,96,893,250
88020,374,291,47,154,75,15,133,115,31,12,83,15,10,35,23,73,10
88021,7417,6311,1663,3069,1344,235,3029,1658,1040,584,1106,141,547,287,131,1012,94
88022,28,28,7,13,8,0,8,5,10,5,0,0,0,0,0,0,0
88023,988,730,125,300,234,71,200,309,132,89,258,11,51,106,90,234,24
88024,236,196,69,82,27,18,128,26,25,17,40,0,0,40,0,40,0
88025,175,142,15,47,68,12,42,72,23,5,33,0,7,13,13,26,7
88026,652,475,125,191,104,55,151,145,109,70,177,34,48,56,39,158,19
88027,56,46,7,29,10,0,15,20,11,0,10,0,10,0,0,10,0
88029,628,459,102,199,128,30,217,139,69,34,169,6,40,92,31,146,23
88030,8759,6152,1263,2302,2019,568,1933,2628,1027,564,2607,226,735,1052,594,2329,278
88033,23,13,0,0,9,4,9,4,0,0,10,0,10,0,0,10,0
88036,103,54,13,41,0,0,0,13,32,9,49,8,23,18,0,49,0
88038,77,54,18,24,12,0,23,27,4,0,23,0,0,13,10,23,0
88039,277,174,22,65,71,16,53,103,10,8,103,0,35,50,18,92,11
88040,29,9,0,9,0,0,0,0,9,0,20,0,0,10,10,10,10
88041,684,491,52,194,164,81,110,279,58,44,193,10,63,63,57,170,23
88042,179,65,9,17,27,12,10,40,6,9,114,0,13,66,35,95,19
88043,743,536,129,165,184,58,143,258,90,45,207,12,49,68,78,181,26
88044,1091,905,129,465,230,81,289,447,107,62,186,12,100,40,34,173,13
88045,1412,991,231,446,250,64,308,357,212,114,421,42,116,167,96,379,42
88047,477,427,99,187,122,19,145,180,58,44,50,9,16,0,25,44,6
88048,1404,1234,291,655,222,66,591,322,231,90,170,30,102,38,0,138,32
88049,235,160,25,66,42,27,48,94,18,0,75,0,38,33,4,67,8
88051,35,19,0,0,19,0,0,19,0,0,16,0,7,9,0,16,0
88052,94,42,17,13,12,0,15,18,9,0,52,0,20,32,0,46,6
88053,135,96,4,54,38,0,39,49,4,4,39,11,12,16,0,22,17
88055,34,28,0,9,6,13,9,12,0,7,6,0,6,0,0,6,0
88056,121,62,19,23,11,9,26,28,5,3,59,2,19,27,11,52,7
88061,8058,5597,1120,2400,1581,496,1665,2565,931,436,2461,356,746,904,455,2130,331
88063,2544,2276,545,1125,510,96,978,602,410,286,268,0,81,126,61,208,60
88065,155,116,16,54,46,0,43,67,0,6,39,0,0,27,12,31,8
88072,244,244,59,128,57,0,125,82,37,0,0,0,0,0,0,0,0
88101,15668,11135,3475,4831,2186,643,4180,4215,1908,832,4533,1205,1341,1129,858,4002,531
88112,64,40,0,16,19,5,12,25,0,3,24,2,8,8,6,22,2
88113,25,19,3,7,6,3,8,11,0,0,6,0,1,2,3,6,0
88114,27,21,3,8,7,3,6,12,3,0,6,0,0,1,5,6,0
88115,31,30,6,11,2,11,17,13,0,0,1,0,0,0,1,1,0
88116,234,164,31,46,55,32,50,99,6,9,70,6,12,28,24,68,2
88118,86,75,16,28,21,10,23,45,4,3,11,0,5,2,4,11,0
88119,880,595,77,241,205,72,180,309,48,58,285,33,50,95,107,267,18
88120,139,96,13,55,28,0,40,47,7,2,43,6,2,25,10,43,0
88121,71,44,6,17,10,11,13,27,0,4,27,0,5,13,9,27,0
88124,496,350,43,167,115,25,108,197,31,14,146,19,44,57,26,136,10
88125,29,21,6,13,2,0,18,3,0,0,8,6,0,2,0,6,2
88126,12,12,4,5,3,0,2,10,0,0,0,0,0,0,0,0,0
88130,6137,4171,1325,1575,979,292,1634,1625,562,350,1966,625,474,519,348,1552,414
88132,93,76,13,26,31,6,23,40,13,0,17,4,3,4,6,11,6
88134,23,18,2,10,4,2,7,11,0,0,5,0,0,5,0,5,0
88135,559,422,77,216,105,24,179,159,50,34,137,16,36,51,34,121,16
88136,25,9,0,5,4,0,0,9,0,0,16,4,0,8,4,16,0
88201,19949,14059,3033,6447,3415,1164,4580,5902,2455,1122,5890,685,1582,1999,1624,5219,671
88210,5816,4252,870,2067,1056,259,1634,1742,599,277,1564,201,463,510,390,1406,158
88213,5,3,1,0,2,0,1,2,0,0,2,0,0,0,2,2,0
88220,12657,9140,1866,4211,2253,810,3019,4054,1366,701,3517,516,1115,1034,852,3092,425
88230,1627,1402,283,702,330,87,558,553,186,105,225,46,38,113,28,212,13
88231,1079,830,192,382,195,61,301,372,94,63,249,56,57,79,57,232,17
88232,867,685,145,318,161,61,296,252,90,47,182,17,49,79,37,160,22
88240,11071,8082,2225,3632,1718,507,3059,3106,1350,567,2989,410,814,1156,609,2662,327
88242,1782,1482,272,855,320,35,595,645,164,78,300,22,176,96,6,255,45
88250,128,87,10,62,12,3,24,59,4,0,41,0,14,15,12,33,8
88252,804,607,105,257,210,35,212,307,50,38,197,12,35,70,80,184,13
88253,70,70,5,57,8,0,48,17,0,5,0,0,0,0,0,0,0
88254,53,41,0,0,41,0,0,41,0,0,12,4,0,8,0,12,0
88255,38,26,0,26,0,0,0,21,5,0,12,0,12,0,0,7,5
88256,625,500,93,246,134,27,205,206,59,30,125,21,38,36,30,120,5
88260,4377,3357,808,1542,831,176,1390,1252,483,232,1020,128,225,366,301,914,106
88262,35,22,2,9,7,4,7,13,2,0,13,0,7,6,0,11,2
88263,41,22,9,6,7,0,9,13,0,0,19,0,6,13,0,13,6
88264,0,0,0,0,0,0,0,0,0,0,0,0,0,0,0,0,0
88265,107,81,16,42,23,0,48,33,0,0,26,0,0,15,11,26,0
88267,433,311,57,135,93,26,136,116,39,20,122,9,28,51,34,116,6
88268,18,16,0,16,0,0,11,2,3,0,2,0,2,0,0,2,0
88301,632,401,58,165,145,33,97,221,52,31,231,10,69,88,64,211,20
88310,15740,11442,3168,4812,2840,622,4275,4816,1572,779,4298,837,1291,1361,809,3859,439
88312,535,418,29,196,188,5,69,278,37,34,117,10,40,59,8,97,20
88314,80,70,9,43,18,0,13,40,8,9,10,0,10,0,0,10,0
88316,909,643,83,314,196,50,201,357,48,37,266,9,96,110,51,240,26
88317,864,620,59,232,305,24,148,391,61,20,244,16,79,114,35,231,13
88318,151,113,15,49,41,8,35,62,12,4,38,4,11,12,11,31,7
88321,143,90,13,37,27,13,28,45,8,9,53,5,23,19,6,50,3
88323,7,7,0,0,7,0,0,7,0,0,0,0,0,0,0,0,0
88324,48,31,3,13,15,0,0,15,9,7,17,0,0,17,0,17,0
88325,433,320,36,156,121,7,98,186,24,12,113,12,40,53,8,98,15
88330,412,394,200,189,5,0,285,90,12,7,18,9,7,2,0,16,2
88336,83,61,3,25,27,6,24,27,9,1,22,2,12,6,2,20,2
88337,949,722,83,388,193,58,201,372,104,45,227,27,66,97,37,172,55
88338,39,21,0,11,5,5,6,10,5,0,18,0,0,14,4,18,0
88339,151,105,8,40,41,16,19,80,0,6,46,0,24,16,6,41,5
88340,835,691,213,373,101,4,220,93,272,106,144,48,56,34,6,119,25
88341,227,182,4,101,66,11,44,120,12,6,45,4,15,12,14,37,8
88343,24,21,0,13,8,0,5,13,0,3,3,2,0,1,0,3,0
88344,80,80,12,13,55,0,5,68,7,0,0,0,0,0,0,0,0
88345,4235,2821,308,1142,1148,223,719,1583,340,179,1414,174,469,599,172,1219,195
88346,1024,713,136,369,175,33,237,263,137,76,311,58,107,95,51,231,80
88347,57,34,2,17,15,0,4,20,5,5,23,4,0,19,0,23,0
88348,229,182,21,90,56,15,55,84,22,21,47,4,13,16,14,45,2
88350,109,69,6,20,38,5,20,49,0,0,40,0,0,37,3,31,9
88351,63,36,3,16,9,8,9,27,0,0,27,5,7,4,11,27,0
88352,1918,1305,203,578,424,100,385,657,166,97,613,54,218,209,132,494,119
88353,244,173,46,78,33,16,59,64,28,22,71,0,22,31,18,69,2
88354,65,61,3,37,11,10,31,25,5,0,4,0,4,0,0,4,0
88401,3232,2202,329,899,780,194,638,1042,281,241,1030,110,325,339,256,929,101
88410,76,52,14,13,25,0,21,22,0,9,24,6,12,6,0,24,0
88411,31,16,4,5,2,5,9,7,0,0,15,0,10,2,3,8,7
88414,44,32,4,12,16,0,0,28,4,0,12,3,3,3,3,12,0
88415,1260,831,161,351,212,107,258,406,119,48,429,49,94,164,122,394,35
88416,186,130,0,21,97,12,10,120,0,0,56,4,20,25,7,47,9
88417,9,9,0,0,9,0,0,9,0,0,0,0,0,0,0,0,0
88418,161,126,17,70,31,8,36,57,22,11,35,5,7,18,5,35,0
88419,58,30,0,26,4,0,17,13,0,0,28,6,7,12,3,28,0
88421,25,0,0,0,0,0,0,0,0,0,25,0,0,7,18,18,7
88422,4,4,0,4,0,0,0,4,0,0,0,0,0,0,0,0,0
88424,21,13,0,5,4,4,5,8,0,0,8,0,0,8,0,8,0
88426,517,360,55,145,113,47,103,195,42,20,157,11,28,67,51,133,24
88427,56,41,18,6,12,5,18,21,2,0,15,0,6,6,3,15,0
88430,43,27,4,11,11,1,11,14,2,0,16,0,5,9,2,16,0
88431,22,15,0,15,0,0,0,15,0,0,7,0,0,7,0,7,0
88434,170,113,15,55,36,7,42,47,15,9,57,0,9,27,21,57,0
88435,1135,794,131,424,187,52,267,287,152,88,341,47,88,142,64,315,26
88436,85,67,12,40,15,0,45,22,0,0,18,6,0,6,6,18,0
88437,19,19,0,3,12,4,11,4,0,4,0,0,0,0,0,0,0
89001,393,290,59,116,115,0,106,138,40,6,103,7,19,42,35,84,19
89003,439,270,63,119,82,6,124,113,25,8,169,6,48,93,22,136,33
89004,152,69,0,54,8,7,12,35,11,11,83,0,60,23,0,41,42
89005,6429,4305,389,1766,1644,506,1182,2535,335,253,2124,188,658,718,560,1758,366
89007,298,247,39,151,49,8,130,63,29,25,51,0,0,41,10,39,12
89008,501,319,77,128,87,27,129,129,44,17,182,19,56,61,46,166,16
89010,154,89,8,45,27,9,26,48,8,7,65,6,24,25,10,58,7
89011,98,98,0,49,49,0,11,87,0,0,0,0,0,0,0,0,0
89012,6995,4892,993,1889,1649,361,1441,2958,308,185,2103,620,624,675,184,1590,513
89013,198,117,10,49,48,10,27,83,5,2,81,0,25,36,20,69,12
89014,31136,21484,4294,11277,4950,963,7822,8699,3041,1922,9652,3427,3662,1996,567,6571,3081
89015,22940,17214,3763,8232,4467,752,6079,7569,2193,1373,5726,904,2134,1874,814,4226,1500
89017,15,7,0,0,7,0,0,7,0,0,8,0,0,0,8,8,0
89018,452,332,60,164,78,30,118,135,67,12,120,10,49,44,17,64,56
89019,1098,560,78,246,182,54,151,308,36,65,538,46,283,177,32,234,304
89020,476,247,43,149,55,0,126,75,23,23,229,22,88,83,36,175,54
89021,648,530,94,300,119,17,294,163,67,6,118,15,33,46,24,92,26
89022,725,532,130,293,87,22,280,173,61,18,193,56,85,52,0,153,40
89024,143,99,20,37,40,2,29,53,8,9,44,3,24,14,3,42,2
89025,421,351,128,158,65,0,185,83,46,37,70,0,20,50,0,61,9
89027,3547,2628,492,917,1030,189,800,1508,215,105,919,128,209,428,154,722,197
89028,11,3,0,0,3,0,0,3,0,0,8,0,0,6,2,6,2
89029,3096,2032,257,879,820,76,465,1117,322,128,1064,142,375,439,108,744,320
89030,14017,11040,4124,4729,1919,268,4744,2292,2420,1584,2977,626,1057,996,298,2145,832
89031,11399,9165,3013,4414,1584,154,4260,3275,1062,568,2234,629,1103,413,89,1389,845
89032,8715,7055,2297,3382,1227,149,2835,2312,1127,781,1660,444,729,419,68,1133,527
89039,217,115,0,17,98,0,12,87,5,11,102,0,37,55,10,92,10
89040,1684,1220,178,462,471,109,441,668,63,48,464,96,90,137,141,387,77
89042,326,207,44,73,65,25,72,113,12,10,119,4,16,51,48,110,9
89043,315,199,25,91,71,12,92,86,6,15,116,4,20,48,44,108,8
89046,547,238,11,12,174,41,0,229,9,0,309,26,120,145,18,276,33
89047,76,37,15,10,12,0,18,7,9,3,39,5,22,9,3,29,10
89048,10230,7180,919,2727,3019,515,1847,4194,653,486,3050,277,781,1451,541,2408,642
89049,1216,728,188,399,115,26,293,332,86,17,488,55,169,207,57,444,44
89052,5912,4183,1277,1762,1044,100,1371,2224,327,261,1729,731,595,357,46,1092,637
89101,16968,9132,3591,4008,1162,371,3649,2214,1910,1359,7836,1165,3227,2704,740,6355,1481
89102,14794,8532,2616,3366,1897,653,2549,3107,1414,1462,6262,1375,2102,1932,853,4903,1359
89103,20312,11160,2879,4843,2602,836,2774,4697,1956,1733,9152,2276,3374,2556,946,6751,2401
89104,15052,9001,1884,4289,2120,708,2817,3432,1453,1299,6051,730,1932,2442,947,4897,1154
89106,8631,5587,1831,2151,1235,370,1436,1499,1550,1102,3044,600,1134,1007,303,2472,572
89107,13282,8658,2113,3748,2256,541,2984,3233,1248,1193,4624,781,1603,1404,836,3544,1080
89108,23913,16346,4817,7444,3394,691,5090,5633,3477,2146,7567,1905,3133,1848,681,5405,2162
89109,19013,8181,2394,3414,1725,648,2117,3181,1553,1330,10832,2789,4240,2719,1084,8401,2431
89110,19454,15081,4510,6986,3043,542,5646,4675,2889,1871,4373,970,1701,1363,339,3041,1332
89113,3465,2255,404,1008,740,103,617,1239,248,151,1210,325,506,257,122,879,331
89115,16695,12272,5034,5271,1694,273,4765,3118,3132,1257,4423,1468,1818,930,207,3339,1084
89117,21437,13822,2717,6607,3813,685,4352,6357,1726,1387,7615,2631,2719,1667,598,5468,2147
89118,7153,4013,1128,1926,866,93,1253,1648,627,485,3140,1337,993,703,107,2087,1053
89119,21018,10390,3399,4149,2157,685,2956,3674,2151,1609,10628,3700,3785,2321,822,7894,2734
89120,8438,5523,1018,2547,1664,294,1582,2642,725,574,2915,783,997,914,221,2100,815
89121,25506,15517,2952,6476,4925,1164,3659,7186,2507,2165,9989,1993,3169,3383,1444,7448,2541
89122,10313,6494,1430,2418,2043,603,1530,3091,1012,861,3819,639,1215,1353,612,3032,787
89123,17694,12413,3352,5910,2739,412,4788,5386,1212,1027,5281,1890,2060,1068,263,3514,1767
89124,612,394,7,245,126,16,108,194,39,53,218,0,156,54,8,161,57
89128,16153,10670,2558,5220,2493,399,3492,4229,1823,1126,5483,1721,2170,1293,299,3967,1516
89129,11466,8703,2130,4515,1846,212,3802,3530,876,495,2763,999,1029,647,88,1861,902
89130,9114,6978,1620,3003,2029,326,2408,3506,643,421,2136,544,869,540,183,1437,699
89131,3487,2852,840,1378,572,62,1285,1154,252,161,635,312,206,89,28,437,198
89134,11571,8535,502,2255,4401,1377,1685,6253,292,305,3036,267,372,1563,834,2548,488
89135,1447,1064,323,439,271,31,302,688,21,53,383,117,171,95,0,299,84
89139,704,559,41,321,187,10,177,309,31,42,145,8,33,94,10,106,39
89141,97,97,0,89,0,8,73,24,0,0,0,0,0,0,0,0,0
89142,7189,5723,1556,2887,1105,175,2535,1852,790,546,1466,423,689,272,82,925,541
89143,809,642,262,273,101,6,254,260,81,47,167,44,108,6,9,109,58
89144,4672,3422,962,1540,802,118,1367,1620,291,144,1250,443,444,316,47,922,328
89145,7167,5199,966,2699,1336,198,1766,2186,655,592,1968,371,792,630,175,1454,514
89146,7134,4699,853,2198,1438,210,1316,2023,673,687,2435,544,1110,632,149,1759,676
89147,14983,10450,2282,5383,2375,410,3803,4594,1209,844,4533,1540,1735,907,351,3156,1377
89148,324,261,57,134,59,11,93,128,20,20,63,0,49,14,0,43,20
89149,4168,3347,325,1859,1082,81,1303,1688,176,180,821,155,403,208,55,597,224
89156,7698,5783,1645,2671,1218,249,2151,2336,803,493,1915,442,844,490,139,1372,543
89191,774,721,559,162,0,0,446,181,87,7,53,11,34,8,0,29,24
89301,2499,1603,399,697,378,129,566,661,259,117,896,145,280,293,178,748,148
89310,213,120,14,72,28,6,43,77,0,0,93,13,23,27,30,79,14
89311,83,55,0,28,27,0,0,41,14,0,28,0,10,18,0,28,0
89314,65,34,8,18,6,2,6,7,20,1,31,5,13,13,0,26,5
89316,424,296,49,152,77,18,150,112,22,12,128,19,57,34,18,115,13
89317,114,105,0,73,23,9,42,56,7,0,9,0,0,0,9,9,0
89318,583,383,56,116,179,32,64,226,68,25,200,6,59,59,76,190,10
89403,3125,2372,445,1207,600,120,931,1081,188,172,753,67,390,245,51,572,181
89404,29,17,17,0,0,0,17,0,0,0,12,0,0,12,0,12,0
89405,117,108,17,60,28,3,32,47,14,15,9,9,0,0,0,9,0
89406,8924,6550,1646,2902,1563,439,2611,2818,775,346,2374,408,716,740,510,1998,376
89408,3199,2440,621,1141,559,119,1006,879,298,257,759,126,245,286,102,592,167
89409,171,101,12,46,35,8,26,43,20,12,70,2,21,32,15,70,0
89410,7742,5822,841,2821,1793,367,1957,2746,780,339,1920,246,703,664,307,1496,424
89411,196,141,0,86,43,12,61,57,0,23,55,0,39,16,0,55,0
89413,197,147,0,57,68,22,10,137,0,0,50,8,18,24,0,40,10
89414,162,125,25,57,38,5,34,70,21,0,37,0,37,0,0,37,0
89415,1780,1157,164,482,384,127,277,552,178,150,623,40,182,258,143,562,61
89418,181,131,14,71,41,5,40,62,20,9,50,2,11,18,19,38,12
89419,1414,965,240,410,273,42,374,399,138,54,449,91,152,125,81,390,59
89420,25,8,0,8,0,0,0,8,0,0,17,0,0,17,0,9,8
89421,172,121,6,48,51,16,24,64,14,19,51,22,8,13,8,51,0
89422,108,49,16,17,11,5,16,29,4,0,59,7,38,14,0,48,11
89423,3171,2527,278,1236,853,160,821,1412,216,78,644,58,246,185,155,525,119
89424,166,114,24,69,21,0,24,19,42,29,52,6,9,31,6,34,18
89425,138,110,13,57,28,12,51,59,0,0,28,6,9,7,6,28,0
89426,143,101,12,70,7,12,46,27,14,14,42,8,16,10,8,42,0
89427,288,181,34,87,45,15,60,53,44,24,107,13,44,32,18,76,31
89428,88,60,0,49,11,0,9,32,16,3,28,0,11,9,8,17,11
89429,2555,1828,301,864,554,109,578,891,191,168,727,32,263,345,87,552,175
89430,135,101,15,63,23,0,70,28,0,3,34,0,0,11,23,34,0
89431,13808,8734,2407,3984,1876,467,3087,2936,1513,1198,5074,898,2022,1478,676,3966,1108
89433,6544,4948,1394,2432,932,190,1876,1605,842,625,1596,325,740,405,126,1036,560
89434,8103,5652,1072,3155,1150,275,2119,2209,835,489,2451,589,832,607,423,1910,541
89436,7262,6119,1361,3566,1070,122,2964,2483,463,209,1143,264,585,248,46,729,414
89439,550,318,20,158,125,15,91,168,29,30,232,28,76,86,42,203,29
89440,491,265,14,158,85,8,71,145,33,16,226,22,115,68,21,202,24
89442,388,273,72,112,61,28,82,90,44,57,115,20,30,36,29,95,20
89444,1081,820,63,319,340,98,207,514,48,51,261,32,80,126,23,208,53
89445,5453,3989,1067,2036,790,96,1840,1395,552,202,1464,300,631,389,144,1178,286
89447,3163,2133,310,846,725,252,610,1064,274,185,1030,122,291,361,256,878,152
89448,1159,707,49,292,293,73,129,451,101,26,452,56,197,165,34,346,106
89449,1686,948,98,552,246,52,327,508,78,35,738,190,349,168,31,523,215
89451,4024,2676,267,1324,912,173,925,1468,184,99,1348,271,583,447,47,972,376
89501,1523,483,191,171,113,8,108,235,67,73,1040,186,481,257,116,873,167
89502,18483,10466,3390,4714,1872,490,3463,3671,1932,1400,8017,2075,2960,2065,917,6078,1939
89503,12943,6400,1548,3083,1342,427,2077,2646,881,796,6543,2396,1896,1623,628,4577,1966
89506,11314,8600,1969,4797,1663,171,3451,3272,1216,661,2714,507,1277,775,155,1874,840
89509,18809,10953,1499,4925,3365,1164,3068,5586,1416,883,7856,1582,2835,1959,1480,6343,1513
89510,520,374,54,207,94,19,137,171,38,28,146,3,78,54,11,113,33
89511,11287,8106,1129,4511,2151,315,3118,3972,619,397,3181,760,1249,847,325,2318,863
89512,8714,4954,1448,2228,989,289,1552,1534,1192,676,3760,871,1239,1092,558,2944,816
89523,6579,4434,956,2620,728,130,1997,1664,488,285,2145,811,889,344,101,1371,774
89701,9305,6410,1238,3262,1490,420,2118,2683,1060,549,2895,528,963,940,464,2345,550
89703,4120,2648,234,1139,979,296,672,1478,301,197,1472,200,492,442,338,1276,196
89704,1628,1246,112,738,372,24,396,693,74,83,382,32,164,127,59,282,100
89705,1612,1237,267,551,360,59,451,622,101,63,375,42,183,118,32,260,115
89706,7423,4841,1149,2071,1261,360,1454,2126,786,475,2582,401,795,873,513,2108,474
89801,7519,5280,1433,2653,1014,180,2416,1865,618,381,2239,589,816,599,235,1785,454
89803,58,34,9,7,12,6,16,10,0,8,24,0,24,0,0,18,6
89815,3824,3244,811,1880,476,77,1685,1218,290,51,580,109,291,125,55,430,150
89820,1903,1449,340,748,345,16,607,581,187,74,454,115,178,150,11,383,71
89821,226,133,24,64,41,4,42,70,10,11,93,2,33,52,6,75,18
89822,814,605,187,279,117,22,244,233,87,41,209,23,72,86,28,171,38
89823,64,41,8,20,8,5,21,8,7,5,23,4,8,11,0,15,8
89824,9,9,9,0,0,0,0,9,0,0,0,0,0,0,0,0,0
89825,480,268,115,109,37,7,103,78,68,19,212,38,126,48,0,164,48
89826,19,19,0,9,10,0,9,10,0,0,0,0,0,0,0,0,0
89828,97,79,20,32,22,5,20,52,7,0,18,5,6,7,0,13,5
89830,131,62,14,35,13,0,40,8,0,14,69,0,29,40,0,61,8
89831,30,30,0,11,10,9,11,19,0,0,0,0,0,0,0,0,0
89832,334,206,42,95,54,15,52,57,56,41,128,11,55,50,12,116,12
89833,70,42,0,28,11,3,17,17,5,3,28,0,10,11,7,28,0
89834,85,37,0,27,10,0,9,20,8,0,48,0,26,13,9,32,16
89835,682,487,100,217,134,36,182,216,56,33,195,29,80,51,35,173,22
89883,1416,1101,471,503,113,14,569,248,213,71,315,56,184,75,0,240,75
90001,12513,10784,3469,5453,1424,438,5140,1509,2502,1633,1729,262,436,610,421,1400,329
90002,10821,8817,2762,4207,1325,523,3283,1201,2661,1672,2004,194,618,662,530,1751,253
90003,14552,11740,4041,5717,1521,461,4687,1586,3286,2181,2812,423,871,1057,461,2329,483
90004,23142,15117,4451,7602,2509,555,5824,3865,2885,2543,8025,2986,2720,1643,676,6180,1845
90005,15337,9517,3651,4242,1237,387,3421,2523,1953,1620,5820,2137,1829,1110,744,4495,1325
90006,18512,13596,4839,6398,2001,358,5327,2874,3014,2381,4916,1316,1585,1486,529,3758,1158
90007,12607,7004,2385,3299,1035,285,2589,1457,1602,1356,5603,3383,956,874,390,3276,2327
90008,13510,7812,1770,3427,1887,728,1590,2126,2300,1796,5698,802,2019,2036,841,5017,681
90010,902,424,57,184,129,54,112,241,14,57,478,141,160,105,72,415,63
90011,21813,18625,7196,8795,2144,490,8721,2343,4856,2705,3188,482,894,1150,662,2601,587
90012,7955,3948,755,1668,1081,444,1164,1592,425,767,4007,1170,824,911,1102,3492,515
90013,3552,499,87,199,123,90,87,242,63,107,3053,467,1242,868,476,2860,193
90014,2588,385,49,73,131,132,72,250,0,63,2203,143,882,871,307,2148,55
90015,4976,3004,1373,1123,403,105,1135,644,722,503,1972,659,606,479,228,1581,391
90016,16340,10936,2772,5454,2047,663,3615,2299,2692,2330,5404,798,1803,1813,990,4750,654
90017,6453,4108,1848,1782,343,135,1455,706,1044,903,2345,563,844,689,249,1860,485
90018,15232,10286,2828,5336,1676,446,3576,1873,2738,2099,4946,768,1628,1544,1006,4373,573
90019,24286,15424,4215,7581,2864,764,5083,3918,3395,3028,8862,2243,3527,1945,1147,7137,1725
90020,16993,10011,3432,4987,1385,207,3688,2709,1755,1859,6982,3232,2273,1097,380,5662,1320
90021,1251,223,95,107,21,0,55,86,29,53,1028,258,549,189,32,890,138
90022,17077,14326,4105,6552,2725,944,6081,3011,2753,2481,2751,468,678,890,715,2210,541
90023,10826,9431,3059,4094,1846,432,4133,1860,1950,1488,1395,262,400,413,320,1074,321
90024,16763,5840,1333,2146,1635,726,1487,3346,284,723,10923,6304,2286,1157,1176,7317,3606
90025,21243,8002,2352,3600,1313,737,2207,3639,761,1395,13241,6537,3891,1807,1006,9702,3539
90026,24500,15207,4591,7033,2727,856,5599,3698,3138,2772,9293,3007,3911,1678,697,6729,2564
90027,22251,10311,2413,4930,2135,833,3378,4047,1196,1690,11940,4597,3923,2211,1209,9541,2399
90028,14975,5362,1948,2457,719,238,1761,1591,1032,978,9613,4558,2745,1462,848,7807,1806
90029,13460,9094,2936,4440,1315,403,3711,2084,1831,1468,4366,1432,1705,774,455,3246,1120
90031,10266,8347,2099,3972,1708,568,3398,1989,1478,1482,1919,432,564,572,351,1498,421
90032,12624,10350,2816,4550,2341,643,3891,2966,1785,1708,2274,579,672,609,414,1763,511
90033,12377,9816,3433,4248,1696,439,4164,1785,2219,1648,2561,379,652,1030,500,2092,469
90034,25769,12274,4127,6074,1594,479,4257,3979,2097,1941,13495,6579,4262,1910,744,9859,3636
90035,12909,6262,1197,3094,1263,708,1966,2458,730,1108,6647,2435,1982,1087,1143,5139,1508
90036,17204,6060,1574,2813,1104,569,1965,2664,550,881,11144,5562,3314,1161,1107,8252,2892
90037,15071,11529,4188,5197,1651,493,4581,1734,3133,2081,3542,503,1199,1129,711,2951,591
90038,12106,6752,2527,3128,907,190,2653,1653,1373,1073,5354,2104,1898,935,417,4037,1317
90039,11285,6214,1492,3070,1274,378,2277,2191,880,866,5071,1308,2106,1122,535,3664,1407
90040,2686,2199,493,1001,517,188,880,683,359,277,487,39,52,210,186,444,43
90041,9371,6424,1203,3307,1565,349,2286,2371,858,909,2947,586,879,946,536,2351,596
90042,19629,14313,4277,6919,2639,478,5724,3579,2867,2143,5316,1507,1798,1424,587,4123,1193
90043,15754,10985,2110,5079,3020,776,2838,3000,2657,2490,4769,658,1488,1822,801,4176,593
90044,24570,18742,6171,8822,3243,506,6404,3093,6007,3238,5828,692,1947,2228,961,4904,924
90045,15546,9446,1903,4707,2033,803,3202,3817,1358,1069,6100,1963,2342,1035,760,4615,1485
90046,28791,8979,1809,3768,2240,1162,2227,4573,848,1331,19812,8456,7146,2721,1489,15011,4801
90047,15619,11525,2221,5184,3288,832,2802,3042,2805,2876,4094,422,1382,1671,619,3581,513
90048,11887,3999,877,1687,857,578,943,2032,300,724,7888,3060,2560,1130,1138,6113,1775
90049,16581,7837,1065,3174,2645,953,2383,4223,448,783,8744,3639,2585,1395,1125,6573,2171
90056,3433,2265,159,1060,754,292,653,1027,281,304,1168,189,402,400,177,1021,147
90057,14874,9228,3878,4119,911,320,3079,2132,2335,1682,5646,1986,2036,991,633,4317,1329
90058,950,680,271,306,95,8,259,89,256,76,270,23,119,97,31,224,46
90059,9277,7686,2383,3717,1217,369,2627,1048,2576,1435,1591,124,617,489,361,1353,238
90061,6291,5121,1422,2364,1037,298,1753,845,1381,1142,1170,95,359,502,214,1025,145
90062,8789,6363,1482,2965,1460,456,1997,1247,1626,1493,2426,206,819,869,532,2124,302
90063,12993,10984,3273,4900,2145,666,4851,2433,1931,1769,2009,301,471,678,559,1669,340
90064,10834,5875,992,2818,1448,617,1969,2580,567,759,4959,1714,1549,904,792,3754,1205
90065,14313,10428,2674,4737,2517,500,4025,3257,1623,1523,3885,823,1300,1201,561,2836,1049
90066,23321,13016,3266,6067,2657,1026,4336,5106,1558,2016,10305,3681,3929,1753,942,7801,2504
90067,1553,744,18,168,285,273,96,559,29,60,809,80,170,258,301,754,55
90068,12301,3887,670,2076,845,296,1055,2037,291,504,8414,3247,3359,1269,539,6268,2146
90069,13559,2764,554,1199,689,322,537,1603,161,463,10795,3207,4897,1755,936,8316,2479
90071,0,0,0,0,0,0,0,0,0,0,0,0,0,0,0,0,0
90077,4165,2910,136,1400,1039,335,1069,1531,148,162,1255,123,502,384,246,958,297
90201,23937,21289,7706,10551,2522,510,10988,3263,4591,2447,2648,504,772,896,476,2050,598
90210,8690,5773,376,2412,2165,820,2006,3050,223,494,2917,552,800,673,892,2401,516
90211,3755,2066,259,1112,452,243,801,772,251,242,1689,570,565,266,288,1422,267
90212,5697,2616,268,1371,732,245,880,1167,369,200,3081,1168,1002,473,438,2644,437
90220,12408,10047,2376,4646,2435,590,3424,2264,2188,2171,2361,249,658,1002,452,1890,471
90221,11147,9739,2777,4809,1943,210,4205,1948,2168,1418,1408,231,605,415,157,1118,290
90222,7126,5883,1500,2739,1245,399,2151,1187,1412,1133,1243,157,240,493,353,1060,183
90230,12944,7661,1330,3846,1866,619,2620,2878,1057,1106,5283,1108,2124,1374,677,4289,994
90232,6435,3696,816,1845,806,229,1178,1445,512,561,2739,831,1054,591,263,2211,528
90240,7895,6315,1016,3233,1459,607,2415,2365,763,772,1580,235,457,440,448,1335,245
90241,13457,9802,2812,4291,1916,783,3610,3146,1640,1406,3655,773,997,962,923,3060,595
90242,12693,10034,2678,5050,1780,526,4089,2807,1813,1325,2659,589,834,645,591,2086,573
90245,7053,3936,721,2207,725,283,1548,1408,512,468,3117,984,1222,697,214,2460,657
90247,16082,11199,3183,4934,2338,744,3901,3592,1994,1712,4883,881,1711,1667,624,4078,805
90248,3445,2530,452,1148,778,152,910,948,299,373,915,154,193,332,236,761,154
90249,8782,6463,1476,3029,1616,342,2186,2113,1073,1091,2319,499,930,660,230,1894,425
90250,31546,22168,7584,10515,3289,780,8321,4869,5675,3303,9378,2838,3977,1837,726,7539,1839
90254,9489,3666,830,1853,869,114,1098,1890,284,394,5823,2926,2028,629,240,3722,2101
90255,18572,16038,5359,8014,2255,410,7900,3101,2931,2106,2534,572,644,849,469,1987,547
90260,10040,7569,2215,3891,1215,248,3080,1741,1438,1310,2471,668,987,585,231,1781,690
90261,0,0,0,0,0,0,0,0,0,0,0,0,0,0,0,0,0
90262,14452,13058,3956,7001,1845,256,6729,2251,2531,1547,1394,193,589,398,214,1092,302
90263,0,0,0,0,0,0,0,0,0,0,0,0,0,0,0,0,0
90265,7329,4697,251,2464,1503,479,1546,2498,354,299,2632,611,1057,684,280,1899,733
90266,14443,8449,978,4781,2210,480,3652,3694,566,537,5994,2397,1969,1048,580,4229,1765
90270,6482,5803,2087,2971,667,78,3134,952,1085,632,679,179,203,207,90,475,204
90272,9272,6453,322,3336,2063,732,2514,3112,410,417,2819,362,950,864,643,2361,458
90274,9307,7617,323,3441,2885,968,2702,4251,304,360,1690,90,512,676,412,1487,203
90275,15412,12305,593,5834,4700,1178,4403,6505,598,799,3107,229,1042,1187,649,2612,495
90277,17062,8023,1412,4178,1909,524,2365,4143,667,848,9039,2889,3860,1559,731,6715,2324
90278,15446,9438,1888,5470,1714,366,3273,3732,1108,1325,6008,1904,2425,1231,448,4101,1907
90280,23121,20223,6109,10395,3090,629,10377,4088,3357,2401,2898,475,831,913,679,2338,560
90290,2217,1319,179,846,242,52,613,530,105,71,898,101,503,233,61,588,310
90291,15518,5602,1289,2984,989,340,1600,2351,871,780,9916,4571,3809,1043,493,7236,2680
90292,10830,3702,737,1509,1087,369,502,2660,292,248,7128,2106,3022,1505,495,5628,1500
90293,6171,2368,524,1019,649,176,517,1314,207,330,3803,1414,1641,561,187,2813,990
90301,12013,8244,2776,4098,1161,209,3344,1404,2075,1421,3769,808,1461,1009,491,3242,527
90302,11094,7377,2303,4007,929,138,2284,1316,2523,1254,3717,917,1592,916,292,3178,539
90303,7564,6128,1835,3024,1205,64,2464,1276,1405,983,1436,269,541,510,116,1190,246
90304,6431,5499,1782,2984,637,96,2997,773,1187,542,932,203,313,293,123,677,255
90305,5607,3692,589,1638,1213,252,813,1317,799,763,1915,144,735,719,317,1732,183
90401,3117,647,214,236,127,70,110,327,106,104,2470,907,799,424,340,2121,349
90402,4931,2984,191,1494,953,346,1168,1432,207,177,1947,322,754,451,420,1690,257
90403,13905,4716,909,2222,1068,517,1254,2328,554,580,9189,2828,3725,1688,948,7768,1421
90404,9193,3809,921,1948,708,232,1064,1331,713,701,5384,1891,2065,928,500,4177,1207
90405,14305,5326,1012,2843,1149,322,1752,2359,610,605,8979,2891,3834,1452,802,7364,1615
90501,13833,9647,2502,4983,1842,320,3988,2900,1552,1207,4186,1107,1555,1054,470,3310,876
90502,5572,3929,691,2081,1013,144,1458,1404,423,644,1643,240,668,569,166,1318,325
90503,16771,10974,1551,5970,2779,674,4258,4554,994,1168,5797,1550,1940,1355,952,4767,1030
90504,11672,8469,1342,4297,2245,585,2982,3343,1030,1114,3203,730,1076,853,544,2653,550
90505,13802,9432,1072,5118,2440,802,3659,4116,798,859,4370,945,1463,1132,830,3707,663
90601,11266,8069,1759,3961,1846,503,2706,3122,1172,1069,3197,680,1127,683,707,2602,595
90602,8155,5883,1915,2758,921,289,2366,1604,1215,698,2272,610,730,493,439,1807,465
90603,6732,5242,740,2605,1255,642,1901,2213,480,648,1490,119,413,446,512,1307,183
90604,11778,9419,2148,4638,2150,483,3828,3386,1215,990,2359,425,794,667,473,1864,495
90605,10161,8558,1873,4360,1798,527,3804,2600,1165,989,1603,188,507,491,417,1288,315
90606,8434,6946,1585,3220,1676,465,2983,2050,834,1079,1488,231,397,512,348,1235,253
90620,13229,10879,1629,5786,2805,659,4180,3996,1190,1513,2350,458,802,709,381,1723,627
90621,10023,7799,2433,3691,1304,371,3166,2209,1466,958,2224,556,883,594,191,1637,587
90623,4979,4262,478,2165,1493,126,1550,1998,351,363,717,156,188,293,80,557,160
90630,16090,12700,1892,6944,3335,529,4985,4903,1398,1414,3390,584,1099,1070,637,2810,580
90631,21654,16271,3696,7755,3743,1077,6275,6123,2051,1822,5383,1011,1749,1470,1153,4303,1080
90638,14796,11808,1723,5977,3275,833,4795,4876,773,1364,2988,362,641,1033,952,2514,474
90640,18979,14953,3629,6485,3701,1138,5077,4778,2598,2500,4026,624,1218,1287,897,3246,780
90650,26917,22603,5543,10960,4829,1271,9867,6772,2878,3086,4314,604,1345,1482,883,3474,840
90660,16443,14006,2768,6451,3899,888,5442,4396,1834,2334,2437,283,436,1006,712,2101,336
90670,4552,3549,592,1655,915,387,1348,1253,422,526,1003,68,225,442,268,863,140
90680,8470,6100,1741,2840,1210,309,2664,1769,881,786,2370,369,752,713,536,1875,495
90701,4468,3619,639,1796,950,234,1467,1266,371,515,849,127,251,278,193,663,186
90703,15355,13608,1018,7431,4657,502,5637,5693,766,1512,1747,241,632,651,223,1364,383
90704,1271,785,184,432,138,31,347,228,152,58,486,93,155,161,77,402,84
90706,23394,17270,4977,8667,2783,843,6834,4749,3515,2172,6124,1074,2396,1636,1018,4885,1239
90710,8379,6070,1562,2759,1409,340,2242,2134,1010,684,2309,510,775,716,308,1875,434
90712,10658,8070,1292,4269,1776,733,3097,2899,956,1118,2588,439,805,690,654,2159,429
90713,9635,7460,1090,3991,1605,774,2970,2885,711,894,2175,211,922,596,446,1721,454
90715,6161,5045,1195,2624,1075,151,2095,1474,631,845,1116,213,498,352,53,841,275
90716,3633,3011,902,1440,534,135,1350,603,609,449,622,85,198,254,85,496,126
90717,8376,5308,1315,2656,1000,337,1896,1747,946,719,3068,652,1232,748,436,2559,509
90720,7655,5870,737,3027,1624,482,2137,2384,728,621,1785,271,554,567,393,1455,330
90723,13964,11356,3920,5605,1557,274,5574,1709,2525,1548,2608,530,907,751,420,2050,558
90731,21404,13567,3888,6367,2652,660,4626,4168,2999,1774,7837,1789,3135,1779,1134,6461,1376
90732,8737,5835,754,2694,1863,524,1899,2910,376,650,2902,392,1083,820,607,2456,446
90740,13050,5991,584,2271,1892,1244,1487,3551,447,506,7059,677,1024,2030,3328,6302,757
90742,595,234,43,95,83,13,28,160,22,24,361,87,155,90,29,227,134
90743,56,44,6,22,10,6,16,22,0,6,12,0,0,0,12,12,0
90744,14017,11461,3830,5382,1741,508,5321,2343,2226,1571,2556,658,706,864,328,1926,630
90745,14694,12163,1886,6271,3366,640,4770,4269,1418,1706,2531,267,799,1002,463,1961,570
90746,7586,6166,492,2871,2519,284,1838,2425,577,1326,1420,131,493,640,156,1182,238
90802,18873,6999,2904,2968,870,257,1952,1768,2068,1211,11874,3799,5051,2115,909,9714,2160
90803,17628,6706,1247,3041,1877,541,1424,4023,596,663,10922,3848,4436,1841,797,8315,2607
90804,15369,8914,3585,4161,919,249,3136,1638,2704,1436,6455,2573,2849,809,224,4415,2040
90805,26284,20347,6888,9929,2863,667,8173,3950,5547,2677,5937,1153,2401,1622,761,4740,1197
90806,14641,10715,3530,5226,1653,306,4164,2134,2823,1594,3926,887,1682,896,461,2988,938
90807,12762,7676,1723,3995,1430,528,2652,2739,1299,986,5086,1118,1915,1073,980,4082,1004
90808,14098,10170,1427,5094,2596,1053,3629,4492,839,1210,3928,590,1413,962,963,3082,846
90810,9144,7586,1666,3849,1686,385,2997,1990,1494,1105,1558,120,330,636,472,1343,215
90813,16455,12595,5324,5839,1155,277,5145,1538,4237,1675,3860,924,1373,1139,424,2994,866
90814,9441,3982,1396,1780,579,227,1107,1553,793,529,5459,1852,2435,759,413,4147,1312
90815,15127,9540,1571,4620,2199,1150,3144,4351,825,1220,5587,1474,1736,1332,1045,4013,1574
90822,0,0,0,0,0,0,0,0,0,0,0,0,0,0,0,0,0
91001,12410,9129,1155,4853,2345,776,3170,3372,1261,1326,3281,487,1456,852,486,2582,699
91006,10457,8149,693,4515,2214,727,3293,3338,667,851,2308,451,512,765,580,1972,336
91007,11330,8019,997,4280,2005,737,2919,3070,857,1173,3311,613,948,845,905,2870,441
91010,8159,6107,1175,3179,1401,352,2534,2069,763,741,2052,184,620,755,493,1736,316
91011,6936,5847,247,3378,1744,478,2717,2443,394,293,1089,65,173,447,404,962,127
91016,14661,10102,2445,5121,1853,683,3692,3378,1706,1326,4559,750,1850,1206,753,3680,879
91020,3097,1685,433,826,315,111,565,616,253,251,1412,323,626,257,206,1200,212
91024,4745,2714,367,1295,772,280,920,1342,159,293,2031,298,1001,510,222,1680,351
91030,10342,5921,989,3147,1455,330,2311,2239,761,610,4421,1440,1579,894,508,3626,795
91040,7068,4689,719,2609,1043,318,1830,1944,415,500,2379,352,980,677,370,1811,568
91042,9723,6611,1444,3599,1266,302,2492,2413,952,754,3112,575,1413,795,329,2451,661
91101,8679,3018,1104,1389,373,152,841,1233,443,501,5661,2460,1707,795,699,4723,938
91103,8113,5794,1410,2907,1151,326,2083,1497,1317,897,2319,413,757,677,472,1815,504
91104,12780,8917,1997,4610,1776,534,3520,3021,1168,1208,3863,788,1632,818,625,3093,770
91105,4667,2702,270,1066,925,441,692,1654,101,255,1965,240,680,607,438,1577,388
91106,10544,5072,1509,2199,1139,225,1620,2103,548,801,5472,2368,1924,718,462,4080,1392
91107,12643,8164,1507,3895,2046,716,2833,3608,657,1066,4479,1144,1679,922,734,3618,861
91108,4392,3789,261,2129,1044,355,1736,1576,204,273,603,55,130,188,230,523,80
91201,8237,6101,1047,3278,1449,327,2581,2114,538,868,2136,666,684,441,345,1716,420
91202,8763,5869,988,2895,1331,655,2168,2452,425,824,2894,649,1002,704,539,2485,409
91203,5390,3553,636,1957,722,238,1376,1219,371,587,1837,551,584,462,240,1530,307
91204,5495,3944,960,2009,832,143,1500,1227,528,689,1551,466,492,395,198,1183,368
91205,14057,9826,2161,5132,2051,482,4052,2929,1255,1590,4231,937,1393,1145,756,3522,709
91206,12829,8210,1415,4090,1955,750,2708,3564,681,1257,4619,1028,1563,1305,723,3879,740
91207,3979,2800,313,1371,772,344,935,1469,73,323,1179,185,401,397,196,1026,153
91208,6586,4672,545,2371,1358,398,1847,2185,223,417,1914,257,694,505,458,1636,278
91214,10347,8136,738,5016,1867,515,3736,2964,779,657,2211,297,745,667,502,1976,235
91301,8358,6827,593,4374,1653,207,3388,2366,629,444,1531,331,607,488,105,1100,431
91302,8561,6524,660,3893,1744,227,3020,2444,679,381,2037,757,724,383,173,1448,589
91303,7406,4885,1914,2201,603,167,1891,1272,943,779,2521,1105,863,456,97,1874,647
91304,16741,12072,2917,5967,2683,505,4944,3996,1785,1347,4669,1284,1814,1146,425,3395,1274
91306,13711,10407,2401,5511,2016,479,4463,3343,1202,1399,3304,718,1398,798,390,2424,880
91307,8063,6572,629,3592,1910,441,2651,2836,460,625,1491,154,533,616,188,1116,375
91311,13159,9221,1302,4805,2645,469,3199,4155,943,924,3938,732,1555,1223,428,3063,875
91316,12792,7241,1160,3310,1940,831,2193,3384,682,982,5551,1570,1750,1245,986,4563,988
91320,12989,10245,1642,5819,2369,415,4624,4281,697,643,2744,508,980,836,420,2121,623
91321,10272,6930,1766,3578,1146,440,2869,2304,829,928,3342,690,875,889,888,2679,663
91324,8801,6230,1243,3019,1583,385,2348,2342,722,818,2571,779,769,568,455,1897,674
91325,11339,7186,1454,3540,1660,532,2582,2838,882,884,4153,2015,1141,727,270,2770,1383
91326,9719,8065,847,4205,2593,420,3321,3763,444,537,1654,336,552,579,187,1328,326
91331,21403,18803,4338,9728,3951,786,8703,4486,3088,2526,2600,343,740,951,566,2031,569
91335,21887,15630,3740,8194,2863,833,6419,4651,2257,2303,6257,1379,2349,1494,1035,4836,1421
91340,7799,6678,1686,3401,1287,304,3347,1403,915,1013,1121,151,292,344,334,866,255
91342,21427,17166,3996,9158,3358,654,7529,5167,2452,2018,4261,546,1678,1415,622,3196,1065
91343,16338,13091,3652,6536,2273,630,5577,3770,2191,1553,3247,644,1093,951,559,2404,843
91344,16258,12738,1977,6414,3501,846,4876,5404,1128,1330,3520,570,1472,932,546,2639,881
91345,5095,3872,791,1850,930,301,1601,1276,418,577,1223,170,383,405,265,945,278
91350,12762,10587,1639,6859,1837,252,5450,3646,983,508,2175,344,968,639,224,1734,441
91351,19728,15015,3689,8605,2380,341,7122,4397,2247,1249,4713,1338,2133,992,250,3249,1464
91352,11839,9753,2299,5027,1983,444,4539,2543,1426,1245,2086,316,820,555,395,1548,538
91354,5765,4821,979,3187,624,31,2866,1490,303,162,944,203,491,204,46,706,238
91355,9589,6626,973,3923,1500,230,2814,2722,647,443,2963,560,1226,671,506,2396,567
91356,11003,7148,1144,3539,1931,534,2484,2912,874,878,3855,858,1477,986,534,3104,751
91360,14491,10805,1279,5939,2992,595,4479,4515,937,874,3686,677,1087,996,926,2888,798
91361,7734,5565,413,2637,1970,545,1919,2849,372,425,2169,291,734,704,440,1770,399
91362,12188,9252,1307,5205,2266,474,4144,3713,780,615,2936,550,1341,790,255,2357,579
91364,10354,7086,862,3771,1925,528,2505,3394,561,626,3268,773,1371,728,396,2363,905
91367,15768,9530,1392,4450,2814,874,3045,4592,953,940,6238,1636,2081,1584,937,5022,1216
91377,5198,4020,547,2791,545,137,2189,1141,499,191,1178,318,450,322,88,947,231
91381,3542,2750,684,1743,301,22,1585,928,141,96,792,332,324,114,22,547,245
91384,4644,3782,755,2480,488,59,2080,1140,347,215,862,206,463,185,8,582,280
91401,14549,9652,2984,4580,1544,544,3755,2868,1623,1406,4897,1431,1963,987,516,3720,1177
91402,17571,14207,5085,7056,1611,455,6888,2678,2833,1808,3364,791,1208,875,490,2539,825
91403,11122,5271,1062,2496,1179,534,1428,2497,610,736,5851,2113,2144,1009,585,4512,1339
91405,16364,11414,4135,5537,1336,406,4764,2665,2342,1643,4950,1249,2079,924,698,3801,1149
91406,17166,11646,3855,5489,1571,731,4774,3172,2135,1565,5520,1391,2387,1118,624,4216,1304
91411,8646,5266,1803,2588,650,225,2051,1457,1033,725,3380,1148,1372,576,284,2605,775
91423,14817,6874,1332,3489,1441,612,2097,3077,941,759,7943,2631,2977,1350,985,6124,1819
91436,5184,3942,292,1836,1329,485,1227,2109,281,325,1242,158,362,442,280,988,254
91501,7478,4671,925,2573,952,221,1780,1676,557,658,2807,821,959,664,363,2273,534
91502,4823,2620,809,1374,335,102,1031,762,507,320,2203,610,526,578,489,1905,298
91504,9601,6643,1146,3376,1593,528,2485,2835,800,523,2958,822,1043,661,432,2317,641
91505,13135,6873,1259,3605,1402,607,2269,2799,882,923,6262,1970,2351,1047,894,4973,1289
91506,7678,4392,714,2304,1013,361,1523,1749,553,567,3286,704,1251,798,533,2772,514
91601,14656,7641,2698,3810,940,193,2863,2041,1504,1233,7015,2632,2597,1183,603,5226,1789
91602,9134,3391,716,1961,502,212,943,1459,471,518,5743,2016,2412,1039,276,4428,1315
91604,13745,5934,1221,2829,1355,529,1866,2897,626,545,7811,2677,3100,1284,750,6111,1700
91605,15203,12176,3344,6360,1999,473,6015,2699,1902,1560,3027,684,1042,882,419,2297,730
91606,14841,10081,3179,4859,1529,514,4348,2566,1832,1335,4760,1304,1737,1093,626,3625,1135
91607,12909,6389,1575,3204,1129,481,2131,2561,887,810,6520,2178,2438,1122,782,5114,1406
91608,0,0,0,0,0,0,0,0,0,0,0,0,0,0,0,0,0
91701,12627,10272,1582,6308,2044,338,4738,3760,910,864,2355,436,802,756,361,1899,456
91702,15212,11833,3461,5557,2275,540,5067,3015,1999,1752,3379,816,1208,839,516,2519,860
91706,17280,15396,3814,8231,2790,561,7307,3526,2418,2145,1884,339,509,613,423,1409,475
91709,19975,17003,3328,11297,2241,137,9446,5263,1333,961,2972,826,1390,595,161,2155,817
91710,19039,15682,3066,9026,3137,453,7170,5138,1832,1542,3357,699,1032,971,655,2656,701
91711,11438,7968,875,3969,2360,764,2769,3628,769,802,3470,582,1063,1033,792,2802,668
91719,132,49,0,11,28,10,0,49,0,0,83,0,32,39,12,83,0
91722,10287,8096,1609,4359,1694,434,3154,2499,1302,1141,2191,398,876,585,332,1671,520
91723,6239,4409,1198,2359,656,196,1532,1219,998,660,1830,434,584,550,262,1522,308
91724,8266,6402,1235,3138,1604,425,2366,2365,892,779,1864,363,681,548,272,1443,421
91730,16842,12333,3486,6786,1692,369,4873,3531,2347,1582,4509,1439,1876,881,313,3474,1035
91731,7558,6217,1951,2790,1135,341,2550,1489,1178,1000,1341,271,343,442,285,1059,282
91732,14489,12480,3353,6500,2208,419,5647,2734,2116,1983,2009,341,631,677,360,1482,527
91733,9856,8776,2490,4485,1529,272,4000,1914,1562,1300,1080,203,325,416,136,732,348
91737,7452,6159,888,4186,958,127,2834,2174,792,359,1293,333,521,283,156,1043,250
91739,3945,3310,777,2040,456,37,1662,1025,435,188,635,133,352,102,48,490,145
91740,8239,6237,1102,3565,1302,268,2489,2169,814,765,2002,245,724,697,336,1598,404
91741,8922,6922,818,3560,2012,532,2649,3066,660,547,2000,297,570,650,483,1690,310
91743,0,0,0,0,0,0,0,0,0,0,0,0,0,0,0,0,0
91744,18495,16576,3338,8708,3881,649,7635,4386,2063,2492,1919,245,728,608,338,1387,532
91745,16081,13699,1660,6848,4322,869,5027,5763,1110,1799,2382,299,815,860,408,2007,375
91746,6846,5976,1133,2911,1582,350,2677,1847,623,829,870,134,194,353,189,724,146
91748,13555,11613,1817,6596,2788,412,4671,4534,1033,1375,1942,576,534,584,248,1474,468
91750,12298,9132,1217,4925,2294,696,3528,3868,880,856,3166,585,872,921,788,2621,545
91752,5842,4310,839,2276,899,296,1690,1659,552,409,1532,57,386,662,427,1329,203
91754,11279,8692,1282,3848,2434,1128,2569,3679,990,1454,2587,440,719,665,763,2121,466
91755,8353,6735,1057,3126,1919,633,2086,2824,689,1136,1618,214,537,451,416,1257,361
91759,18,11,0,3,8,0,0,11,0,0,7,3,2,2,0,4,3
91761,14864,12575,3223,7044,1983,325,6303,3210,1675,1387,2289,640,815,566,268,1684,605
91762,15763,12298,3684,6051,2097,466,5225,3414,2245,1414,3465,624,1292,918,631,2747,718
91763,9271,7474,2032,3711,1384,347,3406,2053,1085,930,1797,275,643,545,334,1457,340
91764,13298,10489,3295,5306,1570,318,4675,2562,1965,1287,2809,738,1096,677,298,2161,648
91765,14703,12361,1653,7531,2850,327,5556,4485,980,1340,2342,560,976,575,231,1894,448
91766,17019,14328,4188,7564,2329,247,7370,3334,2219,1405,2691,584,1069,726,312,1865,826
91767,13049,9751,2704,4967,1674,406,4153,2323,1869,1406,3298,646,911,979,762,2571,727
91768,8494,6624,1967,3303,1193,161,2961,1616,1263,784,1870,570,561,472,267,1259,611
91770,16126,13632,2762,7026,3017,827,5430,4143,1675,2384,2494,356,775,758,605,1995,499
91773,11944,8972,1307,4852,2370,443,3431,3706,935,900,2972,467,993,1019,493,2398,574
91775,8353,6224,972,3274,1511,467,2210,2635,657,722,2129,501,679,505,444,1716,413
91776,11639,8964,2045,4510,1799,610,3282,2941,1183,1558,2675,751,903,542,479,2085,590
91780,11257,8507,1255,4725,1891,636,3259,3133,998,1117,2750,496,995,795,464,2305,445
91784,8022,6807,506,3843,2111,347,2718,3379,341,369,1215,100,428,419,268,959,256
91786,17874,12241,3359,5683,2520,679,4363,4111,2285,1482,5633,1641,1852,1379,761,4370,1263
91789,12923,11425,987,7504,2675,259,5432,4091,800,1102,1498,338,606,422,132,1144,354
91790,12744,10317,2017,5304,2334,662,4353,3333,1241,1390,2427,375,810,711,531,1861,566
91791,9912,7722,1307,3812,2003,600,2913,3053,783,973,2190,309,596,683,602,1746,444
91792,8889,7505,1638,4112,1597,158,3099,2408,922,1076,1384,464,530,260,130,957,427
91801,19357,13368,3098,6563,2700,1007,4697,4611,1650,2410,5989,1939,1908,1210,932,4781,1208
91803,9729,7464,1670,3602,1683,509,2518,2715,1003,1228,2265,544,695,554,472,1785,480
91901,5681,4386,735,2392,1083,176,1625,1972,524,265,1295,137,582,357,219,966,329
91902,5745,4685,506,2541,1385,253,1706,2246,387,346,1060,126,342,435,157,808,252
91905,520,339,27,170,126,16,83,170,64,22,181,48,29,80,24,151,30
91906,1066,785,120,419,190,56,248,325,110,102,281,7,129,132,13,200,81
91910,26314,18658,4508,9245,3584,1321,7187,6421,2906,2144,7656,1550,2366,2153,1587,6224,1432
91911,22465,17578,4013,8160,4060,1345,6360,6034,2885,2299,4887,971,1374,1570,972,3933,954
91913,4047,3435,668,2041,607,119,1722,1055,342,316,612,148,217,114,133,494,118
91914,911,793,344,429,6,14,485,235,36,37,118,52,39,27,0,76,42
91915,2686,2422,647,1460,315,0,1397,653,158,214,264,75,132,43,14,224,40
91916,653,466,34,248,163,21,157,279,6,24,187,6,93,65,23,129,58
91917,315,180,8,78,71,23,60,93,0,27,135,23,31,63,18,106,29
91931,257,191,34,114,38,5,66,73,27,25,66,7,40,13,6,57,9
91932,9173,6498,2070,2968,1143,317,2218,1991,1481,808,2675,921,1045,502,207,1975,700
91934,267,154,47,58,32,17,42,58,38,16,113,8,44,24,37,96,17
91935,2886,2435,168,1535,635,97,1011,1128,150,146,451,45,190,115,101,310,141
91941,18600,11535,2468,5263,2588,1216,3735,5032,1507,1261,7065,1757,2468,1618,1222,5403,1662
91942,10852,5807,1201,2646,1350,610,1777,2449,781,800,5045,1428,1345,984,1288,3924,1121
91945,8558,6042,1275,3166,1083,518,2069,2046,1185,742,2516,404,1084,582,446,1903,613
91948,48,29,0,13,16,0,7,22,0,0,19,0,0,19,0,19,0
91950,15401,12092,3049,5689,2465,889,4485,3364,2407,1836,3309,496,985,1041,787,2671,638
91962,610,465,47,274,103,41,181,250,18,16,145,11,91,37,6,130,15
91963,279,221,41,104,63,13,112,64,20,25,58,0,23,27,8,39,19
91977,17890,14044,3320,7089,2941,694,5178,4819,2429,1618,3846,666,1455,1160,565,2825,1021
91978,2864,2064,438,1014,444,168,718,789,284,273,800,178,259,235,128,612,188
91980,34,26,7,5,10,4,12,14,0,0,8,0,0,8,0,8,0
92003,1465,1113,177,497,337,102,376,535,86,116,352,66,99,121,66,240,112
92004,1278,807,132,235,313,127,182,514,70,41,471,47,133,204,87,376,95
92007,4384,2455,452,1400,487,116,800,1055,284,316,1929,681,855,313,80,1182,747
92008,14357,8916,1337,4604,2079,896,2904,4065,888,1059,5441,1580,1902,1080,879,4008,1433
92009,17180,12181,1694,6913,2694,880,4745,5324,1227,885,4999,929,2031,1416,623,3796,1203
92014,6178,3875,299,1938,1405,233,1283,2036,250,306,2303,467,961,707,168,1687,616
92019,14364,11154,1786,6220,2603,545,4263,4440,1484,967,3210,556,1073,1066,515,2505,705
92020,19990,13816,3906,6412,2587,911,4827,4861,2689,1439,6174,1578,1968,1667,961,4637,1537
92021,22149,15580,4121,7437,3268,754,5640,5596,2584,1760,6569,1579,1995,1901,1094,4996,1573
92024,18455,11750,1726,6900,2458,666,4785,4916,1158,891,6705,1682,2875,1254,894,4715,1990
92025,14851,10726,3241,5180,1785,520,4737,3430,1727,832,4125,781,1511,953,880,3073,1052
92026,16046,11379,2385,4996,2771,1227,3946,5449,1185,799,4667,745,1331,1106,1485,3839,828
92027,15680,11715,2529,6085,2363,738,4695,4157,1672,1191,3965,737,1065,1157,1006,3201,764
92028,14341,11155,2061,4933,3016,1145,4264,5232,842,817,3186,484,842,973,887,2512,674
92029,6543,4984,760,2554,1361,309,1750,2386,418,430,1559,219,623,423,294,1165,394
92036,1392,988,99,460,373,56,337,539,68,44,404,36,140,160,68,330,74
92037,17677,9500,1310,3745,3056,1389,2731,5340,619,810,8177,2703,2230,1914,1330,6173,2004
92040,14794,11084,2451,5741,2311,581,4496,4330,1321,937,3710,582,1551,942,635,2820,890
92054,27685,19868,8863,7618,2428,959,9362,6146,2838,1522,7817,2308,2719,1569,1221,5725,2092
92056,19558,14169,2580,7044,2956,1589,5285,6455,1540,889,5389,935,1256,1772,1426,4276,1113
92057,15544,11637,2480,5739,2312,1106,4924,4621,1256,836,3907,753,962,1037,1155,3011,896
92059,474,348,55,200,83,10,157,83,46,62,126,41,43,26,16,74,52
92060,85,59,3,31,19,6,13,29,14,3,26,0,15,4,7,14,12
92061,892,728,98,273,238,119,172,391,91,74,164,9,70,46,39,147,17
92064,15558,12974,1544,8084,2721,625,6026,4703,1373,872,2584,389,1005,697,493,1969,615
92065,10662,8797,1323,5150,1902,422,3798,3633,874,492,1865,386,749,388,342,1407,458
92066,118,81,3,43,29,6,39,31,7,4,37,0,22,0,15,37,0
92067,2543,2103,35,1041,776,251,852,1099,95,57,440,44,109,131,156,362,78
92069,17833,12776,3013,5705,2585,1473,5209,5220,1388,959,5057,648,1478,1395,1536,3975,1082
92070,494,319,51,108,130,30,64,171,51,33,175,15,64,63,33,150,25
92071,18776,14399,2856,7908,2852,783,5586,5456,2114,1243,4377,798,1677,1148,754,3437,940
92075,5374,3132,430,1453,867,382,908,1675,259,290,2242,626,678,578,360,1707,535
92078,2646,1937,420,856,440,221,799,877,88,173,709,79,143,310,177,599,110
92082,4677,3810,399,2114,1010,287,1562,1648,345,255,867,67,330,241,229,678,189
92083,19987,14638,4010,7264,2474,890,6166,4876,2281,1315,5349,1652,2117,1044,536,3786,1563
92084,14189,10562,2265,5158,2289,850,4050,4044,1510,958,3627,697,1273,862,795,2809,818
92086,536,360,9,118,170,63,78,256,19,7,176,23,35,43,75,141,35
92091,585,430,39,165,121,105,88,301,10,31,155,0,61,78,16,142,13
92101,11411,2254,640,787,568,259,300,1390,287,277,9157,2634,3519,2151,853,7933,1224
92102,14212,9497,3469,4072,1553,403,3545,1933,2506,1513,4715,1527,1968,806,414,3375,1340
92103,17599,4931,1136,2061,1104,630,1004,2851,433,643,12668,4256,4743,2150,1519,9592,3076
92104,21512,9584,3613,4289,1236,446,2946,2720,2471,1447,11928,4247,5042,1715,924,8467,3461
92105,21411,16192,6042,7322,2221,607,6444,3214,4372,2162,5219,1273,2111,1138,697,3816,1403
92106,6929,4190,427,1782,1301,680,1214,2351,257,368,2739,641,836,684,578,2091,648
92107,13953,5910,1583,2720,1000,607,1550,2771,967,622,8043,3576,2780,1027,660,5295,2748
92108,6579,2090,917,736,349,88,354,1090,330,316,4489,2274,1516,548,151,3079,1410
92109,23881,7709,2197,3151,1631,730,1921,3868,754,1166,16172,9346,4086,1761,979,9807,6365
92110,10734,4916,1406,1981,987,542,1480,2328,524,584,5818,1997,1591,1289,941,4201,1617
92111,17399,11020,2434,4970,2748,868,3637,4376,1392,1615,6379,1718,2264,1625,772,4616,1763
92113,11932,9809,3173,4662,1401,573,3840,1601,2752,1616,2123,301,743,753,326,1654,469
92114,17414,15004,2269,8341,3736,658,5786,4794,2230,2194,2410,269,803,938,400,1872,538
92115,20786,10936,3645,4586,1724,981,3662,3599,2084,1591,9850,4786,2632,1365,1067,5765,4085
92116,16394,6813,2512,3080,919,302,1739,2384,1592,1098,9581,3326,4303,1270,682,6891,2690
92117,20822,12926,2432,5804,3422,1268,3954,5996,1440,1536,7896,2325,2643,1785,1143,5492,2404
92118,7752,4958,710,2283,1362,603,1725,2381,499,353,2794,477,935,769,613,2369,425
92119,9111,6170,725,2670,2015,760,1801,3231,499,639,2941,576,915,913,537,2272,669
92120,10961,7212,900,2869,2522,921,2005,4046,486,675,3749,889,1108,1008,744,2746,1003
92121,1853,987,295,506,155,31,342,540,41,64,866,539,277,50,0,451,415
92122,16632,7837,1755,3452,2064,566,2296,4206,591,744,8795,4345,2161,1267,1022,5908,2887
92123,9292,6223,2055,2438,1392,338,2076,2533,826,788,3069,1050,1064,566,389,2040,1029
92124,10605,7579,2287,3937,1186,169,3946,2618,579,436,3026,983,1205,711,127,2135,891
92126,22722,16952,4123,9353,3156,320,7528,6479,1551,1394,5770,2347,2193,981,249,3728,2042
92127,6937,5257,958,3234,803,262,2681,1559,638,379,1680,417,588,301,374,1279,401
92128,18808,12415,1878,5786,2892,1859,4260,6338,928,889,6393,1116,1684,1637,1956,5528,865
92129,14898,12533,2096,8322,1855,260,6813,3859,1135,726,2365,576,1294,362,133,1739,626
92130,10557,7503,1158,5137,1020,188,3984,2391,858,270,3054,939,1451,527,137,2315,739
92131,10445,8229,1567,5214,1311,137,4138,3068,638,385,2216,599,1140,389,88,1586,630
92139,10462,8961,2278,4560,1826,297,3803,2900,1291,967,1501,410,563,330,198,1096,405
92154,16681,14430,2723,7612,3612,483,5834,4656,2232,1708,2251,520,618,685,428,1691,560
92173,7341,6445,1528,3334,1308,275,2636,1479,1498,832,896,148,254,304,190,725,171
92201,16607,13099,3769,6138,2608,584,5612,3872,2224,1391,3508,589,1025,1175,719,2857,651
92203,905,658,165,214,203,76,214,328,57,59,247,21,75,110,41,205,42
92210,1975,1303,11,263,719,310,129,1115,18,41,672,29,64,302,277,542,130
92211,9675,6353,653,1533,2893,1274,1087,4639,371,256,3322,353,758,1396,815,2699,623
92220,9487,6695,1217,2292,2139,1047,1669,3487,883,656,2792,197,511,1209,875,2436,356
92223,6428,4604,883,2008,1264,449,1527,1980,679,418,1824,300,458,648,418,1464,360
92225,5571,4065,996,1952,936,181,1632,1363,689,381,1506,150,527,561,268,1269,237
92227,7089,5662,1388,2735,1209,330,2412,1757,996,497,1427,169,466,465,327,1220,207
92230,797,563,95,299,139,30,196,222,87,58,234,77,40,85,32,172,62
92231,7028,6198,1074,3219,1478,427,2936,1461,896,905,830,35,155,340,300,714,116
92233,1089,916,199,442,204,71,377,300,143,96,173,19,62,47,45,150,23
92234,14267,9892,2481,4739,1894,778,4305,3246,1431,910,4375,437,1341,1763,834,3251,1124
92236,4812,4510,1294,2323,706,187,2473,851,784,402,302,50,67,124,61,244,58
92239,206,125,31,49,36,9,58,52,2,13,81,8,23,43,7,72,9
92240,8136,5341,1434,2444,1002,461,2021,1878,1052,390,2795,406,854,1086,449,2188,607
92241,2449,1466,219,596,439,212,334,852,165,115,983,21,215,445,302,775,208
92242,736,462,37,121,221,83,59,308,50,45,274,8,62,110,94,225,49
92243,12905,10212,2428,5167,2077,540,4469,2849,1808,1086,2693,415,912,890,476,2348,345
92249,856,797,192,371,197,37,386,213,84,114,59,1,13,30,15,52,7
92250,2340,1993,331,1054,441,167,974,635,213,171,347,41,76,139,91,322,25
92251,3034,2586,701,1378,437,70,1230,787,412,157,448,64,171,120,93,382,66
92252,3415,2018,403,809,512,294,537,880,319,282,1397,129,423,555,290,1151,246
92253,8461,6593,1308,3026,1812,447,2578,2994,663,358,1868,215,554,815,284,1422,446
92254,1770,1569,442,767,315,45,839,369,242,119,201,27,85,83,6,123,78
92256,1502,886,105,513,208,60,254,416,144,72,616,93,229,181,113,498,118
92257,1278,700,50,183,313,154,127,391,83,99,578,31,91,282,174,509,69
92258,202,120,18,84,12,6,39,31,28,22,82,28,14,19,21,51,31
92259,266,153,9,59,56,29,34,115,4,0,113,0,43,52,18,95,18
92260,13967,7862,1002,2572,2713,1575,1614,4698,824,726,6105,740,1520,2142,1703,5021,1084
92262,10932,5353,1138,2268,1408,539,1584,2316,810,643,5579,731,1953,1929,966,4261,1318
92264,9953,4444,530,1203,1771,940,752,2749,362,581,5509,507,1650,1965,1387,4356,1153
92266,152,90,8,58,24,0,26,37,19,8,62,5,0,34,23,62,0
92267,47,37,6,24,7,0,21,16,0,0,10,0,10,0,0,10,0
92268,122,73,0,46,27,0,37,36,0,0,49,0,9,23,17,35,14
92270,6315,3834,205,842,1690,1097,499,2820,181,334,2481,90,571,1011,809,2044,437
92273,420,375,97,196,66,16,190,97,59,29,45,6,13,20,6,35,10
92274,4018,3537,1093,1598,722,124,1881,876,451,329,481,58,177,155,91,388,93
92275,367,228,25,67,102,34,19,158,26,25,139,0,13,69,57,115,24
92276,2542,1711,229,541,615,326,483,971,144,113,831,30,151,410,240,690,141
92277,6747,4416,1668,1742,815,191,1656,1700,771,289,2331,583,781,597,370,1860,471
92278,1428,1392,1085,298,9,0,944,403,45,0,36,29,7,0,0,36,0
92280,11,11,11,0,0,0,4,0,7,0,0,0,0,0,0,0,0
92281,703,561,106,262,138,55,230,171,93,67,142,22,45,35,40,122,20
92282,353,240,0,103,124,13,20,164,15,41,113,30,28,40,15,107,6
92283,1266,861,179,356,253,73,227,309,186,139,405,24,105,193,83,346,59
92284,8551,5523,994,2281,1462,786,1595,2467,875,586,3028,251,762,1285,730,2551,477
92285,986,607,44,220,276,67,113,370,52,72,379,32,154,165,28,327,52
92301,4980,4076,1365,1913,692,106,1967,1020,703,386,904,202,315,325,62,725,179
92304,4,4,0,0,4,0,0,4,0,0,0,0,0,0,0,0,0
92305,78,53,18,29,6,0,16,31,0,6,25,0,14,7,4,25,0
92307,11160,8721,1566,4134,2339,682,2920,3947,1264,590,2439,328,738,957,416,1997,442
92308,9864,7504,1400,3491,2108,505,2714,2857,1228,705,2360,245,655,845,615,1930,430
92309,205,128,54,50,24,0,66,15,26,21,77,26,23,26,2,55,22
92310,2371,2273,1689,577,7,0,1654,486,127,6,98,66,32,0,0,87,11
92311,11166,8023,2154,3630,1869,370,2717,3016,1506,784,3143,669,1123,947,404,2624,519
92313,3898,2918,539,1639,599,141,1138,1178,315,287,980,245,386,257,92,795,185
92314,3909,2807,344,1458,837,168,871,1357,400,179,1102,112,415,422,153,897,205
92315,2320,1461,196,596,505,164,364,765,178,154,859,133,327,271,128,686,173
92316,6608,5634,1351,2946,1084,253,2565,1549,880,640,974,100,370,358,146,730,244
92317,673,545,82,309,136,18,260,218,45,22,128,26,63,39,0,105,23
92318,55,29,0,24,5,0,6,5,8,10,26,9,7,10,0,26,0
92320,3071,2107,285,900,565,357,629,1054,239,185,964,74,168,328,394,850,114
92321,198,148,9,89,37,13,33,36,54,25,50,0,40,10,0,29,21
92323,5,2,0,2,0,0,0,0,2,0,3,0,0,3,0,3,0
92324,16167,12221,3560,6167,1989,505,5053,3226,2507,1435,3946,1265,1401,839,441,3155,791
92325,4101,2840,491,1607,649,93,979,1305,401,155,1261,185,616,377,83,1004,257
92327,266,148,5,88,48,7,27,63,24,34,118,10,38,46,24,118,0
92328,189,103,13,74,16,0,18,56,29,0,86,12,50,24,0,78,8
92332,47,35,3,18,14,0,15,15,3,2,12,0,8,0,4,8,4
92333,219,148,14,41,83,10,14,116,14,4,71,8,31,15,17,56,15
92335,21418,17716,5746,8776,2560,634,8410,4042,3517,1747,3702,756,1122,1162,662,2895,807
92336,13961,12561,3485,7271,1533,272,7085,2944,1538,994,1400,250,715,333,102,935,465
92337,7831,6816,2208,3694,858,56,3924,1494,924,474,1015,284,550,110,71,735,280
92338,10,6,0,0,0,6,0,6,0,0,4,0,4,0,0,0,4
92339,447,274,67,176,31,0,100,102,72,0,173,24,124,18,7,150,23
92341,124,99,0,76,23,0,19,45,27,8,25,0,0,25,0,25,0
92342,1943,1545,176,587,632,150,465,974,76,30,398,24,92,181,101,323,75
92345,21933,17639,3536,9084,3938,1081,6852,6533,2677,1577,4294,479,1387,1591,837,3513,781
92346,15539,11880,2712,6177,2436,555,4639,3910,1978,1353,3659,561,1357,1156,585,3029,630
92347,693,458,56,239,140,23,187,182,29,60,235,5,103,88,39,184,51
92352,3504,2701,352,1368,854,127,991,1217,302,191,803,108,357,237,101,655,148
92354,6937,4290,1135,2060,695,400,1563,1648,535,544,2647,837,619,587,604,2077,570
92356,2093,1332,218,589,390,135,441,608,162,121,761,36,220,353,152,605,156
92358,461,270,27,164,57,22,67,163,36,4,191,3,96,69,23,156,35
92359,2572,1782,423,955,361,43,720,566,357,139,790,146,315,197,132,628,162
92363,2256,1437,241,594,462,140,342,580,300,215,819,75,242,309,193,687,132
92364,72,38,18,15,5,0,6,16,13,3,34,0,11,19,4,32,2
92365,1132,768,129,318,276,45,138,364,121,145,364,14,123,153,74,305,59
92368,283,196,48,85,54,9,60,69,45,22,87,11,35,34,7,72,15
92371,3917,3093,380,1660,879,174,1180,1343,303,267,824,99,334,298,93,628,196
92372,1505,1177,130,591,355,101,426,551,110,90,328,7,120,152,49,306,22
92373,13346,8281,1544,3982,2016,739,2682,3768,1103,728,5065,1475,1582,1009,999,4227,838
92374,12011,8895,1750,4827,1908,410,3323,3025,1528,1019,3116,674,995,821,626,2473,643
92376,20334,16873,4678,8883,2683,629,7075,4079,3678,2041,3461,529,1105,1193,634,2823,638
92377,5107,4493,1008,2539,877,69,2283,1298,546,366,614,48,280,162,124,502,112
92382,1964,1422,276,830,251,65,509,644,178,91,542,72,224,219,27,425,117
92384,42,42,3,19,17,3,8,26,0,8,0,0,0,0,0,0,0
92386,789,513,86,277,141,9,111,179,200,23,276,19,104,126,27,215,61
92389,95,26,3,10,8,5,5,18,3,0,69,0,5,35,29,60,9
92392,21131,16123,3666,7848,3360,1249,6143,5657,2801,1522,5008,762,1337,1873,1036,4069,939
92394,3765,2989,860,1418,594,117,1226,820,637,306,776,126,285,306,59,633,143
92397,1651,1216,161,692,329,34,497,558,99,62,435,74,151,125,85,346,89
92398,492,317,61,168,77,11,89,102,77,49,175,45,53,36,41,156,19
92399,15300,10777,2100,5268,2439,970,4192,4278,1342,965,4523,547,1135,1444,1397,3855,668
92401,707,339,168,130,41,0,119,42,124,54,368,62,105,141,60,339,29
92404,17304,12591,3840,5547,2457,747,4308,3794,3099,1390,4713,843,1535,1211,1124,3836,877
92405,7750,5590,1786,2615,883,306,2155,1397,1359,679,2160,317,940,530,373,1773,387
92407,14646,10790,3042,5624,1710,414,4465,2986,2252,1087,3856,1507,1394,738,217,2630,1226
92408,3635,2696,909,1247,402,138,1016,613,734,333,939,296,329,193,121,734,205
92410,11877,9358,3091,4541,1340,386,3442,1726,2830,1360,2519,418,930,744,427,2033,486
92411,6127,4966,1393,2150,999,424,1629,1113,1322,902,1161,71,306,538,246,991,170
92501,6267,3962,1137,2002,640,183,1461,1050,946,505,2305,542,877,463,423,1869,436
92503,21129,16564,4157,8565,3191,651,7593,4597,2586,1788,4565,843,1573,1331,818,3628,937
92504,15333,11001,2709,5098,2478,716,3945,3644,2037,1375,4332,738,1336,1138,1120,3518,814
92505,11573,8880,2287,4507,1748,338,3791,2719,1419,951,2693,730,927,652,384,2072,621
92506,15046,11337,1561,6158,2757,861,4101,4704,1400,1132,3709,696,1278,1032,703,2813,896
92507,16619,9771,3340,4225,1807,399,3549,2875,2027,1320,6848,3620,1793,960,475,4378,2470
92508,5054,4337,879,2692,639,127,2354,1410,389,184,717,202,255,165,95,521,196
92509,17320,14230,3205,7827,2662,536,6251,4403,2289,1287,3090,386,1220,1044,440,2285,805
92518,462,307,35,46,35,191,45,258,4,0,155,0,0,10,145,155,0
92530,12132,9276,2435,4871,1501,469,4158,2690,1467,961,2856,450,1162,804,440,2144,712
92532,1350,1177,188,681,265,43,512,507,89,69,173,16,90,47,20,142,31
92536,839,572,58,284,170,60,170,226,97,79,267,24,73,133,37,205,62
92539,1536,1026,140,492,290,104,276,550,139,61,510,8,165,264,73,426,84
92543,12357,7238,1725,2460,1637,1416,1889,3093,1412,844,5119,533,1049,1378,2159,4504,615
92544,14352,10354,1885,4362,2822,1285,3397,4793,1392,772,3998,445,958,1201,1394,3359,639
92545,11682,7314,983,1812,2520,1999,1546,4580,554,634,4368,424,496,1465,1983,3851,517
92548,1664,1091,139,410,306,236,191,582,209,109,573,50,117,193,213,503,70
92549,1665,1033,97,494,380,62,292,561,129,51,632,61,253,188,130,521,111
92551,5989,5377,1480,2993,739,165,2695,1345,955,382,612,84,328,149,51,482,130
92553,16381,13979,3959,7733,1908,379,6351,3178,2987,1463,2402,416,1036,751,199,1878,524
92555,3705,3189,476,1831,780,102,1462,1165,315,247,516,97,174,194,51,352,164
92557,13532,11396,2369,6747,1970,310,5378,3446,1558,1014,2136,459,947,543,187,1675,461
92561,623,396,20,153,179,44,142,215,10,29,227,12,149,58,8,189,38
92562,11960,9734,1567,5372,2305,490,4696,3777,802,459,2226,498,523,829,376,1842,384
92563,5837,4664,946,2398,947,373,2195,1838,379,252,1173,160,285,351,377,965,208
92567,2250,1859,282,930,562,85,745,735,227,152,391,36,208,115,32,280,111
92570,10425,8465,1832,4222,1885,526,3357,2521,1490,1097,1960,218,556,748,438,1563,397
92571,6838,5929,1990,2936,814,189,3080,1334,972,543,909,164,428,233,84,679,230
92582,1483,1128,187,569,235,137,472,362,156,138,355,27,73,117,138,299,56
92583,7491,5180,1202,2201,1228,549,1821,1912,840,607,2311,213,484,866,748,2024,287
92584,4645,3903,624,2134,861,284,1743,1651,323,186,742,121,279,260,82,546,196
92585,3186,2213,439,901,610,263,757,1042,215,199,973,110,184,408,271,850,123
92586,8931,5287,388,1110,2044,1745,953,3600,295,439,3644,54,150,1591,1849,3413,231
92587,4641,3717,497,1801,1079,340,1456,1715,332,214,924,127,374,251,172,724,200
92590,1042,751,192,331,207,21,261,308,153,29,291,61,112,49,69,246,45
92591,8225,6747,1531,3763,1114,339,3367,2226,806,348,1478,386,595,350,147,1094,384
92592,14467,12517,2562,7161,2326,468,6778,4087,1025,627,1950,409,924,486,131,1428,522
92595,6307,5048,675,2705,1203,465,2190,1991,378,489,1259,142,406,385,326,981,278
92596,1278,1083,177,588,300,18,510,359,131,83,195,49,68,64,14,152,43
92602,956,804,314,428,62,0,416,306,40,42,152,64,55,33,0,107,45
92604,9697,7253,750,4659,1545,299,3154,2693,788,618,2444,538,758,698,450,1878,566
92606,6611,4505,1025,2694,666,120,2085,1570,453,397,2106,758,970,296,82,1513,593
92610,3833,3044,881,1889,265,9,1762,999,181,102,789,329,379,81,0,622,167
92612,13773,7973,1455,4025,1992,501,2916,3494,839,724,5800,2957,1370,902,571,3516,2284
92614,8523,5781,936,3712,1015,118,2623,1876,712,570,2742,962,1184,504,92,2053,689
92618,2635,1342,353,696,186,107,459,536,156,191,1293,407,473,279,134,1054,239
92620,8928,6918,875,4439,1383,221,3376,2429,595,518,2010,565,822,370,253,1519,491
92624,2763,1990,320,1065,430,175,732,840,229,189,773,145,316,181,131,561,212
92625,6319,3493,281,1527,1292,393,1008,2079,150,256,2826,711,912,552,651,2202,624
92626,17830,10872,2512,5093,2664,603,3656,4739,1156,1321,6958,2780,2522,1209,447,4700,2258
92627,21963,12626,4059,6501,1488,578,5178,3866,1952,1630,9337,3052,3479,1754,1052,6418,2919
92629,11732,7348,1099,3680,2035,534,2212,3812,759,565,4384,1070,1791,1038,485,3234,1150
92630,20178,14960,2697,8695,2953,615,6334,5748,1556,1322,5218,1264,2089,1066,799,3920,1298
92646,21505,15316,1865,7911,4527,1013,5464,7085,1270,1497,6189,1380,2040,1680,1089,4673,1516
92647,20225,14265,3034,7361,3318,552,5272,5448,1863,1682,5960,2282,2137,1115,426,4052,1908
92648,18352,10198,2248,5309,2290,351,3288,4665,1294,951,8154,3237,2817,1191,909,5360,2794
92649,13972,8558,1328,4098,2496,636,2611,4146,754,1047,5414,1403,2100,1387,524,4032,1382
92651,11981,6236,667,3107,1902,560,1852,3276,541,567,5745,1131,2619,1386,609,4319,1426
92653,22470,12181,1176,4667,3260,3078,3635,6832,561,1153,10289,413,953,2684,6239,9324,965
92655,2672,1924,502,958,370,94,788,596,229,311,748,145,269,181,153,583,165
92656,16708,10990,3634,6153,1124,79,5109,3976,1170,735,5718,1957,2886,786,89,4133,1585
92657,2423,1547,158,988,353,48,713,699,75,60,876,295,402,153,26,708,168
92660,12996,7883,737,3623,2739,784,2584,4178,449,672,5113,1096,1598,1633,786,4039,1074
92661,2162,1009,126,369,421,93,220,532,95,162,1153,449,418,119,167,821,332
92662,1737,771,64,238,308,161,114,504,57,96,966,277,352,213,124,787,179
92663,10593,4474,749,1914,1368,443,1075,2365,459,575,6119,2568,2039,983,529,4024,2095
92672,14291,8917,1684,4217,2185,831,2862,4251,993,811,5374,1404,1939,1232,799,3859,1515
92673,5250,4354,456,2643,1058,197,2061,1908,222,163,896,78,351,263,204,684,212
92675,11153,8393,1025,4439,2169,760,3477,3476,851,589,2760,229,879,971,681,2231,529
92676,747,478,65,299,114,0,172,274,14,18,269,33,179,48,9,190,79
92677,23408,16910,2416,10275,3566,653,7509,6931,1511,959,6498,1506,2626,1748,618,4866,1632
92679,9966,8642,1266,6056,1255,65,5313,2682,432,215,1324,274,744,254,52,927,397
92683,26297,20369,3887,9923,5418,1141,8082,7609,2022,2656,5928,902,1876,1925,1225,4484,1444
92688,15334,11305,3595,6704,892,114,6238,3147,1289,631,4029,1343,1806,692,188,3020,1009
92691,15570,12379,1849,6789,3355,386,5245,5180,977,977,3191,630,1390,757,414,2427,764
92692,16612,12898,1631,7510,2686,1071,5892,5348,948,710,3714,724,1231,957,802,2990,724
92694,134,127,52,75,0,0,65,37,17,8,7,7,0,0,0,0,7
92701,12317,10306,4176,4855,1006,269,6019,1523,1709,1055,2011,405,756,478,372,1510,501
92703,12733,11264,3252,5612,1979,421,5977,2283,1637,1367,1469,190,470,573,236,1038,431
92704,19721,16216,4509,8305,2956,446,8520,3978,1890,1828,3505,897,1262,956,390,2469,1036
92705,14113,11072,2080,5114,3017,861,4591,4611,911,959,3041,577,978,781,705,2246,795
92706,9584,7861,2451,3777,1166,467,3816,2066,1190,789,1723,278,607,463,375,1272,451
92707,13117,10770,2928,5921,1660,261,5832,2422,1187,1329,2347,748,912,449,238,1585,762
92708,18024,14216,1789,7150,4602,675,5353,6266,944,1653,3808,725,1302,1145,636,2884,924
92780,18362,12868,3553,6258,2432,625,5412,4079,1931,1446,5494,1366,1981,1328,819,4153,1341
92782,7370,4674,1329,2661,641,43,1844,2010,432,388,2696,938,1330,367,61,1922,774
92801,17769,13204,3819,6358,2341,686,5684,3681,2185,1654,4565,945,1497,1214,909,3579,986
92802,12178,9487,3049,4433,1656,349,4586,2513,1244,1144,2691,569,902,752,468,1983,708
92804,24122,18488,5168,8921,3549,850,7770,5797,2633,2288,5634,1314,2106,1372,842,4276,1358
92805,16932,13475,4448,6719,1786,522,7101,3050,1973,1351,3457,762,1213,877,605,2631,826
92806,10702,8000,2113,3806,1649,432,2985,2726,1246,1043,2702,842,984,608,268,1994,708
92807,12638,10005,1237,5469,2935,364,3821,4612,808,764,2633,443,884,797,509,1966,667
92808,6988,5505,1290,3239,922,54,2728,2017,367,393,1483,425,879,154,25,1206,277
92821,12577,8896,1398,4911,2130,457,3561,3595,889,851,3681,941,1091,1013,636,2957,724
92823,471,356,30,182,124,20,93,209,42,12,115,19,42,46,8,82,33
92831,13206,7684,2300,3366,1525,493,2684,3110,927,963,5522,2642,1579,848,453,3887,1635
92832,7706,5022,1544,2326,856,296,2097,1629,705,591,2684,952,824,570,338,2003,681
92833,14700,11442,2136,6087,2621,598,4767,3856,1467,1352,3258,776,1198,874,410,2542,716
92835,8175,5779,660,2532,1871,716,1839,3148,339,453,2396,489,631,626,650,1873,523
92840,14702,11107,2630,5593,2260,624,4663,3701,1324,1419,3595,643,1350,976,626,2768,827
92841,9215,7333,1533,3631,1731,438,3006,2517,812,998,1882,281,671,617,313,1463,419
92843,10336,8764,2140,4554,1682,388,4188,2218,1072,1286,1572,177,629,488,278,1169,403
92844,6415,5353,1163,2798,1218,174,2371,1539,633,810,1062,144,504,264,150,787,275
92845,5624,4415,501,2285,1382,247,1634,2081,298,402,1209,106,349,481,273,985,224
92860,5521,4509,622,2623,1144,120,1685,1912,496,416,1012,120,424,342,126,739,273
92861,1925,1718,18,815,811,74,685,909,13,111,207,9,42,115,41,161,46
92865,5988,4569,884,2265,1132,288,1655,1743,677,494,1419,337,492,440,150,1044,375
92866,5977,3671,1204,1678,610,179,1382,1372,575,342,2306,547,763,539,457,1826,480
92867,12448,10002,1925,5074,2540,463,4325,3908,864,905,2446,460,854,640,492,1808,638
92868,6622,4290,1205,2092,814,179,1599,1404,693,594,2332,643,936,454,299,1729,603
92869,11821,9605,1719,5126,2317,443,3888,3974,821,922,2216,374,960,759,123,1790,426
92870,15645,12312,2589,6070,3103,550,4909,4968,1082,1353,3333,759,1109,929,536,2456,877
92879,13422,10499,2752,5702,1732,313,4881,3401,1262,955,2923,852,1118,583,370,2180,743
92880,5000,4219,1188,2435,555,41,2169,1242,499,309,781,218,375,158,30,523,258
92881,6680,5602,1380,3206,873,143,3039,1834,406,323,1078,262,384,327,105,801,277
92882,17938,14634,4004,7814,2395,421,7410,4331,1821,1072,3304,786,1413,711,394,2512,792
92883,3986,3448,1194,1836,391,27,2060,1015,257,116,538,113,232,164,29,358,180
92886,13159,10955,1013,6584,2908,450,4725,4687,777,766,2204,288,726,748,442,1769,435
92887,6662,5666,540,3986,993,147,3122,2036,292,216,996,159,501,240,96,746,250
93001,12796,7515,1678,3781,1624,432,2438,2910,1438,729,5281,1315,2182,1133,651,3963,1318
93003,18228,12087,2021,6241,2656,1169,4062,5034,1569,1422,6141,1099,1985,1601,1456,4755,1386
93004,9810,7466,1088,4121,1789,468,2913,2881,940,732,2344,444,739,727,434,1922,422
93010,15158,11257,1773,5548,3158,778,4288,5252,947,770,3901,562,1193,1181,965,3176,725
93012,9701,6959,863,3488,1598,1010,2740,3501,441,277,2742,178,618,645,1301,2388,354
93013,6184,4226,644,2217,1009,356,1563,1712,417,534,1958,230,641,671,416,1535,423
93015,4332,3467,806,1741,688,232,1606,1062,469,330,865,86,257,318,204,680,185
93021,9515,8163,1390,5312,1227,234,4579,2421,707,456,1352,247,569,448,88,972,380
93022,2166,1666,231,960,348,127,661,668,197,140,500,31,234,167,68,343,157
93023,8181,5668,448,3232,1436,552,2063,2329,787,489,2513,250,787,802,674,2071,442
93030,21259,17028,4572,8033,3584,839,7452,4978,2577,2021,4231,780,1380,1215,856,3273,958
93033,16718,14613,3482,7419,3216,496,7001,3767,1854,1991,2105,361,652,707,385,1569,536
93035,9156,6199,865,3241,1717,376,2151,2712,708,628,2957,682,1240,769,266,2079,878
93040,379,325,61,179,69,16,150,88,35,52,54,16,19,11,8,37,17
93041,8065,5802,1907,2679,863,353,2417,1845,913,627,2263,466,655,643,499,1776,487
93060,9219,7284,1646,3505,1623,510,3152,2534,970,628,1935,185,444,712,594,1602,333
93063,16377,13007,2012,7774,2774,447,5238,5076,1461,1232,3370,592,1333,955,490,2546,824
93065,20927,16757,3111,9570,3563,513,7317,6265,1796,1379,4170,961,1582,1182,445,2911,1259
93066,898,782,106,353,298,25,331,361,44,46,116,16,55,19,26,97,19
93067,259,59,9,13,29,8,0,52,7,0,200,34,114,28,24,155,45
93101,12161,5934,1929,2817,856,332,2214,1879,981,860,6227,2389,2032,1125,681,4336,1891
93103,7352,4466,918,2058,1109,381,1567,1935,562,402,2886,789,1199,596,302,2071,815
93105,11298,6313,878,3043,1589,803,2043,3176,491,603,4985,999,1528,1153,1305,3737,1248
93108,4998,3322,150,1470,1227,475,1119,1683,276,244,1676,154,531,538,453,1308,368
93109,4596,2547,258,1256,750,283,809,1183,247,308,2049,666,666,409,308,1349,700
93110,6091,3748,480,1740,1045,483,1351,1710,390,297,2343,480,596,681,586,1777,566
93111,5727,4349,347,2248,1349,405,1736,1962,291,360,1378,312,428,413,225,1022,356
93117,15478,8073,1810,3995,1893,375,3236,3100,773,964,7405,4786,1114,924,581,3307,4098
93201,288,224,47,109,61,7,83,76,46,19,64,5,21,26,12,57,7
93202,850,709,190,390,116,13,315,163,138,93,141,28,45,57,11,106,35
93203,3897,3404,1028,1788,483,105,2074,548,470,312,493,69,128,189,107,373,120
93204,1928,1657,604,779,215,59,886,291,296,184,271,32,83,73,83,219,52
93205,840,568,62,232,195,79,120,356,56,36,272,11,58,115,88,231,41
93206,586,470,137,243,70,20,236,112,69,53,116,14,41,28,33,94,22
93207,94,59,16,8,35,0,10,35,14,0,35,0,10,25,0,32,3
93208,83,60,5,13,34,8,3,49,2,6,23,0,12,7,4,20,3
93210,3951,2966,733,1506,614,113,1394,912,478,182,985,174,397,243,171,796,189
93212,3509,2851,774,1353,572,152,1175,750,574,352,658,71,218,209,160,548,110
93215,9001,7845,2390,3677,1393,385,3829,1854,1391,771,1156,158,312,402,284,908,248
93216,0,0,0,0,0,0,0,0,0,0,0,0,0,0,0,0,0
93218,197,175,21,96,47,11,75,61,15,24,22,0,7,6,9,22,0
93219,2158,1888,528,916,380,64,902,414,367,205,270,44,75,98,53,194,76
93221,4328,3436,682,1776,725,253,1352,1165,567,352,892,111,208,250,323,754,138
93222,647,396,38,165,176,17,131,194,56,15,251,0,123,125,3,198,53
93223,2189,1875,570,868,360,77,838,499,308,230,314,47,65,132,70,227,87
93224,218,174,28,108,31,7,58,89,21,6,44,3,20,13,8,36,8
93225,1691,1258,177,672,357,52,522,596,110,30,433,18,179,185,51,400,33
93226,115,83,2,56,19,6,34,37,6,6,32,0,9,14,9,29,3
93230,17739,13441,3293,6495,2898,755,5243,4951,2150,1097,4298,862,1273,1174,989,3482,816
93234,1517,1420,438,719,222,41,666,265,331,158,97,9,42,46,0,65,32
93235,1175,1027,252,573,157,45,508,254,112,153,148,47,51,50,0,120,28
93238,862,586,47,220,216,103,118,372,41,55,276,6,122,103,45,230,46
93239,390,339,125,112,102,0,179,89,53,18,51,31,6,14,0,14,37
93240,2519,1534,140,506,673,215,250,983,175,126,985,78,201,321,385,893,92
93241,3633,3171,874,1690,472,135,1621,597,634,319,462,65,104,184,109,360,102
93242,840,672,173,309,166,24,332,236,35,69,168,26,73,32,37,132,36
93243,460,370,89,168,106,7,107,149,32,82,90,37,14,33,6,43,47
93244,117,84,10,30,40,4,17,52,12,3,33,6,4,16,7,28,5
93245,9200,7464,2755,3374,1131,204,3600,2118,1197,549,1736,456,583,461,236,1363,373
93247,4229,3487,984,1529,748,226,1567,1052,601,267,742,91,182,247,222,617,125
93249,475,438,173,208,55,2,284,73,52,29,37,14,14,6,3,29,8
93250,2278,2058,587,1026,373,72,1027,398,363,270,220,13,67,83,57,177,43
93251,85,67,19,34,11,3,37,23,3,4,18,0,14,4,0,13,5
93252,703,555,117,238,174,26,218,243,47,47,148,17,57,50,24,132,16
93254,268,192,29,98,53,12,57,93,31,11,76,11,10,45,10,67,9
93255,314,174,0,95,65,14,32,95,38,9,140,0,62,57,21,102,38
93256,1109,923,308,350,231,34,395,235,194,99,186,35,73,33,45,150,36
93257,19511,15263,3953,7289,3031,990,6025,4777,3022,1439,4248,681,1279,1357,931,3561,687
93260,112,87,7,42,31,7,20,54,10,3,25,1,10,11,3,25,0
93261,629,579,179,304,90,6,364,92,76,47,50,2,8,26,14,40,10
93262,36,9,3,3,3,0,3,6,0,0,27,6,21,0,0,15,12
93263,3938,3331,871,1664,639,157,1514,1033,551,233,607,54,151,178,224,502,105
93265,1507,1022,73,437,397,115,252,596,93,81,485,24,157,175,129,415,70
93266,419,368,66,244,52,6,259,94,5,10,51,14,8,29,0,34,17
93267,1502,1247,314,598,271,64,622,358,129,138,255,14,25,118,98,228,27
93268,5289,3862,975,1771,854,262,1408,1423,688,343,1427,273,320,499,335,1217,210
93270,1508,1272,297,612,301,62,618,401,154,99,236,34,68,90,44,200,36
93271,1006,688,52,316,218,102,186,386,67,49,318,22,126,103,67,257,61
93272,770,660,213,314,117,16,359,162,75,64,110,19,27,39,25,90,20
93274,17081,13736,3822,6300,2821,793,5562,4578,2316,1280,3345,554,907,1056,828,2768,577
93276,67,49,11,26,11,1,25,14,5,5,18,6,6,3,3,17,1
93277,16497,11932,2782,5718,2561,871,4363,4897,1786,886,4565,855,1346,1295,1069,3802,763
93280,4395,3779,995,1793,825,166,1774,1011,610,384,616,80,186,193,157,520,96
93282,20,20,4,12,4,0,4,7,5,4,0,0,0,0,0,0,0
93283,863,571,48,205,249,69,97,317,104,53,292,0,67,136,89,268,24
93285,1260,661,46,165,252,198,100,390,95,76,599,24,131,306,138,481,118
93286,2527,2118,478,1071,489,80,970,647,288,213,409,20,113,179,97,345,64
93287,25,22,2,12,8,0,2,13,5,2,3,0,0,1,2,3,0
93291,10305,8258,2204,4058,1539,457,3362,2564,1554,778,2047,449,580,637,381,1698,349
93292,9936,7760,1973,3717,1701,369,3286,2837,1091,546,2176,502,788,561,325,1717,459
93301,5063,2903,1051,1105,503,244,787,885,894,337,2160,546,682,577,355,1808,352
93304,14707,10719,3068,4985,2036,630,3885,3294,2223,1317,3988,702,1441,1112,733,3361,627
93305,10448,7917,2716,3491,1225,485,2957,1952,2052,956,2531,431,844,653,603,1992,539
93306,17530,13269,2866,6495,2989,919,4827,4848,2365,1229,4261,941,1265,1161,894,3531,730
93307,16181,13143,3574,6252,2698,619,5394,3357,2790,1602,3038,364,1007,1175,492,2449,589
93308,16126,11282,2557,5235,2737,753,3726,4458,1904,1194,4844,805,1645,1579,815,4052,792
93309,22514,15312,3995,7208,3229,880,5085,5711,2947,1569,7202,2011,2251,1766,1174,5809,1393
93311,7256,5386,1137,3235,859,155,2734,1875,456,321,1870,459,634,487,290,1545,325
93312,12956,11026,2233,6386,2105,302,5652,4044,866,464,1930,537,855,377,161,1513,417
93313,7546,6332,1722,3604,776,230,3165,1886,868,413,1214,221,472,335,186,1014,200
93401,11821,5698,989,2953,1263,493,2044,2447,649,558,6123,2806,1510,932,875,3913,2210
93402,6089,3927,501,2022,995,409,1362,1835,420,310,2162,255,730,642,535,1587,575
93405,8602,3370,609,1490,872,399,1066,1611,323,370,5232,3715,567,408,542,2545,2687
93420,9596,6771,750,3344,1897,780,2198,3532,569,472,2825,376,831,927,691,2296,529
93422,10609,7716,1179,4429,1737,371,2872,3155,1154,535,2893,494,1067,692,640,2273,620
93424,482,272,6,83,120,63,11,185,27,49,210,36,71,53,50,192,18
93426,550,383,51,182,125,25,100,242,33,8,167,25,63,42,37,120,47
93427,1725,1223,192,662,284,85,562,476,90,95,502,74,170,165,93,384,118
93428,2936,1988,122,818,785,263,445,1249,129,165,948,142,191,316,299,760,188
93429,51,15,4,3,8,0,4,8,0,3,36,9,21,6,0,15,21
93430,1425,831,99,433,184,115,250,492,48,41,594,105,228,159,102,452,142
93432,479,345,45,211,86,3,97,211,35,2,134,11,44,52,27,108,26
93433,5025,3330,807,1619,665,239,1061,1214,635,420,1695,351,596,528,220,1226,469
93434,1434,1215,304,625,236,50,644,252,197,122,219,6,49,127,37,163,56
93435,0,0,0,0,0,0,0,0,0,0,0,0,0,0,0,0,0
93436,17034,12398,2464,6237,2847,850,4830,4621,1817,1130,4636,677,1601,1527,831,3814,822
93437,1704,1620,881,739,0,0,1159,357,101,3,84,65,15,4,0,69,15
93440,452,345,80,182,75,8,169,107,46,23,107,8,54,32,13,87,20
93441,488,367,40,222,95,10,138,164,53,12,121,15,66,26,14,101,20
93442,5315,2823,407,1134,918,364,557,1645,341,280,2492,504,767,699,522,2023,469
93444,5089,4100,602,2019,1184,295,1572,1956,370,202,989,110,327,351,201,750,239
93445,2457,1719,389,877,318,135,625,613,282,199,738,84,237,250,167,569,169
93446,12911,9425,1512,4720,2316,877,3507,4028,1188,702,3486,603,1181,941,761,2818,668
93447,0,0,0,0,0,0,0,0,0,0,0,0,0,0,0,0,0
93449,4228,2347,250,1028,765,304,500,1404,232,211,1881,381,504,568,428,1497,384
93450,230,168,52,78,31,7,62,62,37,7,62,10,20,19,13,50,12
93451,1007,767,207,367,154,39,346,304,113,4,240,62,93,68,17,184,56
93452,184,120,34,61,7,18,32,61,20,7,64,0,27,9,28,42,22
93453,1014,693,89,415,133,56,274,310,57,52,321,30,167,99,25,243,78
93454,10477,7243,1558,3366,1741,578,2656,2902,964,721,3234,556,915,996,767,2700,534
93455,13185,10218,1226,5090,2816,1086,3879,4709,886,744,2967,259,782,1181,745,2417,550
93458,10555,8650,2812,3872,1380,586,4135,2300,1367,848,1905,362,507,574,462,1543,362
93460,2210,1715,128,865,559,163,582,876,128,129,495,13,249,134,99,389,106
93461,357,301,73,156,61,11,129,108,35,29,56,8,22,12,14,50,6
93463,3055,2063,235,928,622,278,771,1032,113,147,992,141,256,302,293,847,145
93465,2882,2275,269,1310,576,120,972,1012,179,112,607,73,197,172,165,471,136
93501,1854,1277,326,547,301,103,375,463,299,140,577,76,227,229,45,497,80
93505,3039,2217,509,1078,551,79,768,956,358,135,822,139,315,256,112,658,164
93510,2523,2047,130,1396,410,111,935,831,175,106,476,51,201,174,50,339,137
93512,108,75,14,43,2,16,41,22,3,9,33,2,0,19,12,33,0
93513,691,495,57,208,172,58,130,275,50,40,196,20,76,56,44,153,43
93514,5672,3745,523,1779,1157,286,1133,1825,508,279,1927,248,566,650,463,1709,218
93516,964,669,79,287,238,65,162,354,94,59,295,32,89,121,53,261,34
93517,359,226,32,101,84,9,44,160,1,21,133,2,100,31,0,131,2
93518,424,316,16,162,123,15,86,181,14,35,108,7,36,52,13,89,19
93522,48,18,1,5,12,0,0,15,3,0,30,2,13,13,2,27,3
93523,2272,1982,1095,806,69,12,1340,470,140,32,290,128,87,63,12,267,23
93526,355,200,22,99,61,18,63,98,27,12,155,4,60,60,31,138,17
93527,939,535,72,268,178,17,162,275,69,29,404,12,180,135,77,320,84
93528,69,25,6,9,10,0,0,16,9,0,44,0,0,39,5,36,8
93529,264,178,19,125,34,0,41,83,44,10,86,30,15,41,0,65,21
93530,39,18,0,3,15,0,3,15,0,0,21,0,9,8,4,13,8
93531,484,406,42,224,125,15,139,231,22,14,78,3,19,33,23,74,4
93532,948,671,108,419,132,12,318,242,68,43,277,43,127,86,21,202,75
93534,12947,8161,2471,3687,1568,435,2409,2495,2192,1065,4786,1138,1452,1288,908,4003,783
93535,18170,14049,3667,7200,2571,611,5831,3995,2874,1349,4121,585,1797,1255,484,3274,847
93536,15228,11627,1948,6782,2463,434,4816,4242,1817,752,3601,507,1259,1155,680,2971,630
93541,218,148,0,89,59,0,42,99,0,7,70,0,19,43,8,29,41
93543,3276,2590,403,1506,588,93,1169,886,327,208,686,52,310,262,62,486,200
93544,488,343,6,146,151,40,62,241,8,32,145,0,57,69,19,127,18
93545,803,492,84,225,142,41,156,206,82,48,311,36,100,98,77,277,34
93546,3224,1867,497,975,374,21,778,782,222,85,1357,463,669,208,17,860,497
93549,115,76,11,31,28,6,27,35,4,10,39,9,10,15,5,31,8
93550,19952,15913,4569,8746,2074,524,6985,3593,3943,1392,4039,839,1585,1138,477,3130,909
93551,10694,8870,981,5746,1920,223,4564,2940,789,577,1824,291,810,560,163,1427,397
93552,7008,5923,1168,3734,899,122,3179,1408,831,505,1085,142,563,267,113,821,264
93553,637,373,40,215,79,39,117,186,51,19,264,13,147,78,26,205,59
93554,57,36,0,9,19,8,0,28,0,8,21,0,3,0,18,21,0
93555,11779,8242,1721,3922,2147,452,2834,3579,1230,599,3537,587,1346,1065,539,3064,473
93560,5178,3737,823,2186,614,114,1659,1233,582,263,1441,178,593,532,138,1183,258
93561,7841,6006,1006,2774,1846,380,2362,2783,586,275,1835,210,619,615,391,1608,227
93562,764,509,99,215,166,29,167,221,85,36,255,26,118,85,26,212,43
93563,104,78,7,44,27,0,20,46,12,0,26,0,9,17,0,26,0
93591,1903,1532,213,980,280,59,697,429,260,146,371,35,158,167,11,264,107
93601,657,518,68,237,175,38,174,252,45,47,139,21,53,39,26,114,25
93602,1308,1060,52,618,342,48,370,547,98,45,248,24,57,91,76,223,25
93603,83,49,0,49,0,0,7,21,21,0,34,8,9,0,17,34,0
93604,293,177,23,28,99,27,23,140,7,7,116,11,15,63,27,98,18
93605,84,70,10,46,14,0,36,26,8,0,14,3,8,3,0,10,4
93606,156,151,18,93,32,8,70,49,14,18,5,0,0,0,5,5,0
93608,345,296,53,156,70,17,180,86,23,7,49,1,20,28,0,21,28
93609,1426,1182,206,629,271,76,528,427,121,106,244,21,76,90,57,197,47
93610,3999,3076,745,1400,704,227,1330,1165,361,220,923,160,171,350,242,776,147
93611,15078,12752,1649,7838,2695,570,5958,5175,959,660,2326,342,806,802,376,1868,458
93612,13269,8458,2607,3794,1553,504,2781,2642,1926,1109,4811,1214,1484,1245,868,3959,852
93614,3539,2801,268,1203,1068,262,856,1675,141,129,738,31,316,247,144,612,126
93615,1239,1119,242,568,275,34,519,322,171,107,120,13,22,41,44,110,10
93616,552,488,76,189,156,67,172,164,74,78,64,0,10,25,29,56,8
93618,6555,5521,1482,2540,1215,284,2535,1471,862,653,1034,119,236,364,315,877,157
93620,2807,2284,554,1019,597,114,988,746,362,188,523,64,176,171,112,453,70
93621,177,103,9,66,19,9,38,51,7,7,74,0,25,22,27,74,0
93622,2330,2018,501,1055,397,65,1072,543,245,158,312,75,113,64,60,261,51
93623,15,15,0,8,7,0,0,15,0,0,0,0,0,0,0,0,0
93624,369,349,106,205,33,5,265,62,12,10,20,6,8,3,3,9,11
93625,1662,1303,270,637,253,143,514,448,185,156,359,25,111,122,101,324,35
93626,534,380,21,204,121,34,101,176,36,67,154,11,72,40,31,143,11
93627,50,50,7,43,0,0,39,6,5,0,0,0,0,0,0,0,0
93628,36,27,0,19,8,0,14,8,5,0,9,0,0,9,0,9,0
93630,3948,3233,852,1510,688,183,1545,959,407,322,715,92,192,280,151,547,168
93631,4784,3773,862,1706,896,309,1543,1491,436,303,1011,106,263,356,286,875,136
93634,7,4,0,4,0,0,3,1,0,0,3,0,0,0,3,3,0
93635,8703,7076,1738,3523,1494,321,3339,2288,999,450,1627,262,492,532,341,1393,234
93637,8864,7028,1969,3243,1428,388,2793,2452,1100,683,1836,254,586,548,448,1561,275
93638,12924,10943,2451,5542,2486,464,4754,3511,1590,1088,1981,292,664,618,407,1506,475
93640,2089,1743,492,921,286,44,923,321,250,249,346,60,170,88,28,203,143
93641,174,95,9,47,14,25,21,59,15,0,79,7,29,30,13,65,14
93643,1415,1121,108,480,466,67,290,670,121,40,294,23,87,81,103,275,19
93644,3636,2544,257,1063,905,319,632,1470,297,145,1092,116,267,406,303,884,208
93645,64,59,0,27,32,0,41,7,11,0,5,0,5,0,0,5,0
93646,1875,1674,490,764,362,58,826,397,297,154,201,30,37,78,56,164,37
93647,2294,2037,560,909,404,164,978,569,230,260,257,5,39,102,111,220,37
93648,2835,2520,758,1182,481,99,1286,466,473,295,315,60,68,112,75,258,57
93650,810,657,169,293,137,58,245,114,164,134,153,15,41,68,29,135,18
93651,424,361,30,211,96,24,153,149,45,14,63,11,9,8,35,54,9
93652,53,48,10,23,8,7,15,21,9,3,5,0,1,4,0,3,2
93653,371,296,33,105,124,34,65,169,33,29,75,11,19,30,15,49,26
93654,7425,6091,1432,2871,1343,445,2604,2074,778,635,1334,253,355,305,421,1139,195
93656,1630,1403,339,666,350,48,623,560,147,73,227,37,24,94,72,211,16
93657,8452,6875,1309,3347,1704,515,2732,2639,869,635,1577,114,464,474,525,1326,251
93660,935,868,308,374,167,19,524,169,110,65,67,7,15,25,20,56,11
93662,7495,6154,1465,2800,1392,497,2504,2052,845,753,1341,158,295,535,353,1133,208
93664,278,199,15,79,94,11,47,124,15,13,79,0,37,31,11,65,14
93665,131,103,10,43,28,22,28,19,25,31,28,7,6,15,0,28,0
93666,27,23,8,10,5,0,6,7,8,2,4,4,0,0,0,0,4
93667,870,702,94,376,208,24,327,302,49,24,168,19,81,40,28,142,26
93668,358,282,50,170,62,0,117,106,33,26,76,23,0,33,20,76,0
93669,127,84,0,14,62,8,4,57,23,0,43,0,43,0,0,10,33
93673,167,147,27,71,37,12,50,60,15,22,20,0,12,8,0,12,8
93675,1242,957,68,432,364,93,227,590,72,68,285,11,115,142,17,211,74
93701,3642,2761,1090,1271,361,39,1060,296,995,410,881,178,356,239,108,720,161
93702,11794,9383,2878,4437,1656,412,4259,1723,2100,1301,2411,233,495,787,896,2034,377
93703,9686,7130,2192,3068,1325,545,2444,1896,1747,1043,2556,324,932,702,598,2123,433
93704,11389,6730,1442,3060,1538,690,1908,2804,1157,861,4659,797,1535,1219,1108,3887,772
93705,12201,8604,2538,3641,1713,712,2957,2445,1944,1258,3597,545,1295,981,776,2967,630
93706,9644,7600,1981,3369,1555,695,2667,1850,1781,1302,2044,246,566,658,574,1691,353
93710,10946,6952,1674,2905,1878,495,2085,2863,1109,895,3994,1884,902,618,590,2762,1232
93711,15186,10447,1556,4981,3058,852,3318,5259,1115,755,4739,1488,1314,1148,789,3919,820
93720,16860,12265,2412,7098,2292,463,5602,4644,1292,727,4595,1291,1592,991,721,3658,937
93721,1440,666,343,210,93,20,239,130,206,91,774,43,248,340,143,673,101
93722,19673,15385,4326,8075,2458,526,6592,4981,2715,1097,4288,1033,1709,1073,473,3376,912
93725,5573,4633,1172,2244,882,335,1825,1389,875,544,940,128,329,319,164,727,213
93726,14143,9199,2825,3947,1818,609,3089,2836,1932,1342,4944,1673,1435,1091,745,3673,1271
93727,17327,13092,3944,5634,2672,842,4737,4277,2905,1173,4235,941,1492,1144,658,3427,808
93728,5828,3434,955,1612,664,203,1101,934,844,555,2394,616,873,542,363,1824,570
93901,10108,6563,1647,3087,1294,535,2436,2353,1076,698,3545,623,1104,986,832,2911,634
93905,11532,10418,3579,5306,1192,341,6051,1796,1677,894,1114,145,332,403,234,849,265
93906,15476,12239,3180,6245,2390,424,5438,3786,1710,1305,3237,709,1142,878,508,2550,687
93907,7286,5699,857,3217,1317,308,2353,2417,431,498,1587,191,724,486,186,1217,370
93908,4574,3804,341,2047,1117,299,1533,1921,205,145,770,68,227,317,158,611,159
93920,452,213,20,129,51,13,51,112,26,24,239,46,123,55,15,195,44
93921,1693,859,58,273,339,189,157,587,40,75,834,69,263,235,267,745,89
93923,6133,3721,119,1422,1434,746,861,2417,221,222,2412,149,583,873,807,2052,360
93924,2844,1868,102,942,634,190,489,1023,184,172,976,92,380,326,178,752,224
93925,283,270,57,143,70,0,144,100,7,19,13,5,6,0,2,10,3
93926,2031,1802,494,912,369,27,1042,362,250,148,229,46,64,78,41,194,35
93927,3098,2635,727,1431,387,90,1527,507,389,212,463,64,174,86,139,326,137
93928,97,78,40,31,7,0,48,26,4,0,19,7,10,2,0,12,7
93930,3837,3213,1052,1404,676,81,1654,927,404,228,624,100,215,219,90,507,117
93932,185,132,12,85,28,7,66,42,15,9,53,3,21,20,9,37,16
93933,7844,5513,1386,2795,1094,238,1865,1975,1034,639,2331,729,843,551,208,1651,680
93940,13952,7601,1499,3443,1887,772,2323,3636,908,734,6351,1631,2328,1441,951,4962,1389
93950,7235,3979,418,2102,1034,425,1133,1932,463,451,3256,502,1205,845,704,2635,621
93953,2132,1472,44,423,659,346,360,952,60,100,660,0,132,234,294,549,111
93954,123,112,11,63,29,9,55,32,12,13,11,2,7,0,2,7,4
93955,9991,7539,2558,3339,1332,310,3260,2277,997,1005,2452,495,848,734,375,1830,622
93960,2933,2639,842,1213,456,128,1420,620,306,293,294,84,74,89,47,254,40
93962,160,135,37,72,26,0,46,35,29,25,25,9,0,16,0,10,15
94002,10584,6709,1098,3446,1728,437,2373,3423,434,479,3875,1025,1486,906,458,2900,975
94005,1630,891,148,521,222,0,344,381,87,79,739,106,367,177,89,563,176
94010,16705,10504,1239,5144,2879,1242,3859,4972,690,983,6201,1845,2077,1197,1082,4971,1230
94014,13063,10148,1866,5080,2597,605,3782,3504,1075,1787,2915,577,1121,784,433,2088,827
94015,20276,14662,2738,7238,3747,939,5312,5748,1381,2221,5614,1585,1864,1334,831,4176,1438
94019,6107,4364,538,2501,1107,218,1840,1977,261,286,1743,198,728,580,237,1269,474
94020,618,346,30,237,67,12,131,168,35,12,272,22,160,90,0,179,93
94021,33,20,0,13,0,7,13,7,0,0,13,7,6,0,0,13,0
94022,7007,5376,217,2578,1869,712,2015,2821,255,285,1631,196,463,548,424,1311,320
94024,7874,6376,274,3385,2032,685,2726,3170,205,275,1498,156,365,601,376,1204,294
94025,15607,9416,1680,4733,2050,953,3677,4044,866,829,6191,1655,2010,1399,1127,4785,1406
94027,2258,1859,47,807,708,297,715,995,51,98,399,0,124,135,140,282,117
94028,2497,1918,63,873,682,300,726,1060,52,80,579,20,203,193,163,457,122
94030,7783,5425,610,2552,1635,628,1746,2693,402,584,2358,328,516,646,868,1959,399
94037,857,670,60,443,151,16,281,267,60,62,187,21,119,40,7,121,66
94038,1020,717,73,477,124,43,304,281,86,46,303,53,95,147,8,200,103
94040,13754,7741,1911,3720,1394,716,2920,3466,694,661,6013,2397,1926,1207,483,4557,1456
94041,6215,2833,922,1310,446,155,954,1163,305,411,3382,1413,1285,385,299,2411,971
94043,12157,6237,1882,3006,1103,246,2331,2670,500,736,5920,1885,2486,1061,488,4275,1645
94044,13936,9773,1305,5624,2421,423,3662,4176,911,1024,4163,877,1759,1051,476,2844,1319
94060,643,482,79,246,150,7,156,252,50,24,161,45,51,57,8,120,41
94061,13714,8958,1818,4636,1856,648,3175,3776,1091,916,4756,1241,1567,987,961,3575,1181
94062,10037,6867,866,3630,1842,529,2531,3369,483,484,3170,565,1324,752,529,2331,839
94063,8873,6226,2043,3255,782,146,2831,1524,1104,767,2647,604,995,739,309,1985,662
94065,4683,2939,735,1603,542,59,1156,1323,239,221,1744,531,873,288,52,1378,366
94066,14344,9857,1839,5133,2251,634,3720,3967,933,1237,4487,957,1830,1096,604,3606,881
94070,11546,7808,1049,4297,1829,633,3057,3625,546,580,3738,696,1271,912,859,2886,852
94074,124,93,26,61,6,0,47,30,0,16,31,0,26,0,5,15,16
94080,19698,14826,2482,7655,3731,958,5704,5587,1528,2007,4872,695,1508,1524,1145,3910,962
94086,26154,15059,5296,6655,2427,681,5335,6591,1448,1685,11095,4671,4006,1571,847,7787,3308
94087,19480,13577,2445,6703,3553,876,5364,6284,842,1087,5903,1713,2076,1326,788,4491,1412
94089,6722,4036,978,1674,968,416,1308,1948,295,485,2686,659,908,636,483,2006,680
94102,15713,4062,1142,1668,949,303,842,1604,735,881,11651,3590,4581,2762,718,9573,2078
94103,9724,2969,795,1295,665,214,836,1112,395,626,6755,2141,2797,1039,778,5052,1703
94104,189,83,0,42,30,11,14,42,0,27,106,6,40,34,26,74,32
94105,1246,317,126,136,49,6,32,204,6,75,929,496,297,114,22,738,191
94107,9110,3080,906,1299,528,347,618,1494,518,450,6030,1941,2868,723,498,4243,1787
94108,7792,2655,348,958,949,400,578,1511,120,446,5137,1754,1392,1094,897,4473,664
94109,33531,8680,2115,3447,2171,947,1898,4786,535,1461,24851,9848,7701,4397,2905,19608,5243
94110,26125,12716,3392,6031,2468,825,4234,4127,1830,2525,13409,5286,5080,2080,963,7496,5913
94111,2284,682,63,299,195,125,94,500,32,56,1602,169,679,544,210,1499,103
94112,20076,14955,2272,7166,4185,1332,5061,5401,1360,3133,5121,842,1696,1413,1170,3403,1718
94114,16817,4133,1087,2083,640,323,952,2318,358,505,12684,3865,6247,1976,596,7315,5369
94115,17502,5753,1424,2391,1468,470,1206,2802,844,901,11749,4877,3712,1963,1197,8508,3241
94116,14883,10270,1095,5020,2830,1325,3470,4400,546,1854,4613,1104,1397,924,1188,3061,1552
94117,18025,4597,1307,2144,905,241,1065,2234,455,843,13428,6609,4835,1381,603,7358,6070
94118,17401,8250,1487,3843,2040,880,2567,4021,507,1155,9151,3736,2969,1468,978,5966,3185
94121,17287,9746,1560,4581,2692,913,2963,4635,547,1601,7541,2674,2456,1385,1026,5098,2443
94122,21738,11981,1975,5696,3177,1133,3960,5490,672,1859,9757,3882,2978,1613,1284,6086,3671
94123,14279,4020,1006,1617,940,457,919,2583,134,384,10259,4722,3327,1391,819,7972,2287
94124,9153,7120,1294,3400,1731,695,2006,1580,1767,1767,2033,250,714,536,533,1574,459
94127,7521,5030,467,2528,1404,631,1811,2334,247,638,2491,320,877,658,636,1708,783
94128,0,0,0,0,0,0,0,0,0,0,0,0,0,0,0,0,0
94129,828,404,207,174,21,2,162,146,52,44,424,352,61,6,5,103,321
94130,468,183,84,91,8,0,89,40,34,20,285,203,75,7,0,75,210
94131,13741,5630,1055,2658,1424,493,1774,2578,436,842,8111,2232,3560,1572,747,5217,2894
94132,9948,5848,1042,2629,1562,615,1718,2566,419,1145,4100,1109,997,921,1073,2959,1141
94133,13675,5452,839,2119,1750,744,1308,3057,306,781,8223,2529,2453,1915,1326,6559,1664
94134,10794,8570,1259,4079,2548,684,2839,3180,991,1560,2224,316,713,610,585,1662,562
94301,7639,3721,401,1892,1053,375,1297,1967,218,239,3918,1297,1160,746,715,3168,750
94303,13005,9758,1957,4990,2206,605,4211,3042,1288,1217,3247,845,1149,790,463,2460,787
94304,912,410,111,146,124,29,125,270,15,0,502,143,151,89,119,411,91
94305,3192,1300,513,451,225,111,551,678,43,28,1892,1671,75,87,59,792,1100
94306,10478,6148,813,3325,1506,504,2453,2585,624,486,4330,1317,1364,947,702,3322,1008
94401,12493,6907,1784,3269,1193,661,2505,2598,744,1060,5586,1469,1722,1121,1274,4485,1101
94402,9550,6300,840,3076,1731,653,2255,3040,457,548,3250,607,1197,749,697,2573,677
94403,15190,9878,1873,4608,2440,957,3564,4476,854,984,5312,1228,1793,1123,1168,4150,1162
94404,13323,8654,1532,4580,2140,402,3255,4206,611,582,4669,1331,1796,1230,312,3496,1173
94501,25078,14084,2927,7218,2899,1040,4659,5381,1998,2046,10994,2807,4306,2457,1424,8649,2345
94502,5289,3904,270,2376,1068,190,1633,1641,274,356,1385,148,559,385,293,1101,284
94506,6404,5664,456,3851,1241,116,2908,2341,248,167,740,92,352,235,61,587,153
94507,5125,4350,142,2492,1482,234,1879,2110,170,191,775,47,285,313,130,567,208
94508,1002,724,125,400,159,40,232,402,52,38,278,73,109,84,12,229,49
94509,29466,23381,5454,13155,3950,822,10517,7603,3467,1794,6085,1124,2342,1634,985,4668,1417
94510,10062,7014,1022,4008,1540,444,2640,2771,1023,580,3048,490,1356,870,332,2400,648
94511,1153,627,74,238,264,51,93,362,86,86,526,10,217,216,83,423,103
94512,38,38,12,12,8,6,17,8,0,13,0,0,0,0,0,0,0
94513,8601,7007,1446,3629,1603,329,3428,2625,663,291,1594,288,481,609,216,1258,336
94514,3779,2946,472,1487,897,90,1093,1528,181,144,833,159,300,280,94,588,245
94515,2937,1870,325,740,541,264,543,926,185,216,1067,98,333,355,281,785,282
94517,5146,4115,442,2358,1161,154,1697,1945,286,187,1031,130,480,357,64,765,266
94518,10326,7257,1166,3745,1838,508,2615,3051,741,850,3069,568,1161,850,490,2387,682
94519,6680,4830,939,2527,966,398,1863,1835,624,508,1850,302,774,473,301,1364,486
94520,12660,7899,2654,3729,1173,343,3160,2236,1386,1117,4761,1327,1788,1060,586,3585,1176
94521,14517,10716,1593,5904,2713,506,4227,4250,1164,1075,3801,651,1712,1001,437,2890,911
94523,13585,8462,1457,4495,1875,635,3056,3754,874,778,5123,1177,1924,1234,788,3857,1266
94525,1522,871,108,435,238,90,218,415,53,185,651,103,285,145,118,519,132
94526,12116,9653,722,5668,2748,515,4122,4392,634,505,2463,238,913,799,513,1969,494
94530,10246,6042,966,2581,1685,810,1643,3109,443,847,4204,822,1418,866,1098,3195,1009
94533,25969,19636,4134,10082,4340,1080,7102,7314,3068,2152,6333,1379,2163,1900,891,5026,1307
94535,2370,2301,1580,721,0,0,1507,531,247,16,69,46,23,0,0,22,47
94536,23551,17166,3872,9005,3590,699,6818,7112,1531,1705,6385,1887,2542,1217,739,4611,1774
94538,19253,13912,3842,6950,2580,540,5529,5223,1344,1816,5341,1737,2103,1040,461,3757,1584
94539,14723,12795,1351,8325,2737,382,6665,4599,774,757,1928,287,890,555,196,1438,490
94541,20553,13797,3753,6632,2521,891,5319,4087,2243,2148,6756,1497,2593,1439,1227,5052,1704
94542,3952,2577,479,1369,613,116,749,1271,223,334,1375,598,451,254,72,791,584
94544,22286,16796,4385,8317,3219,875,6816,5148,2534,2298,5490,1168,1840,1517,965,4186,1304
94545,8568,6551,1101,3386,1691,373,2452,2333,725,1041,2017,274,683,602,458,1626,391
94546,16416,10948,1838,5490,2385,1235,3760,4658,1268,1262,5468,881,2066,1327,1194,4192,1276
94547,7460,5801,644,3741,1215,201,2469,2149,605,578,1659,197,761,533,168,1338,321
94549,9130,6806,485,3722,2053,546,2878,3263,392,273,2324,453,785,675,411,1843,481
94550,27003,20377,3691,11801,4087,798,8841,7808,2058,1670,6626,1564,2753,1537,772,5019,1607
94552,4555,3790,522,2410,772,86,1792,1670,141,187,765,128,285,291,61,562,203
94553,18582,11989,2040,6626,2568,755,4196,4928,1562,1303,6593,1359,2858,1571,805,5044,1549
94555,10763,8766,1919,5331,1341,175,4568,2994,532,672,1997,532,907,414,144,1443,554
94556,5828,4409,266,2326,1441,376,1864,2041,254,250,1419,196,370,570,283,1140,279
94558,22964,16314,2394,8242,4272,1406,6015,7370,1623,1306,6650,745,2077,2108,1720,5408,1242
94559,10395,6371,1628,2956,1275,512,2362,2509,855,645,4024,902,1437,911,774,3182,842
94560,13024,10447,2149,5551,2378,369,4260,3948,1006,1233,2577,565,1072,672,268,1842,735
94561,8518,6977,1617,4048,1176,136,3696,2227,673,381,1541,256,620,466,199,1153,388
94563,6673,5358,273,2680,1761,644,2221,2688,228,221,1315,58,358,432,467,1074,241
94564,5999,4540,560,2442,1244,294,1665,1812,464,599,1459,293,479,433,254,1201,258
94565,24580,18643,4928,9704,3248,763,7610,5786,2948,2299,5937,1022,2475,1577,863,4508,1429
94566,13529,10148,1282,6140,2405,321,4626,4123,843,556,3381,703,1185,847,646,2662,719
94567,152,122,25,59,36,2,59,54,7,2,30,4,11,9,6,18,12
94568,9216,6457,1495,3563,1253,146,2566,2621,714,556,2759,1007,1255,392,105,1972,787
94569,70,44,7,12,25,0,12,25,7,0,26,0,14,7,5,26,0
94571,2200,1458,260,623,450,125,452,727,184,95,742,130,181,257,174,599,143
94572,2806,2130,345,1124,557,104,717,842,349,222,676,87,308,154,127,551,125
94574,3750,2473,263,1221,790,199,830,1119,252,272,1277,154,405,357,361,1071,206
94576,94,78,8,53,11,6,12,38,23,5,16,0,11,5,0,16,0
94577,16363,10490,2095,5017,2337,1041,3447,4209,1399,1435,5873,987,2266,1299,1321,4752,1121
94578,13863,8657,2635,3968,1447,607,2732,2938,1740,1247,5206,1394,1972,956,884,4062,1144
94579,6856,5125,800,2442,1354,529,1817,2223,424,661,1731,165,441,481,644,1449,282
94580,9044,6712,1010,3461,1583,658,2507,2694,643,868,2332,340,758,581,653,1867,465
94583,16730,11965,1751,7575,2328,311,5313,4988,1004,660,4765,1322,2140,838,465,3531,1234
94585,12174,10164,1966,6036,1829,333,4729,3546,1129,760,2010,423,898,450,239,1537,473
94586,294,192,45,71,65,11,65,87,40,0,102,20,47,24,11,82,20
94587,18529,15688,2850,8941,3362,535,6972,5484,1473,1759,2841,670,1060,729,382,2078,763
94588,10383,7794,1266,4909,1462,157,3782,3035,550,427,2589,772,1154,518,145,1925,664
94589,12758,10045,1595,5250,2521,679,3834,3556,1225,1430,2713,334,830,956,593,2224,489
94590,14296,8935,2386,4303,1508,738,2579,2646,2252,1458,5361,918,2039,1433,971,4432,929
94591,17062,12959,2144,7279,2872,664,5110,5007,1516,1326,4103,720,1616,1128,639,3193,910
94592,50,27,12,0,15,0,0,27,0,0,23,15,8,0,0,14,9
94595,9973,4490,263,1446,1266,1515,1035,2957,193,305,5483,250,441,1473,3319,5084,399
94596,19312,10189,1934,5272,2250,733,3514,4853,936,886,9123,2869,3388,1683,1183,7161,1962
94598,10316,7385,666,3657,2486,576,2737,3744,445,459,2931,467,942,894,628,2368,563
94599,1086,582,81,243,165,93,137,340,56,49,504,29,158,181,136,429,75
94601,15112,11416,3457,5626,1812,521,4303,2258,2583,2272,3696,773,1576,831,516,2767,929
94602,11519,6855,1414,3556,1368,517,2153,2515,1166,1021,4664,808,2204,958,694,3349,1315
94603,8754,6965,1904,3121,1485,455,2296,1523,1661,1485,1789,242,681,567,299,1455,334
94605,15245,10549,2178,5047,2565,759,2810,3357,2282,2100,4696,879,1903,1328,586,3599,1097
94606,15080,8708,2496,3985,1730,497,2687,2532,1853,1636,6372,2312,2477,1073,510,4949,1423
94607,7494,4348,1208,1891,839,410,980,1088,1243,1037,3146,489,1060,912,685,2611,535
94608,11056,5009,1186,2483,1019,321,1012,1275,1437,1285,6047,1752,2359,1243,693,4737,1310
94609,9234,3951,1135,1827,676,313,733,1181,1109,928,5283,2168,1854,838,423,3691,1592
94610,15780,6156,1411,3116,1177,452,1915,2396,808,1037,9624,3203,4101,1485,835,7642,1982
94611,17076,8935,1294,4651,2218,772,2946,4380,947,662,8141,2240,2791,1660,1450,6171,1970
94612,6554,1915,530,776,310,299,455,744,369,347,4639,1218,1545,1092,784,4117,522
94618,7378,3694,640,1826,931,297,1256,1867,287,284,3684,1147,1403,641,493,2666,1018
94619,8726,5701,907,2895,1425,474,1735,2016,1025,925,3025,609,1345,753,318,2104,921
94621,8861,6804,2208,3064,1108,424,2371,1048,1853,1532,2057,242,674,684,457,1730,327
94702,7187,3392,716,1707,603,366,824,1082,675,811,3795,959,1429,856,551,2864,931
94703,8751,4046,884,2128,754,280,1175,1239,860,772,4705,2031,1520,807,347,3050,1655
94704,8574,1583,600,609,268,106,462,582,129,410,6991,5059,1225,521,186,4039,2952
94705,5538,2626,344,1270,792,220,907,1294,222,203,2912,1058,1041,498,315,1893,1019
94706,6980,4052,580,2410,766,296,1652,1366,528,506,2928,764,995,652,517,2226,702
94707,4995,3332,227,1644,1063,398,1199,1643,218,272,1663,189,536,559,379,1230,433
94708,4566,2910,194,1145,1187,384,846,1691,140,233,1656,290,537,494,335,1108,548
94709,5123,1424,523,572,244,85,368,706,134,216,3699,1948,928,535,288,2503,1196
94710,3221,1843,676,858,193,116,652,489,404,298,1378,459,542,262,115,932,446
94801,8678,6075,1894,2833,1012,336,2159,1153,1561,1202,2603,384,1063,846,310,2108,495
94803,9212,6656,896,3620,1688,452,2350,2669,883,754,2556,307,1156,709,384,1951,605
94804,14148,9221,2423,4163,1869,766,2561,2851,2031,1778,4927,1073,1963,1212,679,3964,963
94805,5382,3535,506,1897,782,350,1109,1358,457,611,1847,235,787,498,327,1455,392
94806,17614,12622,3261,6208,2648,505,4659,3764,2165,2034,4992,1140,1725,1383,744,4066,926
94901,15521,9092,2026,4473,2015,578,3286,3811,1092,903,6429,1523,2563,1443,900,4681,1748
94903,11656,7202,809,3543,2163,687,2340,3355,841,666,4454,567,1447,1302,1138,3555,899
94904,5502,3195,246,1500,1020,429,1146,1528,295,226,2307,166,786,808,547,1920,387
94920,5669,3669,213,1787,1300,369,1245,1902,299,223,2000,210,719,742,329,1597,403
94922,220,118,24,72,22,0,41,60,11,6,102,35,38,21,8,76,26
94923,872,631,69,196,311,55,159,420,25,27,241,30,100,81,30,188,53
94924,593,322,27,187,101,7,117,133,44,28,271,32,126,101,12,185,86
94925,3811,2489,292,1359,652,186,1013,1008,254,214,1322,205,558,336,223,994,328
94928,15640,9949,2248,5521,1779,401,4095,3371,1495,988,5691,2204,1553,1044,890,3812,1879
94929,141,104,9,45,34,16,7,82,4,11,37,7,24,0,6,20,17
94930,3759,2182,192,1363,497,130,701,940,377,164,1577,215,742,413,207,1112,465
94931,3061,1985,473,1092,305,115,860,616,298,211,1076,200,492,260,124,714,362
94933,419,241,0,188,47,6,80,84,61,16,178,80,60,32,6,102,76
94937,375,176,20,71,61,24,71,105,0,0,199,13,80,72,34,169,30
94938,354,202,14,145,43,0,85,56,33,28,152,16,81,46,9,122,30
94939,3347,1652,160,966,406,120,652,744,122,134,1695,339,737,431,188,1315,380
94940,179,95,13,41,27,14,44,42,4,5,84,2,38,34,10,61,23
94941,12630,7359,721,4085,2141,412,2876,3363,673,447,5271,734,2028,1619,890,4025,1246
94945,6392,4517,550,2411,1291,265,1651,2009,581,276,1875,271,800,480,324,1473,402
94946,215,158,8,110,34,6,65,77,8,8,57,7,29,14,7,45,12
94947,9318,6579,817,3552,1833,377,2346,2872,812,549,2739,369,1032,870,468,2118,621
94949,5448,3466,726,1618,837,285,1256,1577,364,269,1982,298,743,622,319,1528,454
94950,68,40,0,29,0,11,7,26,7,0,28,0,10,12,6,20,8
94951,1461,1096,106,566,366,58,271,642,111,72,365,65,192,73,35,267,98
94952,12178,8062,1189,4465,1860,548,3069,3414,846,733,4116,744,1595,1038,739,3126,990
94954,12275,9155,1346,5392,1962,455,3860,3623,908,764,3120,384,1057,907,772,2346,774
94956,921,561,28,306,168,59,137,303,76,45,360,46,142,101,71,305,55
94960,6731,4386,356,2612,1030,388,1875,1720,417,374,2345,375,1021,639,310,1675,670
94963,160,129,15,73,22,19,28,74,27,0,31,0,16,15,0,31,0
94964,114,73,17,20,36,0,0,25,28,20,41,0,22,19,0,31,10
94965,6136,2583,527,1203,720,133,505,1480,304,294,3553,693,1735,866,259,2612,941
94970,347,186,28,74,72,12,59,104,14,9,161,20,93,41,7,118,43
94971,127,75,7,57,6,5,32,16,6,21,52,7,23,16,6,36,16
94972,23,18,0,18,0,0,0,18,0,0,5,0,0,5,0,0,5
94973,548,423,0,252,141,30,169,158,48,48,125,7,67,51,0,88,37
95002,509,413,62,275,52,24,191,106,56,60,96,15,39,42,0,63,33
95003,10000,6373,658,3582,1528,605,2197,2964,673,539,3627,688,1447,1012,480,2509,1118
95004,1091,936,63,618,229,26,413,379,117,27,155,24,72,27,32,91,64
95005,2338,1596,253,938,322,83,604,649,223,120,742,203,333,156,50,501,241
95006,4054,2644,354,1758,450,82,1005,1125,402,112,1410,342,768,227,73,959,451
95007,398,281,51,156,74,0,86,99,37,59,117,30,71,8,8,69,48
95008,18736,11073,2433,5903,2228,509,3923,4432,1419,1299,7663,2774,2895,1225,769,5340,2323
95010,4620,2176,422,1172,442,140,592,962,302,320,2444,572,900,579,393,1741,703
95012,2077,1781,350,897,464,70,809,465,269,238,296,49,131,92,24,234,62
95014,19586,14705,1984,8825,3219,677,7383,5319,903,1100,4881,1165,1837,1130,749,3754,1127
95017,242,151,8,115,23,5,91,46,8,6,91,32,39,18,2,66,25
95018,3052,1923,188,1332,319,84,758,800,220,145,1129,264,605,164,96,805,324
95019,1190,941,221,488,168,64,503,243,109,86,249,0,44,109,96,217,32
95020,14393,11872,2734,6416,2252,470,5104,3904,1685,1179,2521,407,790,783,541,1969,552
95023,13984,11591,2819,6158,2158,456,5459,3920,1482,730,2393,403,881,620,489,1872,521
95030,5389,3460,291,1783,1152,234,1360,1729,142,229,1929,467,699,445,318,1517,412
95032,9798,6461,651,3646,1755,409,2469,2912,588,492,3337,675,1208,822,632,2512,825
95033,3904,2772,238,1650,827,57,1026,1416,206,124,1132,154,672,290,16,809,323
95035,17203,14239,2879,7922,3075,363,6402,5257,1211,1369,2964,860,1208,642,254,1962,1002
95037,13377,10734,1767,6142,2396,429,4523,4295,1150,766,2643,471,993,833,346,2005,638
95039,250,155,23,79,53,0,95,53,7,0,95,39,39,17,0,42,53
95041,25,19,0,13,6,0,6,13,0,0,6,6,0,0,0,6,0
95043,310,216,37,92,60,27,77,95,20,24,94,6,33,37,18,75,19
95045,1097,804,170,389,199,46,333,308,120,43,293,55,134,65,39,213,80
95046,1640,1332,117,727,387,101,491,543,119,179,308,35,127,84,62,204,104
95050,14000,7975,2178,3753,1460,584,2912,3236,741,1086,6025,2188,1803,992,1042,4263,1762
95051,20252,13637,3555,6189,3047,846,4810,5918,1199,1710,6615,2237,2476,1262,640,4674,1941
95054,4260,2837,789,1470,529,49,1036,1264,233,304,1423,622,528,228,45,1012,411
95060,16670,8957,1549,4783,1928,697,2956,3811,1288,902,7713,2952,2836,1245,680,4589,3124
95062,14969,7974,1635,4613,1306,420,2616,2583,1666,1109,6995,2124,2609,1282,980,4641,2354
95064,547,366,175,181,10,0,162,126,78,0,181,121,50,6,4,130,51
95065,3285,2136,219,1220,553,144,718,970,247,201,1149,245,353,252,299,856,293
95066,5491,3978,490,2396,793,299,1705,1643,383,247,1513,272,438,401,402,1167,346
95070,10742,8815,321,4947,2888,659,3942,4203,277,393,1927,143,590,641,553,1594,333
95073,3870,2537,268,1432,671,166,814,1113,365,245,1333,197,561,382,193,1007,326
95076,21696,17115,3827,8666,3481,1141,7663,5328,2386,1738,4581,589,1676,1366,950,3512,1069
95110,4685,3056,1061,1293,544,158,1153,725,561,617,1629,485,777,203,164,1130,499
95111,14104,11739,2967,6383,2103,286,5351,3144,1680,1564,2365,455,999,659,252,1681,684
95112,16569,9385,3100,4194,1526,565,3417,2973,1479,1516,7184,2853,2259,1253,819,4852,2332
95113,384,97,13,40,32,12,30,56,5,6,287,94,57,87,49,283,4
95116,12036,9794,3235,4399,1777,383,4496,2235,1456,1607,2242,327,830,665,420,1656,586
95117,11109,7170,2392,3173,1207,398,2635,2475,1017,1043,3939,1282,1518,691,448,2777,1162
95118,11331,8375,1760,4377,1759,479,3267,3147,1046,915,2956,672,1118,838,328,2169,787
95119,3122,2618,399,1653,505,61,1162,983,234,239,504,162,189,129,24,326,178
95120,12430,10867,758,6290,3429,390,4931,5049,371,516,1563,96,545,721,201,1281,282
95121,8956,7804,1233,4756,1631,184,3526,2609,765,904,1152,211,518,321,102,796,356
95122,12105,10726,2517,5555,2316,338,4858,2728,1428,1712,1379,389,481,391,118,862,517
95123,20403,15214,3327,8494,2989,404,6107,5523,1826,1758,5189,1486,1903,1244,556,3734,1455
95124,16228,12138,1967,6631,2725,815,4797,4898,1196,1247,4090,852,1482,1184,572,3006,1084
95125,18765,11530,2175,5577,2592,1186,3960,5171,1137,1262,7235,1544,2464,1639,1588,5420,1815
95126,10896,5849,2073,2634,813,329,2006,1981,947,915,5047,1670,1976,812,589,3644,1403
95127,15419,12861,2305,6922,2811,823,5261,4409,1493,1698,2558,457,843,816,442,1790,768
95128,12540,7613,2381,3406,1237,589,2542,2841,1102,1128,4927,1555,1923,900,549,3480,1447
95129,13982,9932,1644,5439,2324,525,4422,3720,835,955,4050,1253,1471,933,393,3008,1042
95130,4827,3488,646,1880,796,166,1414,1318,382,374,1339,367,619,271,82,940,399
95131,8146,6295,1570,3586,1021,118,2637,2153,615,890,1851,640,925,248,38,1274,577
95132,11605,9759,1581,5354,2542,282,4137,3798,667,1157,1846,461,819,458,108,1212,634
95133,6992,5916,1050,3423,1206,237,2472,1928,708,808,1076,318,461,262,35,747,329
95134,4071,2329,898,1083,322,26,788,1036,251,254,1742,767,764,189,22,1357,385
95135,5834,4478,529,2123,1297,529,1895,2276,100,207,1356,50,139,535,632,1191,165
95136,12832,9261,2304,4725,1970,262,3444,3687,1125,1005,3571,1367,1337,661,206,2462,1109
95138,4865,3956,914,2464,552,26,1979,1402,295,280,909,325,453,123,8,634,275
95139,2283,1786,256,1108,341,81,843,569,190,184,497,100,194,154,49,363,134
95140,9,0,0,0,0,0,0,0,0,0,9,0,9,0,0,9,0
95148,10947,9873,1451,6212,2007,203,4852,3305,750,966,1074,299,499,247,29,708,366
95202,3285,1378,636,499,144,99,364,253,558,203,1907,263,626,627,391,1699,208
95203,5285,3532,1073,1614,620,225,1237,931,853,511,1753,431,588,500,234,1302,451
95204,11619,7482,1696,3316,1669,801,2159,3125,1369,829,4137,865,1056,1126,1090,3420,717
95205,9749,7464,2187,3281,1590,406,2730,1897,1595,1242,2285,253,812,679,541,1848,437
95206,12814,10719,2854,5403,1871,591,4756,2627,1996,1340,2095,314,597,707,477,1625,470
95207,18404,12182,3334,5216,2731,901,3856,4133,2717,1476,6222,1441,1752,1681,1348,5097,1125
95209,9524,7953,1571,4411,1600,371,3424,2911,1009,609,1571,209,597,415,350,1274,297
95210,11311,9206,2331,4677,1776,422,4010,2516,1748,932,2105,327,639,669,470,1692,413
95212,2590,1910,285,757,694,174,620,1006,141,143,680,11,249,250,170,564,116
95215,6615,5124,988,2330,1452,354,1930,2006,560,628,1491,109,385,533,464,1255,236
95219,7858,5021,1083,2500,1225,213,1785,1993,911,332,2837,858,969,705,305,2364,473
95220,2255,1776,173,850,618,135,571,989,110,106,479,32,156,163,128,400,79
95221,271,142,12,48,60,22,34,76,12,20,129,18,42,43,26,104,25
95222,1714,1213,165,536,415,97,312,622,173,106,501,91,140,160,110,437,64
95223,2243,1613,106,667,699,141,412,1086,44,71,630,89,196,242,103,485,145
95224,59,5,0,0,5,0,0,5,0,0,54,13,9,32,0,54,0
95225,6,0,0,0,0,0,0,0,0,0,6,6,0,0,0,6,0
95226,18,8,0,8,0,0,8,0,0,0,10,0,10,0,0,0,10
95227,236,207,11,60,130,6,49,128,20,10,29,7,6,16,0,21,8
95228,1024,779,110,265,368,36,255,442,41,41,245,24,107,90,24,179,66
95230,177,117,23,49,45,0,42,68,7,0,60,3,31,16,10,54,6
95231,908,715,178,290,167,80,302,215,70,128,193,6,65,80,42,181,12
95232,7,7,7,0,0,0,0,0,7,0,0,0,0,0,0,0,0
95233,125,87,18,24,25,20,27,45,10,5,38,0,17,21,0,29,9
95236,1022,849,146,432,204,67,328,395,103,23,173,9,71,47,46,128,45
95237,1110,900,125,439,224,112,321,407,109,63,210,31,41,78,60,176,34
95240,15614,10917,2824,5128,2165,800,4174,3750,1766,1227,4697,928,1270,1340,1159,3820,877
95242,8600,6165,884,2945,1813,523,2075,3001,679,410,2435,307,700,778,650,2049,386
95245,1131,752,64,356,254,78,171,459,99,23,379,30,122,193,34,289,90
95246,736,484,12,238,204,30,122,305,47,10,252,26,57,156,13,147,105
95247,1934,1336,80,600,478,178,329,815,132,60,598,36,91,292,179,558,40
95249,1566,1026,175,395,344,112,273,511,177,65,540,20,129,167,224,493,47
95250,43,33,0,33,0,0,0,23,10,0,10,0,0,10,0,10,0
95251,196,134,0,90,25,19,61,58,8,7,62,12,14,26,10,20,42
95252,4094,3238,351,1671,1068,148,1085,1644,296,213,856,74,342,276,164,671,185
95254,114,95,14,54,27,0,29,34,32,0,19,0,9,0,10,0,19
95255,950,637,66,263,227,81,156,376,31,74,313,14,87,152,60,266,47
95257,193,101,17,33,36,15,22,60,12,7,92,0,15,56,21,73,19
95258,1428,1120,126,659,261,74,507,454,31,128,308,44,122,109,33,249,59
95301,8602,6836,1667,3377,1516,276,2734,2231,1274,597,1766,278,539,664,285,1462,304
95303,230,170,22,81,37,30,52,93,13,12,60,13,21,14,12,43,17
95305,64,52,8,8,18,18,0,31,16,5,12,0,6,6,0,6,6
95306,373,263,16,153,83,11,117,101,24,21,110,9,24,45,32,95,15
95307,10275,8117,2005,3983,1644,485,3405,2692,1225,795,2158,343,695,664,456,1714,444
95310,941,586,41,226,221,98,93,366,71,56,355,33,96,102,124,276,79
95311,930,665,39,310,246,70,152,390,67,56,265,10,71,142,42,198,67
95312,17,13,4,8,1,0,10,3,0,0,4,2,0,2,0,4,0
95313,505,401,97,174,102,28,167,151,49,34,104,35,20,14,35,84,20
95315,2718,2324,722,1126,397,79,1229,587,279,229,394,63,135,138,58,278,116
95316,1792,1447,202,840,319,86,634,534,187,92,345,53,130,79,83,271,74
95317,199,172,44,78,35,15,73,68,16,15,27,12,9,2,4,18,9
95318,264,133,38,87,8,0,90,37,6,0,131,41,63,18,9,124,7
95320,3836,3014,528,1599,675,212,1365,1243,216,190,822,120,233,256,213,694,128
95321,1671,1159,43,386,559,171,194,787,99,79,512,47,169,213,83,420,92
95322,2737,2017,453,981,395,188,878,774,212,153,720,68,162,265,225,612,108
95323,356,289,60,149,58,22,111,132,24,22,67,13,28,14,12,60,7
95324,2399,1985,466,906,426,187,915,822,87,161,414,41,89,199,85,358,56
95325,54,30,0,0,30,0,0,16,0,14,24,0,0,16,8,24,0
95326,2205,1785,278,925,447,135,724,750,173,138,420,63,150,82,125,350,70
95327,2217,1514,227,676,488,123,377,838,199,100,703,79,187,263,174,575,128
95328,514,453,86,277,73,17,186,100,105,62,61,0,29,9,23,42,19
95329,706,528,80,200,221,27,151,310,35,32,178,19,76,47,36,123,55
95330,2997,2544,595,1387,508,54,1114,879,366,185,453,52,225,108,68,358,95
95333,885,761,132,371,184,74,358,267,59,77,124,12,31,42,39,105,19
95334,3026,2617,694,1379,473,71,1427,627,314,249,409,49,133,183,44,342,67
95335,325,220,17,107,74,22,53,138,0,29,105,11,34,38,22,105,0
95336,12210,9613,1974,5047,2139,453,3886,3531,1300,896,2597,427,925,766,479,2062,535
95337,6579,4998,1003,2843,978,174,2196,1730,671,401,1581,292,596,434,259,1267,314
95338,4210,2821,260,1271,949,341,690,1569,296,266,1389,119,433,540,297,1149,240
95340,18133,13780,3527,6396,3163,694,5528,4217,2525,1510,4353,835,1430,1200,888,3440,913
95345,187,142,27,81,34,0,45,58,32,7,45,0,9,36,0,33,12
95346,499,343,38,216,71,18,134,154,43,12,156,34,56,41,25,107,49
95348,8092,5587,1620,2523,1116,328,2004,1733,1240,610,2505,601,878,625,401,2036,469
95350,19863,13647,3070,6147,3315,1115,4220,5366,2344,1717,6216,1080,1729,1768,1639,5143,1073
95351,12798,10450,2938,5227,1832,453,4758,2454,2005,1233,2348,409,761,746,432,1768,580
95354,9180,6281,1585,3137,1166,393,2204,2042,1181,854,2899,509,1064,796,530,2291,608
95355,17433,12503,2668,6391,2748,696,4520,4850,1922,1211,4930,848,1717,1471,894,4127,803
95356,9689,6944,1452,3627,1400,465,2635,2712,936,661,2745,760,914,743,328,2168,577
95357,4142,3405,685,1846,760,114,1646,1127,341,291,737,74,291,224,148,632,105
95358,8342,7007,1519,3728,1460,300,3232,2132,1038,605,1335,189,474,436,236,1068,267
95360,2561,2048,453,1051,487,57,947,678,232,191,513,41,125,200,147,409,104
95361,9118,6849,1220,3388,1741,500,2381,3058,828,582,2269,339,715,705,510,1880,389
95363,4290,3549,834,1852,686,177,1738,1069,422,320,741,100,233,212,196,575,166
95364,36,36,0,14,22,0,0,25,0,11,0,0,0,0,0,0,0
95365,975,898,220,459,175,44,508,226,82,82,77,2,28,12,35,64,13
95366,4218,3338,587,1862,685,204,1490,1328,341,179,880,166,225,274,215,722,158
95367,4851,4082,941,2059,843,239,1914,1299,434,435,769,125,262,264,118,614,155
95368,3532,3074,992,1615,375,92,1783,844,272,175,458,186,177,44,51,307,151
95369,403,292,56,155,71,10,131,120,33,8,111,20,37,34,20,85,26
95370,10637,7111,1078,3025,2096,912,2043,3643,803,622,3526,384,1148,1216,778,2881,645
95372,548,411,47,186,120,58,148,197,44,22,137,36,28,37,36,99,38
95374,595,491,136,229,102,24,244,197,27,23,104,11,21,37,35,94,10
95376,20656,16625,3911,9505,2607,602,8470,5240,1749,1166,4031,754,1417,1125,735,3103,928
95379,1552,1089,177,578,285,49,381,516,110,82,463,19,179,175,90,376,87
95380,12776,9535,2398,4486,1850,801,3691,3318,1558,968,3241,596,1034,1004,607,2714,527
95382,8604,6326,1353,3068,1520,385,2779,2393,650,504,2278,773,565,488,452,1703,575
95383,2057,1436,160,560,607,109,381,815,148,92,621,72,204,195,150,537,84
95385,85,68,9,33,21,5,31,29,8,0,17,0,12,0,5,17,0
95386,2519,2120,508,1124,385,103,1034,676,263,147,399,83,100,113,103,333,66
95387,166,151,16,108,21,6,101,38,12,0,15,0,0,5,10,15,0
95388,3222,2683,761,1209,600,113,1266,780,398,239,539,73,190,162,114,426,113
95389,266,177,17,132,28,0,63,92,22,0,89,9,64,16,0,89,0
95401,12901,8315,1780,4313,1683,539,2995,3099,1227,994,4586,1189,1724,983,690,3261,1325
95403,14764,9791,1945,5201,1999,646,3630,3666,1509,986,4973,1086,1650,1244,993,3841,1132
95404,13919,8508,1366,4377,2051,714,2811,3934,1057,706,5411,1194,1797,1488,932,4034,1377
95405,8819,5731,757,3115,1377,482,2062,2455,685,529,3088,625,1139,770,554,2310,778
95407,9445,6548,1916,3348,971,313,2664,1873,1274,737,2897,668,1252,701,276,1964,933
95409,11356,7124,671,3122,1984,1347,1904,3923,813,484,4232,377,810,1270,1775,3558,674
95410,391,231,16,124,68,23,80,99,23,29,160,6,99,40,15,132,28
95412,270,185,24,73,69,19,45,107,27,6,85,13,32,31,9,66,19
95415,434,314,59,159,84,12,122,112,60,20,120,9,50,36,25,101,19
95417,64,48,6,26,16,0,25,19,4,0,16,3,9,4,0,16,0
95419,207,125,10,86,29,0,36,58,31,0,82,16,48,18,0,63,19
95420,180,105,0,56,39,10,10,82,13,0,75,11,53,11,0,53,22
95421,655,361,25,205,107,24,97,186,39,39,294,39,148,75,32,192,102
95422,5742,3454,667,1437,948,402,707,1461,846,440,2288,139,615,983,551,1923,365
95423,1639,960,65,300,461,134,155,584,169,52,679,28,213,239,199,559,120
95424,48,16,0,0,0,16,0,10,0,6,32,0,20,12,0,12,20
95425,3341,2405,440,1252,530,183,817,1070,377,141,936,107,227,394,208,803,133
95426,576,448,55,278,97,18,152,223,56,17,128,29,51,34,14,98,30
95427,213,110,0,55,37,18,7,69,16,18,103,20,19,40,24,77,26
95428,839,568,107,227,196,38,148,221,104,95,271,30,138,77,26,218,53
95429,27,18,0,3,15,0,0,9,3,6,9,3,3,3,0,9,0
95430,67,34,8,26,0,0,9,17,0,8,33,23,10,0,0,11,22
95431,0,0,0,0,0,0,0,0,0,0,0,0,0,0,0,0,0
95432,158,109,20,64,12,13,33,64,10,2,49,0,27,15,7,42,7
95436,2671,1454,186,861,283,124,493,614,206,141,1217,173,700,255,89,896,321
95437,6014,3683,595,1836,990,262,1179,1762,518,224,2331,254,785,773,519,1832,499
95439,167,116,53,50,6,7,42,20,35,19,51,6,10,27,8,35,16
95441,725,540,83,309,117,31,246,206,40,48,185,25,68,69,23,135,50
95442,1417,852,125,504,191,32,303,379,128,42,565,128,242,147,48,426,139
95443,105,67,10,24,23,10,0,67,0,0,38,0,0,26,12,32,6
95444,138,90,15,44,28,3,24,37,26,3,48,0,28,0,20,29,19
95445,873,525,51,262,158,54,165,282,41,37,348,17,148,124,59,286,62
95446,2274,1046,143,581,271,51,203,440,226,177,1228,160,637,305,126,860,368
95448,6537,4520,739,2290,1076,415,1608,1995,518,399,2017,260,684,554,519,1583,434
95449,450,330,93,179,51,7,124,112,58,36,120,28,40,23,29,82,38
95450,213,102,2,45,44,11,17,53,18,14,111,10,60,28,13,93,18
95451,3937,2745,368,1332,724,321,837,1330,369,209,1192,76,355,548,213,984,208
95452,728,498,40,263,133,62,187,267,33,11,230,8,117,69,36,190,40
95453,4310,2807,480,1196,781,350,815,1301,402,289,1503,157,463,546,337,1207,296
95454,1095,743,122,399,172,50,194,306,150,93,352,53,163,98,38,265,87
95456,522,261,0,111,119,31,19,180,44,18,261,23,30,133,75,206,55
95457,1120,790,96,353,264,77,184,417,94,95,330,6,109,117,98,248,82
95458,1426,798,53,379,283,83,153,448,142,55,628,33,179,276,140,516,112
95459,221,146,24,76,39,7,35,67,36,8,75,3,34,19,19,51,24
95460,1048,626,55,317,159,95,197,350,54,25,422,66,130,103,123,358,64
95461,2968,2012,282,1034,563,133,705,1001,241,65,956,83,395,299,179,701,255
95462,772,358,29,180,138,11,109,169,62,18,414,51,248,87,28,293,121
95463,59,48,0,37,11,0,9,39,0,0,11,0,7,4,0,8,3
95464,974,557,83,240,176,58,77,278,128,74,417,35,156,114,112,342,75
95465,751,366,64,167,115,20,149,162,44,11,385,83,166,100,36,308,77
95466,388,293,30,195,61,7,145,118,13,17,95,0,62,29,4,74,21
95468,518,332,80,138,76,38,114,147,47,24,186,34,75,67,10,143,43
95469,759,511,73,271,144,23,185,227,57,42,248,29,98,103,18,189,59
95470,2087,1657,235,907,419,96,562,793,161,141,430,44,181,118,87,356,74
95471,129,61,21,31,9,0,27,27,7,0,68,0,42,26,0,30,38
95472,12207,8248,800,4656,2116,676,2924,3557,1044,723,3959,467,1784,1061,647,2957,1002
95476,14184,8857,1187,4212,2476,982,2980,4204,925,748,5327,506,1725,1753,1343,4421,906
95480,14,7,2,2,0,3,2,3,2,0,7,4,0,0,3,7,0
95481,4,4,0,4,0,0,4,0,0,0,0,0,0,0,0,0,0
95482,11377,7655,1806,3596,1796,457,2651,2991,1431,582,3722,639,1133,1147,803,3016,706
95485,976,629,108,226,207,88,131,339,96,63,347,34,118,111,84,296,51
95488,139,61,7,20,26,8,4,35,14,8,78,21,16,30,11,54,24
95490,5166,3503,684,1641,900,278,1193,1422,605,283,1663,180,653,524,306,1318,345
95492,7885,6101,1009,3620,1159,313,2911,2076,694,420,1784,172,708,440,464,1443,341
95493,84,64,6,50,8,0,27,17,5,15,20,0,0,20,0,15,5
95494,114,67,2,38,22,5,13,45,7,2,47,0,24,23,0,47,0
95497,419,282,4,49,187,42,19,250,0,13,137,0,51,63,23,108,29
95501,9742,5143,1382,2351,1064,346,1257,2011,1229,646,4599,1422,1397,1009,771,3523,1076
95502,0,0,0,0,0,0,0,0,0,0,0,0,0,0,0,0,0
95503,9377,6298,1101,3172,1571,454,1850,2886,1066,496,3079,551,992,1038,498,2369,710
95511,85,63,34,23,6,0,20,15,28,0,22,11,11,0,0,22,0
95514,64,56,12,24,12,8,15,20,12,9,8,0,6,2,0,8,0
95519,6170,4250,853,2194,960,243,1557,1615,613,465,1920,486,768,468,198,1335,585
95521,8240,3618,826,1785,729,278,991,1487,757,383,4622,2720,876,634,392,2719,1903
95524,721,535,50,310,124,51,246,220,59,10,186,39,61,42,44,124,62
95525,707,421,65,244,86,26,100,194,93,34,286,72,102,67,45,219,67
95526,286,196,38,86,66,6,62,104,22,8,90,15,40,21,14,57,33
95527,212,118,17,64,35,2,27,48,30,13,94,4,19,56,15,71,23
95528,411,295,40,171,70,14,94,143,53,5,116,7,38,37,34,101,15
95531,7793,5331,965,2790,1240,336,1699,2041,1115,476,2462,285,876,904,397,1996,466
95536,1199,802,123,398,241,40,278,413,59,52,397,68,106,135,88,328,69
95537,87,44,16,21,7,0,5,10,6,23,43,12,13,10,8,35,8
95540,4872,3252,561,1497,863,331,1098,1471,398,285,1620,283,502,428,407,1333,287
95542,892,553,83,336,125,9,173,241,108,31,339,76,184,48,31,251,88
95543,209,173,15,123,35,0,59,62,34,18,36,0,11,13,12,36,0
95545,42,26,0,22,4,0,14,4,8,0,16,1,12,3,0,12,4
95546,994,704,183,333,152,36,203,167,208,126,290,46,102,110,32,232,58
95547,446,335,26,201,80,28,129,168,17,21,111,11,47,33,20,85,26
95548,411,295,19,177,70,29,50,155,70,20,116,3,48,45,20,95,21
95549,100,80,8,52,19,1,31,34,7,8,20,7,8,5,0,15,5
95550,42,36,1,30,5,0,18,8,10,0,6,1,0,0,5,5,1
95551,582,377,98,161,86,32,127,167,50,33,205,25,103,47,30,162,43
95552,95,69,3,30,33,3,11,34,10,14,26,6,11,6,3,20,6
95553,412,207,47,127,25,8,67,61,63,16,205,37,134,20,14,176,29
95554,255,184,15,92,64,13,81,72,26,5,71,10,33,28,0,28,43
95555,220,137,29,61,29,18,24,76,28,9,83,12,33,30,8,53,30
95556,228,160,18,61,64,17,35,53,48,24,68,12,21,27,8,62,6
95558,126,72,6,42,18,6,17,40,13,2,54,10,27,9,8,35,19
95559,57,47,0,32,15,0,0,9,32,6,10,0,10,0,0,0,10
95560,865,406,36,238,90,42,67,183,140,16,459,60,225,140,34,366,93
95562,1259,863,189,387,236,51,242,370,163,88,396,53,133,105,105,315,81
95563,299,178,15,100,59,4,46,104,19,9,121,3,54,60,4,109,12
95564,126,97,24,47,26,0,28,41,17,11,29,12,8,5,4,16,13
95565,354,297,81,171,40,5,162,87,33,15,57,8,27,17,5,49,8
95567,772,515,103,203,117,92,164,269,38,44,257,13,111,73,60,194,63
95568,77,52,5,32,10,5,13,32,7,0,25,8,13,0,4,25,0
95569,134,85,16,32,35,2,26,40,12,7,49,6,15,23,5,47,2
95570,1074,595,70,268,194,63,170,304,72,49,479,93,220,120,46,360,119
95571,91,74,11,38,16,9,31,20,8,15,17,0,11,6,0,17,0
95573,741,464,51,177,182,54,126,253,44,41,277,26,133,87,31,228,49
95585,111,75,4,52,17,2,15,22,31,7,36,8,7,13,8,29,7
95587,91,34,11,21,2,0,10,9,15,0,57,14,18,25,0,39,18
95589,367,217,12,106,68,31,52,126,18,21,150,13,39,70,28,127,23
95595,97,71,11,33,19,8,23,32,10,6,26,2,14,7,3,26,0
95601,82,63,16,22,23,2,14,26,6,17,19,4,6,8,1,10,9
95602,6823,5284,571,2484,1719,510,1611,2664,575,434,1539,124,436,533,446,1289,250
95603,10254,6575,928,3219,1736,692,2184,3116,763,512,3679,525,1187,974,993,3070,609
95605,4124,2854,660,1372,628,194,1132,857,429,436,1270,153,368,521,228,1036,234
95606,162,102,11,39,39,13,34,49,12,7,60,8,23,23,6,40,20
95607,87,74,5,40,29,0,25,38,0,11,13,0,0,7,6,13,0
95608,24784,15511,2690,7392,3959,1470,4858,6648,2453,1552,9273,2028,3025,2474,1746,7615,1658
95610,16934,11078,2578,5371,2481,648,3998,4195,1585,1300,5856,1842,2064,1253,697,4381,1475
95612,392,318,38,187,60,33,141,122,36,19,74,21,29,6,18,43,31
95613,22,0,0,0,0,0,0,0,0,0,22,0,14,0,8,22,0
95614,1412,1171,117,633,337,84,462,599,55,55,241,39,84,109,9,205,36
95615,240,182,3,99,60,20,79,76,0,27,58,0,10,30,18,58,0
95616,24669,12598,3029,6752,2314,503,5313,4613,1601,1071,12071,7883,2195,1161,832,6043,6028
95618,272,207,0,62,115,30,49,154,4,0,65,0,5,23,37,47,18
95619,1725,1220,243,623,256,98,536,461,126,97,505,45,136,161,163,417,88
95620,5791,4763,1302,2414,893,154,2323,1694,454,292,1028,253,288,298,189,767,261
95621,16578,10785,2613,5046,2306,820,3541,4257,1738,1249,5793,1078,1700,1693,1322,4544,1249
95623,1614,1134,112,459,386,177,286,657,88,103,480,22,135,136,187,384,96
95624,12472,10374,1971,6002,2071,330,4752,3751,1082,789,2098,375,848,562,313,1644,454
95625,43,7,0,7,0,0,0,7,0,0,36,4,13,19,0,32,4
95626,1935,1672,268,982,356,66,602,623,205,242,263,45,94,89,35,209,54
95627,960,692,150,303,186,53,217,285,85,105,268,20,62,123,63,225,43
95628,16039,11397,1509,5429,3665,794,3626,5545,1282,944,4642,927,1903,1267,545,3645,997
95629,369,250,28,104,100,18,52,130,33,35,119,9,43,51,16,69,50
95630,17192,12520,2472,7327,2120,601,5711,5060,1183,566,4672,1158,1751,957,806,3734,938
95631,2216,1697,193,906,458,140,526,908,177,86,519,44,199,206,70,402,117
95632,7458,6210,1130,3507,1256,317,2872,2070,752,516,1248,195,323,438,292,1004,244
95633,928,747,38,410,273,26,208,465,64,10,181,5,66,76,34,144,37
95634,1041,786,118,391,237,40,223,390,116,57,255,38,115,60,42,195,60
95635,401,281,6,154,101,20,80,183,9,9,120,18,51,26,25,107,13
95636,292,205,26,87,53,39,67,115,7,16,87,0,65,22,0,78,9
95637,70,39,3,16,20,0,19,20,0,0,31,0,16,10,5,21,10
95638,604,488,21,318,127,22,190,244,37,17,116,8,81,18,9,68,48
95639,81,53,14,13,13,13,11,11,0,31,28,10,9,9,0,18,10
95640,2004,1499,201,865,344,89,474,685,233,107,505,82,168,184,71,394,111
95641,895,566,70,226,221,49,142,323,51,50,329,27,131,102,69,262,67
95642,2642,1754,250,662,601,241,431,1012,198,113,888,114,203,338,233,797,91
95645,606,474,97,261,101,15,241,170,41,22,132,22,45,35,30,122,10
95646,26,8,0,6,2,0,2,4,2,0,18,14,4,0,0,0,18
95648,5194,4062,832,1884,1104,242,1478,1739,552,293,1132,148,452,298,234,912,220
95650,4076,3275,354,1684,998,239,1239,1470,305,261,801,79,272,308,142,633,168
95651,163,91,6,61,24,0,20,51,20,0,72,8,27,22,15,49,23
95653,151,118,22,73,23,0,48,40,24,6,33,10,15,8,0,23,10
95655,328,106,25,49,32,0,17,0,57,32,222,8,186,28,0,222,0
95658,2397,1835,154,864,694,123,670,1007,76,82,562,50,174,218,120,470,92
95659,298,207,24,101,59,23,77,96,13,21,91,13,37,21,20,74,17
95660,10604,7921,2091,3627,1573,630,2664,2512,1678,1067,2683,503,1007,879,294,2067,616
95661,9717,6698,1155,3618,1547,378,2608,2890,814,386,3019,685,858,682,794,2483,536
95662,11665,8660,1477,4674,2005,504,3113,3603,1191,753,3005,638,1069,857,441,2260,745
95663,655,510,35,259,156,60,156,317,25,12,145,7,72,35,31,110,35
95664,379,306,36,152,82,36,75,202,21,8,73,0,34,30,9,47,26
95665,1811,1382,184,546,491,161,303,839,174,66,429,30,128,160,111,409,20
95666,2412,1627,135,572,715,205,292,1123,156,56,785,92,284,244,165,608,177
95667,13548,9652,1139,4918,2676,919,2903,4990,1123,636,3896,436,1360,1229,871,3141,755
95668,313,224,14,120,72,18,84,110,8,22,89,9,36,35,9,68,21
95669,864,644,62,322,229,31,183,315,58,88,220,16,44,98,62,177,43
95670,18799,12986,3354,5864,3069,699,4419,5151,2046,1370,5813,1499,2147,1608,559,4621,1192
95672,1296,1079,90,680,270,39,492,470,67,50,217,3,98,70,46,143,74
95673,4600,3502,636,1803,864,199,1093,1411,560,438,1098,133,397,390,178,860,238
95674,307,248,27,128,79,14,102,111,27,8,59,9,10,13,27,47,12
95675,139,80,4,70,0,6,35,11,22,12,59,0,26,26,7,59,0
95676,98,74,24,41,5,4,27,25,13,9,24,13,7,0,4,7,17
95677,8062,5682,989,3222,1080,391,2170,2259,757,496,2380,512,710,755,403,1851,529
95678,11758,8029,1969,3995,1533,532,3007,2904,1230,888,3729,1057,1406,762,504,2969,760
95681,451,358,30,238,84,6,152,130,39,37,93,10,37,23,23,65,28
95682,9004,7093,1179,3693,1779,442,2565,3226,843,459,1911,348,649,557,357,1468,443
95683,1966,1547,116,676,595,160,433,986,52,76,419,25,139,150,105,362,57
95684,1088,846,44,431,314,57,277,487,50,32,242,5,108,93,36,147,95
95685,1932,1365,153,587,491,134,368,750,161,86,567,95,127,179,166,476,91
95686,361,294,60,145,72,17,127,97,51,19,67,9,17,18,23,45,22
95687,19267,14201,3428,7699,2446,628,6107,5004,2009,1081,5066,1223,1736,1277,830,3910,1156
95688,11306,8833,1574,4728,2090,441,3255,3754,1204,620,2473,459,981,664,369,1912,561
95689,568,463,36,202,192,33,166,280,10,7,105,21,32,26,26,89,16
95690,799,518,117,242,127,32,169,247,63,39,281,32,65,138,46,256,25
95691,7360,4884,1061,2383,1103,337,1590,1757,979,558,2476,414,877,821,364,2067,409
95692,1236,940,175,449,236,80,357,384,117,82,296,25,82,117,72,248,48
95693,1977,1637,111,938,526,62,601,828,92,116,340,51,174,72,43,255,85
95694,2662,2221,353,1251,524,93,1000,765,287,169,441,80,134,135,92,352,89
95695,13695,9806,2278,4651,2145,732,3792,3702,1337,975,3889,712,1178,1010,989,3148,741
95701,300,221,42,127,34,18,89,108,14,10,79,12,36,27,4,72,7
95703,593,423,22,179,159,63,102,281,21,19,170,36,63,45,26,122,48
95709,1923,1446,138,636,524,148,388,856,144,58,477,61,135,182,99,392,85
95713,3331,2413,291,1389,600,133,929,1045,321,118,918,115,320,298,185,719,199
95714,130,94,16,44,26,8,40,38,9,7,36,4,16,2,14,34,2
95715,72,58,9,31,18,0,21,34,3,0,14,4,10,0,0,14,0
95717,151,97,11,44,34,8,17,48,22,10,54,13,19,15,7,34,20
95720,80,34,11,15,5,3,4,21,9,0,46,4,13,22,7,43,3
95721,0,0,0,0,0,0,0,0,0,0,0,0,0,0,0,0,0
95722,1361,1133,99,609,334,91,432,574,62,65,228,0,93,92,43,184,44
95726,3354,2488,336,1151,802,199,761,1362,241,124,866,101,305,295,165,687,179
95728,35,17,0,0,17,0,0,17,0,0,18,0,0,18,0,18,0
95735,5,5,3,0,0,2,0,3,0,2,0,0,0,0,0,0,0
95736,5,5,0,0,0,5,0,5,0,0,0,0,0,0,0,0,0
95742,88,65,0,29,36,0,0,44,0,21,23,0,12,5,6,17,6
95746,6833,6018,563,3786,1456,213,2979,2445,411,183,815,30,301,361,123,707,108
95747,9941,7799,1215,3395,2379,810,2832,4041,599,327,2142,248,499,969,426,1806,336
95758,15392,12251,2901,7553,1593,204,6255,3781,1479,736,3141,764,1609,619,149,2339,802
95762,7153,6359,698,4124,1356,181,3357,2507,321,174,794,72,341,256,125,681,113
95765,5397,4532,1048,2663,739,82,2381,1629,384,138,865,289,373,148,55,631,234
95776,4437,3577,1101,1840,519,117,1752,1109,473,243,860,183,296,205,176,671,189
95814,8552,2032,623,851,364,194,352,765,631,284,6520,2265,2140,1233,882,5718,802
95815,9293,5514,1663,2520,979,352,1747,1371,1331,1065,3779,932,1467,988,392,2909,870
95816,9372,2442,810,1036,427,169,563,1145,416,318,6930,3142,2362,894,532,5403,1527
95817,5904,3126,1085,1348,462,231,835,766,949,576,2778,725,1021,708,324,2155,623
95818,10019,5114,1198,2440,1047,429,1312,2039,1080,683,4905,1269,1893,936,807,3845,1060
95819,7600,3852,671,1870,757,554,1116,1967,407,362,3748,924,1259,708,857,2998,750
95820,12671,8278,2232,3659,1587,800,2659,2464,1760,1395,4393,711,1795,1059,828,3453,940
95821,15520,8836,2159,3679,2087,911,2493,3394,1764,1185,6684,1424,2293,1747,1220,5558,1126
95822,15788,10723,2185,4611,2734,1193,3102,3905,1963,1753,5065,732,1362,1616,1355,4330,735
95823,22456,17097,5163,8389,2966,579,6372,4675,4027,2023,5359,1060,1993,1549,757,4400,959
95824,8855,6687,2137,2784,1313,453,2363,1807,1576,941,2168,276,880,644,368,1741,427
95825,15272,6078,2225,2341,973,539,1500,2333,1335,910,9194,3715,2751,1782,946,6978,2216
95826,15902,9237,2657,3999,2033,548,2832,3922,1278,1205,6665,2735,2052,1258,620,4531,2134
95827,7162,4689,1116,2335,1091,147,1453,1650,857,729,2473,726,880,636,231,1740,733
95828,16681,13224,2896,7105,2492,731,5254,4102,2384,1484,3457,484,1355,958,660,2714,743
95829,3665,3058,566,1817,533,142,1367,1105,393,193,607,131,277,146,53,476,131
95830,202,165,34,90,30,11,80,63,13,9,37,7,15,9,6,37,0
95831,17978,11657,2008,5737,3072,840,3780,5344,1512,1021,6321,1597,2337,1629,758,5033,1288
95832,2129,1798,437,792,504,65,736,481,304,277,331,53,113,128,37,286,45
95833,12191,7354,2285,3607,1168,294,2573,2371,1580,830,4837,1653,2175,780,229,3596,1241
95834,3213,2050,656,1039,308,47,726,536,564,224,1163,407,539,172,45,835,328
95835,282,187,43,101,37,6,76,101,6,4,95,44,45,6,0,52,43
95836,0,0,0,0,0,0,0,0,0,0,0,0,0,0,0,0,0
95837,92,81,7,18,34,22,8,58,1,14,11,0,3,6,2,11,0
95838,10200,7675,2074,3921,1360,320,2742,1838,1982,1113,2525,469,1047,676,333,1883,642
95841,8797,5260,1455,2351,1180,274,1406,1734,1380,740,3537,1138,1278,761,360,2708,829
95842,11383,7886,2502,3715,1405,264,2655,2455,1803,973,3497,996,1353,871,277,2610,887
95843,11764,9384,2616,5531,1081,156,4650,2669,1434,631,2380,710,1158,445,67,1717,663
95864,10009,6653,785,2956,1899,1013,2007,3330,661,655,3356,436,1007,1033,880,2776,580
95901,12891,9146,2378,4331,1958,479,3407,3017,1733,989,3745,766,1220,1147,612,2929,816
95903,1601,1424,899,525,0,0,967,337,120,0,177,155,22,0,0,132,45
95910,72,37,0,18,19,0,12,25,0,0,35,0,24,4,7,35,0
95912,1474,1170,278,524,311,57,457,447,145,121,304,19,107,133,45,234,70
95913,80,74,18,38,18,0,26,30,18,0,6,0,0,6,0,6,0
95914,258,173,11,81,63,18,46,95,20,12,85,2,37,30,16,67,18
95916,565,355,32,161,141,21,73,196,58,28,210,11,66,74,59,168,42
95917,1045,829,162,430,196,41,365,314,97,53,216,25,54,58,79,183,33
95918,543,454,16,204,190,44,64,300,53,37,89,0,18,61,10,72,17
95919,588,401,69,153,149,30,82,219,54,46,187,27,45,71,44,159,28
95920,101,67,18,27,20,2,24,26,8,9,34,4,16,8,6,27,7
95922,252,142,17,83,39,3,53,61,22,6,110,18,51,23,18,87,23
95923,42,18,0,5,8,5,0,13,5,0,24,0,12,12,0,24,0
95925,136,71,14,29,17,11,32,28,11,0,65,9,41,15,0,50,15
95926,14547,7306,1760,3491,1463,592,2409,2921,1342,634,7241,3977,1463,1057,744,4360,2881
95928,12564,6737,1753,3384,1156,444,2430,2448,1225,634,5827,3216,1407,690,514,3362,2465
95930,133,111,24,26,52,9,28,67,0,16,22,0,8,0,14,22,0
95932,2659,1881,407,916,446,112,744,676,253,208,778,136,207,234,201,649,129
95934,79,54,14,12,18,10,17,31,6,0,25,0,8,7,10,25,0
95935,276,201,35,73,73,20,20,98,37,46,75,8,23,33,11,75,0
95936,178,113,6,43,37,27,23,68,17,5,65,9,25,27,4,56,9
95937,0,0,0,0,0,0,0,0,0,0,0,0,0,0,0,0,0
95938,1276,938,129,524,228,57,370,394,98,76,338,66,96,73,103,301,37
95939,179,117,25,48,34,10,33,60,14,10,62,1,14,21,26,54,8
95941,206,93,0,29,51,13,9,72,0,12,113,0,54,30,29,82,31
95942,587,476,40,238,157,41,121,293,38,24,111,7,64,32,8,84,27
95943,465,355,68,177,96,14,157,134,41,23,110,20,33,19,38,85,25
95944,22,22,0,16,6,0,6,16,0,0,0,0,0,0,0,0,0
95945,10220,6303,959,3028,1610,706,1808,2677,1143,675,3917,418,1298,1086,1115,3182,735
95946,3958,3100,174,1180,1227,519,673,1992,278,157,858,75,219,287,277,681,177
95947,833,566,89,236,191,50,172,284,41,69,267,18,107,101,41,245,22
95948,3336,2486,484,1110,643,249,910,1026,287,263,850,97,217,277,259,737,113
95949,7057,5377,324,2383,2039,631,1466,3244,307,360,1680,68,557,596,459,1370,310
95950,157,110,29,51,24,6,66,24,14,6,47,6,12,19,10,41,6
95951,524,425,132,179,96,18,239,107,29,50,99,19,37,25,18,49,50
95953,2572,2054,423,1055,471,105,1000,662,232,160,518,53,138,172,155,469,49
95954,4597,3353,361,1233,1188,571,765,2032,388,168,1244,78,355,456,355,994,250
95955,396,309,77,133,78,21,142,105,44,18,87,16,30,18,23,77,10
95956,138,94,3,45,38,8,26,62,6,0,44,0,7,37,0,44,0
95957,279,194,17,101,59,17,63,92,20,19,85,20,20,22,23,77,8
95959,6955,4957,424,2596,1539,398,1572,2476,553,356,1998,181,865,663,289,1533,465
95960,238,145,37,58,47,3,36,63,20,26,93,7,44,25,17,79,14
95961,2069,1534,295,710,436,93,498,637,203,196,535,45,147,217,126,434,101
95962,600,424,23,233,123,45,81,258,69,16,176,13,107,24,32,162,14
95963,4882,3614,744,1715,878,277,1390,1468,523,233,1268,117,411,360,380,1067,201
95965,6510,4432,1032,1920,1124,356,1250,1747,990,445,2078,337,622,737,382,1705,373
95966,10882,7514,1001,3214,2406,893,2076,3810,909,719,3368,306,916,1162,984,2786,582
95968,393,291,69,102,96,24,109,137,25,20,102,21,25,32,24,78,24
95969,12348,7787,956,3275,2197,1359,2039,4104,996,648,4561,407,1013,1481,1660,3891,670
95970,186,154,16,78,50,10,67,77,10,0,32,0,7,17,8,27,5
95971,2689,1724,251,881,487,105,596,898,170,60,965,253,333,233,146,817,148
95972,44,23,0,21,2,0,3,12,8,0,21,0,0,11,10,21,0
95973,10579,6914,1436,3611,1384,483,2697,2756,1012,449,3665,903,1231,750,781,2872,793
95974,24,19,0,13,0,6,5,14,0,0,5,0,0,5,0,5,0
95975,646,385,42,210,80,53,133,217,14,21,261,16,103,70,72,194,67
95977,361,311,55,155,91,10,82,156,37,36,50,7,21,13,9,43,7
95978,8,0,0,0,0,0,0,0,0,0,8,0,0,8,0,8,0
95979,302,200,29,69,77,25,51,118,16,15,102,8,32,39,23,94,8
95981,34,20,0,20,0,0,0,0,20,0,14,0,8,6,0,14,0
95982,1028,870,148,476,204,42,415,299,107,49,158,21,38,51,48,119,39
95983,256,161,0,88,73,0,22,105,19,15,95,6,25,20,44,58,37
95984,26,13,0,5,8,0,0,13,0,0,13,0,13,0,0,0,13
95986,54,17,0,9,8,0,5,7,5,0,37,5,21,8,3,34,3
95987,1246,986,239,483,197,67,472,369,93,52,260,13,107,79,61,241,19
95988,3118,2237,502,1071,523,141,839,869,350,179,881,153,250,232,246,747,134
95991,12476,8761,2349,3917,1933,562,3173,3228,1475,885,3715,738,1328,1012,637,3051,664
95993,9499,7435,1291,3604,2162,378,2925,3236,698,576,2064,369,692,604,399,1760,304
96001,12723,8423,1454,4014,2295,660,2601,3771,1312,739,4300,750,1390,1322,838,3488,812
96002,11265,7974,1684,3636,1957,697,2586,3288,1577,523,3291,654,964,980,693,2585,706
96003,16586,11040,2212,5154,2705,969,3529,5074,1629,808,5546,1164,1613,1656,1113,4453,1093
96006,284,194,31,71,83,9,56,115,13,10,90,13,26,26,25,70,20
96007,8025,5716,1124,2500,1607,485,1675,2605,905,531,2309,260,723,874,452,1943,366
96008,347,252,22,138,83,9,84,121,33,14,95,7,38,33,17,83,12
96009,202,157,36,77,29,15,67,51,26,13,45,9,12,18,6,42,3
96010,94,68,5,30,25,8,16,35,15,2,26,1,12,8,5,20,6
96011,99,50,5,24,18,3,19,15,12,4,49,3,25,15,6,38,11
96013,1843,1254,254,529,378,93,373,592,173,116,589,33,191,165,200,498,91
96014,146,110,5,47,46,12,40,65,0,5,36,0,12,0,24,36,0
96015,89,47,5,0,42,0,5,33,0,9,42,0,0,39,3,42,0
96016,162,145,23,46,67,9,40,99,6,0,17,0,0,17,0,8,9
96017,93,59,14,24,13,8,12,24,17,6,34,0,15,10,9,30,4
96019,2406,1644,329,790,396,129,469,604,322,249,762,99,292,248,123,577,185
96020,1098,784,87,340,286,71,219,423,99,43,314,49,107,99,59,268,46
96021,5010,3560,763,1563,941,293,1247,1384,577,352,1450,209,375,497,369,1164,286
96022,4586,3592,480,1807,1086,219,1306,1669,347,270,994,99,367,363,165,791,203
96023,464,329,53,140,116,20,84,176,42,27,135,16,37,40,42,121,14
96024,373,245,26,133,69,17,73,110,45,17,128,9,72,28,19,100,28
96025,1174,681,109,302,180,90,165,322,123,71,493,41,191,161,100,404,89
96027,877,615,57,293,207,58,199,304,73,39,262,25,95,73,69,217,45
96028,681,449,58,188,163,40,106,261,66,16,232,19,70,69,74,209,23
96029,30,24,0,17,4,3,12,6,5,1,6,0,0,2,4,6,0
96031,70,35,2,15,16,2,10,20,0,5,35,10,12,11,2,24,11
96032,949,650,81,307,210,52,193,349,64,44,299,8,95,77,119,266,33
96033,143,104,5,62,31,6,19,61,17,7,39,0,18,8,13,28,11
96034,133,103,16,40,30,17,28,56,14,5,30,3,10,12,5,25,5
96035,1140,849,205,374,224,46,335,288,106,120,291,17,85,138,51,218,73
96037,111,79,8,50,14,7,16,51,11,1,32,2,3,19,8,19,13
96038,245,170,39,66,55,10,47,76,39,8,75,0,17,43,15,62,13
96039,548,353,49,170,113,21,96,159,67,31,195,13,72,78,32,160,35
96040,156,91,0,27,42,22,12,64,0,15,65,0,40,25,0,57,8
96041,1085,701,99,339,202,61,185,360,112,44,384,31,133,163,57,322,62
96044,451,309,22,117,123,47,66,189,22,32,142,7,34,64,37,113,29
96046,118,66,0,44,15,7,24,27,8,7,52,7,29,9,7,52,0
96047,341,256,25,124,93,14,70,135,23,28,85,11,22,38,14,68,17
96048,309,216,18,90,92,16,56,119,14,27,93,5,50,32,6,78,15
96050,210,126,14,47,49,16,21,83,14,8,84,3,38,35,8,72,12
96051,541,389,22,170,153,44,84,267,28,10,152,5,65,58,24,119,33
96052,741,528,60,186,246,36,113,321,57,37,213,10,76,100,27,175,38
96054,152,108,11,37,49,11,14,70,10,14,44,3,10,13,18,38,6
96055,1490,1044,173,441,314,116,296,537,104,107,446,68,120,158,100,380,66
96056,585,467,77,207,138,45,195,226,36,10,118,11,45,38,24,114,4
96057,697,476,62,190,176,48,104,268,72,32,221,12,55,77,77,203,18
96058,305,212,52,89,54,17,82,89,28,13,93,12,40,25,16,79,14
96059,236,174,0,50,103,21,21,147,4,2,62,2,16,32,12,49,13
96061,34,27,4,12,6,5,11,16,0,0,7,0,2,5,0,3,4
96062,283,242,26,107,77,32,79,125,12,26,41,5,11,17,8,25,16
96063,59,36,10,9,17,0,11,25,0,0,23,0,13,2,8,20,3
96064,1821,1319,170,594,433,122,379,732,108,100,502,43,174,167,118,425,77
96065,168,105,21,48,30,6,33,41,16,15,63,2,30,27,4,49,14
96067,3204,2017,155,1125,577,160,545,1045,364,63,1187,175,407,332,273,1007,180
96068,50,33,13,4,14,2,8,17,8,0,17,0,9,0,8,17,0
96069,331,243,8,120,91,24,64,144,25,10,88,8,26,50,4,66,22
96071,75,53,3,0,42,8,0,50,3,0,22,0,14,8,0,18,4
96073,1724,1436,66,725,520,125,515,770,73,78,288,14,70,157,47,222,66
96074,41,24,7,4,11,2,9,13,2,0,17,0,12,4,1,14,3
96075,116,72,7,27,28,10,18,47,7,0,44,0,14,15,15,34,10
96076,117,50,5,19,21,5,12,33,0,5,67,4,20,36,7,63,4
96080,10281,7120,1398,3117,1921,684,2231,3236,1105,548,3161,503,863,906,889,2665,496
96084,177,119,11,43,60,5,29,78,5,7,58,5,26,17,10,46,12
96085,40,26,2,13,4,7,11,13,0,2,14,0,6,5,3,7,7
96086,151,91,4,47,26,14,13,68,6,4,60,8,25,15,12,41,19
96087,195,154,16,91,32,15,43,58,22,31,41,0,11,18,12,37,4
96088,1789,1332,104,604,476,148,344,829,107,52,457,39,142,174,102,369,88
96090,142,108,19,38,33,18,32,47,17,12,34,3,8,11,12,32,2
96091,351,233,13,86,110,24,46,168,11,8,118,7,39,50,22,107,11
96092,166,119,49,43,27,0,45,63,5,6,47,5,21,5,16,39,8
96093,1619,1038,167,464,302,105,295,522,163,58,581,55,213,158,155,511,70
96094,2420,1690,314,696,492,188,527,837,210,116,730,131,231,185,183,578,152
96095,0,0,0,0,0,0,0,0,0,0,0,0,0,0,0,0,0
96096,317,223,23,122,66,12,76,119,16,12,94,10,34,32,18,76,18
96097,4041,2542,400,1110,766,266,841,1191,395,115,1499,175,502,358,464,1315,184
96101,2085,1442,170,746,431,95,461,659,208,114,643,83,171,199,190,566,77
96103,885,588,33,235,249,71,131,416,15,26,297,28,81,129,59,230,67
96104,381,249,35,101,85,28,65,138,20,26,132,16,42,42,32,114,18
96105,235,124,23,78,19,4,56,57,11,0,111,0,82,16,13,101,10
96106,45,24,5,0,13,6,12,12,0,0,21,0,7,7,7,21,0
96107,517,368,87,177,59,45,120,148,80,20,149,7,53,49,40,142,7
96108,16,16,0,16,0,0,7,0,9,0,0,0,0,0,0,0,0
96109,433,332,72,128,103,29,93,166,33,40,101,7,35,37,22,92,9
96110,47,33,0,15,8,10,10,21,0,2,14,1,3,9,1,7,7
96112,87,55,11,20,18,6,6,26,17,6,32,5,7,7,13,30,2
96113,374,245,15,130,60,40,91,102,26,26,129,13,57,31,28,106,23
96114,1119,880,109,491,239,41,369,424,45,42,239,35,68,77,59,193,46
96115,68,49,4,31,12,2,12,35,2,0,19,0,7,12,0,15,4
96116,100,60,12,20,28,0,32,28,0,0,40,0,8,24,8,40,0
96117,119,101,10,38,47,6,23,68,7,3,18,4,8,3,3,14,4
96118,733,515,81,249,157,28,183,202,105,25,218,32,53,93,40,206,12
96119,20,18,6,0,12,0,4,12,2,0,2,0,2,0,0,0,2
96120,418,270,28,140,84,18,72,129,35,34,148,15,78,42,13,123,25
96121,232,151,15,88,48,0,50,82,19,0,81,0,50,26,5,65,16
96122,1700,1233,209,589,338,97,410,597,167,59,467,37,152,188,90,411,56
96123,28,14,5,9,0,0,11,3,0,0,14,7,0,7,0,14,0
96124,138,87,17,42,18,10,19,56,7,5,51,13,0,38,0,31,20
96125,165,85,0,21,46,18,19,66,0,0,80,0,37,21,22,50,30
96126,83,59,7,35,12,5,31,28,0,0,24,11,6,0,7,13,11
96128,161,122,29,62,21,10,68,43,11,0,39,3,8,17,11,35,4
96130,5588,3858,871,1956,869,162,1473,1548,607,230,1730,329,568,506,327,1436,294
96132,31,21,0,13,8,0,4,13,2,2,10,0,4,0,6,10,0
96133,48,33,0,18,15,0,0,33,0,0,15,0,15,0,0,15,0
96134,937,661,147,283,157,74,275,287,63,36,276,32,100,77,67,232,44
96136,52,32,7,20,5,0,20,9,3,0,20,0,5,10,5,20,0
96137,1801,1252,129,547,455,121,351,699,153,49,549,66,229,175,79,455,94
96140,770,492,49,316,107,20,167,237,44,44,278,92,142,26,18,152,126
96141,360,209,11,127,52,19,80,116,7,6,151,34,87,19,11,99,52
96142,577,344,60,201,53,30,166,111,40,27,233,74,107,38,14,128,105
96143,1748,916,333,407,161,15,318,314,157,127,832,280,453,79,20,547,285
96145,1662,862,117,471,219,55,298,413,91,60,800,346,239,200,15,461,339
96146,406,195,39,83,62,11,44,95,41,15,211,75,97,39,0,135,76
96148,245,191,56,93,34,8,89,73,8,21,54,6,26,22,0,45,9
96150,13067,8083,1537,4658,1606,282,2839,3242,1366,636,4984,1522,2019,1089,354,3388,1596
96161,5900,4161,759,2506,808,88,1705,1741,513,202,1739,449,866,347,77,1104,635
96701,13782,10279,1561,4422,3309,987,3036,4896,870,1477,3503,941,1561,650,351,2671,832
96703,652,534,84,258,170,22,151,233,92,58,118,24,58,28,8,84,34
96704,2345,1680,199,888,427,166,489,752,224,215,665,67,301,222,75,489,176
96705,632,496,71,242,124,59,185,180,71,60,136,18,27,47,44,125,11
96706,11769,9928,2610,5046,1966,306,4973,2959,943,1053,1841,626,698,367,150,1349,492
96707,7285,6260,1608,3399,1133,120,3074,2067,626,493,1025,305,532,160,28,706,319
96708,3041,2014,352,1176,423,63,833,657,333,191,1027,247,517,183,80,673,354
96710,126,108,0,50,44,14,26,65,0,17,18,0,18,0,0,12,6
96712,2607,1759,289,974,408,88,700,635,192,232,848,275,340,121,112,540,308
96713,523,365,52,178,98,37,143,135,36,51,158,7,79,60,12,112,46
96714,838,509,75,277,144,13,229,190,55,35,329,40,183,59,47,230,99
96716,816,645,99,340,125,81,277,240,71,57,171,14,39,86,32,143,28
96717,1339,1037,199,499,284,55,451,296,141,149,302,48,130,109,15,215,87
96718,0,0,0,0,0,0,0,0,0,0,0,0,0,0,0,0,0
96719,585,432,43,214,140,35,158,161,45,68,153,41,46,30,36,124,29
96720,15366,10771,1439,4937,3252,1143,3015,4635,1669,1452,4595,761,1456,1380,998,3701,894
96722,502,393,29,198,119,47,77,225,56,35,109,25,62,22,0,95,14
96725,1047,703,103,397,139,64,230,272,116,85,344,35,196,96,17,252,92
96727,1558,1135,114,525,343,153,399,473,112,151,423,47,123,160,93,359,64
96728,206,160,26,68,35,31,47,52,27,34,46,7,17,21,1,36,10
96729,305,255,15,112,96,32,92,88,13,62,50,7,13,21,9,35,15
96730,567,392,60,210,92,30,122,189,56,25,175,27,86,45,17,141,34
96731,762,587,77,293,163,54,238,220,57,72,175,14,55,66,40,162,13
96732,5707,4339,716,1768,1322,533,1415,1836,519,569,1368,82,351,452,483,1163,205
96734,16191,13003,2624,6104,3285,990,5014,5588,1114,1287,3188,629,1231,844,484,2253,935
96737,897,527,58,271,181,17,127,283,70,47,370,15,168,154,33,308,62
96738,1903,1324,280,748,234,62,517,486,255,66,579,139,297,110,33,383,196
96740,9369,6415,975,3447,1493,500,2205,2833,797,580,2954,458,1217,992,287,2100,854
96741,2236,1583,200,800,416,167,549,739,160,135,653,95,253,202,103,455,198
96742,132,14,0,0,14,0,0,14,0,0,118,15,29,59,15,118,0
96743,2959,2145,271,1179,546,149,739,878,310,218,814,175,358,210,71,569,245
96744,16909,13867,1648,6552,4561,1106,4605,6288,1205,1769,3042,539,1209,737,557,2317,725
96746,5592,4064,679,2161,962,262,1602,1449,598,415,1528,199,805,368,156,1180,348
96747,198,150,11,70,43,26,49,60,11,30,48,5,14,22,7,37,11
96748,1540,1128,205,479,343,101,350,446,196,136,412,35,119,153,105,356,56
96749,3828,2862,521,1589,614,138,1079,1054,416,313,966,128,405,277,156,757,209
96750,945,645,74,318,186,67,183,279,84,99,300,42,125,79,54,236,64
96751,106,56,0,17,22,17,0,18,12,26,50,2,23,16,9,35,15
96752,980,740,81,325,234,100,218,355,91,76,240,29,88,85,38,210,30
96753,8687,5373,1004,2971,1106,292,1728,2423,768,454,3314,821,1577,677,239,2227,1087
96754,733,493,71,301,75,46,186,151,106,50,240,59,116,37,28,178,62
96755,962,719,100,330,202,87,236,314,83,86,243,13,112,71,47,193,50
96756,1961,1402,201,650,375,176,411,662,177,152,559,75,234,141,109,433,126
96757,264,225,27,100,58,40,74,102,26,23,39,2,7,15,15,36,3
96759,125,97,7,49,33,8,53,44,0,0,28,17,0,0,11,17,11
96760,826,555,94,287,139,35,201,194,80,80,271,16,169,56,30,219,52
96761,6271,4023,549,2056,1132,286,1387,1836,351,449,2248,603,1001,470,174,1406,842
96762,997,812,208,369,193,42,420,238,74,80,185,80,37,49,19,102,83
96763,1159,797,149,324,208,116,277,338,100,82,362,71,135,92,64,303,59
96764,273,223,23,105,51,44,57,84,33,49,50,0,15,22,13,40,10
96766,3990,2856,364,1362,826,304,932,1236,417,271,1134,163,275,371,325,923,211
96768,5329,4015,626,2202,1026,161,1435,1585,648,347,1314,229,684,266,135,881,433
96769,158,127,28,55,26,18,60,40,14,13,31,0,10,19,2,19,12
96770,200,152,46,51,49,6,49,54,38,11,48,9,29,10,0,46,2
96771,1707,1153,192,686,192,83,474,420,172,87,554,16,351,129,58,484,70
96772,668,453,49,214,131,59,158,212,63,20,215,7,98,73,37,166,49
96773,62,47,8,18,14,7,7,20,13,7,15,0,7,8,0,15,0
96774,50,42,0,23,14,5,16,19,0,7,8,0,0,0,8,8,0
96776,482,352,33,184,101,34,128,151,34,39,130,6,71,47,6,106,24
96777,491,372,42,169,99,62,123,161,37,51,119,4,34,34,47,92,27
96778,3792,2556,438,1312,641,165,821,962,506,267,1236,106,563,429,138,951,285
96779,895,629,77,352,159,41,238,224,68,99,266,62,105,62,37,166,100
96780,187,131,7,97,13,14,66,59,6,0,56,11,32,0,13,48,8
96781,564,410,44,142,147,77,110,188,40,72,154,31,48,31,44,127,27
96782,10971,9044,1164,3326,3676,878,2463,4505,540,1536,1927,351,565,673,338,1626,301
96783,667,485,92,178,145,70,105,217,97,66,182,16,69,56,41,156,26
96785,1080,641,75,385,129,52,195,269,122,55,439,63,207,136,33,322,117
96786,11235,9576,4263,3130,1472,711,4699,2991,994,892,1659,300,551,486,322,1370,289
96789,14941,12154,2163,7073,2621,297,5571,4662,1018,903,2787,836,1180,560,211,2108,679
96790,2545,1741,146,1030,423,142,587,784,192,178,804,98,309,300,97,595,209
96791,2405,1783,274,761,515,233,465,863,213,242,622,179,258,117,68,475,147
96792,10560,8926,1752,4511,2246,417,2967,2716,1803,1440,1634,236,757,483,158,1174,460
96793,7095,5109,796,2600,1178,535,1849,1910,705,645,1986,360,840,482,304,1532,454
96795,2317,2004,240,957,622,185,597,764,225,418,313,44,143,76,50,214,99
96796,782,565,74,267,156,68,166,245,82,72,217,18,69,63,67,174,43
96797,17253,14025,2588,7031,3597,809,5463,5597,1439,1526,3228,1084,1248,670,226,2357,871
96813,9105,4424,720,1955,1184,565,1082,1876,570,896,4681,1208,1480,1219,774,3842,839
96814,7301,3036,680,1270,734,352,632,1496,372,536,4265,1051,1592,1072,550,3585,680
96815,14683,6000,933,2413,1756,898,1172,3429,520,879,8683,2216,3186,2037,1244,6955,1728
96816,17523,12181,1171,4623,3720,2667,2997,5660,985,2539,5342,1172,1764,1163,1243,3867,1475
96817,18418,12066,1446,5070,3621,1929,3348,4996,1162,2560,6352,843,1996,2052,1461,5346,1006
96818,16692,13715,4761,6393,2058,503,6602,4811,1313,989,2977,917,1281,656,123,2240,737
96819,11524,9745,1762,3920,2733,1330,3146,3719,1097,1783,1779,239,556,626,358,1386,393
96821,6355,5134,195,2281,1819,839,1592,2766,185,591,1221,217,354,314,336,859,362
96822,18463,10441,1427,4424,2962,1628,2615,5041,1019,1766,8022,2324,2898,1687,1113,6207,1815
96825,9642,7812,599,3885,2806,522,2604,3970,428,810,1830,333,620,509,368,1338,492
96826,15010,7060,1531,3231,1639,659,1788,2938,944,1390,7950,2237,2575,1858,1280,6479,1471
96862,0,0,0,0,0,0,0,0,0,0,0,0,0,0,0,0,0
96863,0,0,0,0,0,0,0,0,0,0,0,0,0,0,0,0,0
97001,73,51,8,18,17,8,8,41,0,2,22,2,9,6,5,18,4
97002,2152,1649,175,834,495,145,527,952,85,85,503,77,242,115,69,417,86
97004,1552,1265,129,731,368,37,468,628,83,86,287,17,95,135,40,213,74
97005,10386,5572,2120,2344,765,343,2012,1832,1023,705,4814,1341,1680,1063,730,3797,1017
97006,19206,12860,3964,6676,1849,371,5719,4712,1576,853,6346,3014,2085,901,346,4509,1837
97007,19667,14697,3690,8226,2394,387,6678,5546,1632,841,4970,1798,1926,771,475,3797,1173
97008,10908,7112,1673,3675,1383,381,2739,2862,956,555,3796,1127,1343,912,414,2949,847
97009,4566,3742,356,1954,1269,163,1267,1985,250,240,824,84,298,309,133,644,180
97011,373,212,43,101,56,12,90,64,35,23,161,32,85,31,13,112,49
97013,6876,5247,1000,2649,1272,326,2094,2237,563,353,1629,258,449,490,432,1315,314
97014,502,375,84,189,90,12,139,164,46,26,127,20,59,32,16,103,24
97015,8873,6474,1528,3506,1193,247,2575,2727,736,436,2399,764,982,439,214,1870,529
97016,2325,1688,231,844,487,126,541,884,181,82,637,48,219,212,158,532,105
97017,891,707,78,447,160,22,290,284,86,47,184,28,108,22,26,108,76
97018,591,453,57,235,128,33,170,239,25,19,138,20,43,45,30,92,46
97019,1010,788,85,497,180,26,279,414,63,32,222,40,89,54,39,161,61
97020,32,23,14,9,0,0,7,9,4,3,9,0,2,7,0,4,5
97021,411,290,32,150,76,32,97,135,48,10,121,11,34,54,22,104,17
97022,1202,1011,116,587,228,80,416,430,70,95,191,3,91,84,13,120,71
97023,3445,2570,339,1418,701,112,881,1235,264,190,875,108,326,287,154,677,198
97024,3251,2204,729,978,394,103,758,920,372,154,1047,216,442,280,109,774,273
97026,889,746,239,315,156,36,302,297,79,68,143,11,58,47,27,109,34
97027,4437,3292,655,1586,880,171,1196,1394,401,301,1145,282,287,346,230,851,294
97028,120,85,23,43,19,0,34,38,0,13,35,8,15,12,0,27,8
97029,137,97,20,44,19,14,43,37,9,8,40,1,9,15,15,38,2
97030,12556,7952,2234,3666,1561,491,2709,3124,1372,747,4604,1475,1335,954,840,3669,935
97031,5985,4270,1006,1966,1028,270,1804,1723,451,292,1715,288,650,390,387,1406,309
97032,1382,1083,230,557,215,81,469,366,131,117,299,59,115,77,48,229,70
97033,35,21,0,5,12,4,5,16,0,0,14,6,0,8,0,11,3
97034,7551,5488,399,3170,1544,375,2243,2657,350,238,2063,326,758,574,405,1716,347
97035,10319,6460,951,3758,1441,310,2592,2853,620,395,3859,1126,1331,876,526,3043,816
97037,437,301,29,135,111,26,70,178,37,16,136,15,60,32,29,123,13
97038,4475,3454,841,1647,789,177,1417,1461,344,232,1021,145,388,248,240,789,232
97039,184,135,17,73,34,11,51,64,16,4,49,8,20,15,6,47,2
97040,386,281,69,125,64,23,92,143,27,19,105,12,53,24,16,75,30
97041,842,662,77,369,162,54,198,339,90,35,180,21,75,35,49,145,35
97042,1078,844,63,441,275,65,269,523,14,38,234,20,119,54,41,176,58
97045,16340,12435,2450,6542,2775,668,4484,5714,1343,894,3905,868,1441,917,679,2978,927
97048,2463,1881,362,877,556,86,619,950,194,118,582,82,244,141,115,482,100
97049,790,492,77,315,94,6,210,227,44,11,298,105,127,39,27,222,76
97050,189,119,10,54,39,16,25,68,18,8,70,9,20,24,17,67,3
97051,4857,3430,1015,1586,583,246,1399,1300,500,231,1427,299,514,311,303,1150,277
97053,1215,994,127,506,300,61,340,574,64,16,221,12,65,75,69,169,52
97054,458,399,35,261,89,14,158,174,43,24,59,0,27,19,13,36,23
97055,4910,3754,656,2080,902,116,1393,1764,383,214,1156,128,523,249,256,918,238
97056,3671,2650,390,1375,758,127,963,1289,243,155,1021,195,386,268,172,848,173
97058,7452,5133,943,2424,1305,461,1663,2372,697,401,2319,347,653,674,645,2000,319
97060,6113,4727,1127,2616,854,130,1980,1862,558,327,1386,374,569,350,93,972,414
97062,9075,6211,1567,3545,929,170,2939,2193,705,374,2864,1018,1015,523,308,2148,716
97063,446,344,31,107,180,26,44,256,22,22,102,5,18,55,24,90,12
97064,1258,953,228,466,211,48,380,441,107,25,305,32,158,78,37,251,54
97065,256,179,22,80,61,16,65,83,18,13,77,11,30,21,15,64,13
97067,625,415,38,202,132,43,143,225,26,21,210,45,93,51,21,160,50
97068,9033,6991,808,4355,1516,312,2930,3020,690,351,2042,453,790,509,290,1570,472
97070,6538,4280,1103,1893,1001,283,1657,1886,502,235,2258,546,672,518,522,1789,469
97071,7771,5689,1453,2192,1256,788,2200,2380,619,490,2082,229,315,709,829,1721,361
97080,12609,9624,1835,5604,1786,399,4066,4091,900,567,2985,866,1035,622,462,2327,658
97101,1228,1002,188,509,254,51,415,441,83,63,226,9,93,78,46,182,44
97102,90,65,0,37,13,15,24,41,0,0,25,0,0,18,7,25,0
97103,6955,4525,865,2239,1148,273,1497,2075,631,322,2430,415,792,671,552,2083,347
97106,1492,1196,217,659,252,68,516,519,88,73,296,47,104,101,44,236,60
97107,595,409,80,157,131,41,120,218,35,36,186,21,63,68,34,170,16
97108,187,126,9,52,55,10,29,77,15,5,61,0,30,19,12,61,0
97109,210,173,33,93,21,26,73,82,0,18,37,0,29,8,0,32,5
97110,521,302,64,128,85,25,83,159,33,27,219,33,95,67,24,168,51
97111,932,743,161,336,204,42,290,306,87,60,189,34,61,61,33,143,46
97112,1009,721,68,325,236,92,236,390,50,45,288,27,73,112,76,213,75
97113,3773,2954,913,1343,538,160,1371,1149,246,188,819,131,246,265,177,596,223
97114,1413,1154,202,582,291,79,522,411,90,131,259,37,90,56,76,216,43
97115,1206,941,181,487,234,39,379,438,70,54,265,58,99,53,55,204,61
97116,7439,5135,1256,2489,985,405,2196,1957,612,370,2304,557,674,406,667,1844,460
97117,244,181,8,110,43,20,44,116,0,21,63,24,27,5,7,53,10
97118,374,208,17,88,71,32,39,131,22,16,166,15,39,75,37,134,32
97119,1758,1421,162,837,346,76,504,699,132,86,337,45,154,93,45,294,43
97121,434,319,76,183,60,0,145,88,76,10,115,44,32,6,33,98,17
97122,163,134,0,50,65,19,32,83,4,15,29,0,14,10,5,29,0
97123,11888,8883,2739,4301,1536,307,4216,3224,847,596,3005,655,1090,716,544,2312,693
97124,14420,9540,3095,4559,1557,329,3979,4004,1034,523,4880,2259,1543,612,466,3610,1270
97125,29,20,0,15,5,0,9,11,0,0,9,0,0,9,0,9,0
97127,867,674,201,332,122,19,293,235,92,54,193,35,79,55,24,148,45
97128,10700,7599,1910,3300,1658,731,2797,3253,955,594,3101,746,792,811,752,2443,658
97130,217,123,13,38,63,9,15,87,14,7,94,15,16,39,24,81,13
97131,1106,732,76,287,293,76,119,507,66,40,374,20,88,163,103,308,66
97132,8171,6133,1526,3083,1165,359,2585,2567,665,316,2038,418,642,547,431,1587,451
97133,1335,1053,176,527,313,37,441,488,68,56,282,57,88,83,54,228,54
97134,22,6,0,0,6,0,0,6,0,0,16,0,7,5,4,9,7
97135,190,71,5,10,45,11,0,49,10,12,119,19,37,37,26,110,9
97136,917,563,49,166,279,69,87,393,36,47,354,29,106,151,68,292,62
97137,466,330,68,157,84,21,145,119,34,32,136,38,51,33,14,112,24
97138,4130,2573,478,1199,676,220,712,1267,392,202,1557,236,512,421,388,1295,262
97140,5977,4777,1250,2445,938,144,2245,1996,331,205,1200,262,452,322,164,894,306
97141,5065,3492,642,1623,969,258,1155,1688,405,244,1573,312,394,475,392,1306,267
97143,36,23,0,23,0,0,14,9,0,0,13,8,0,5,0,13,0
97144,49,35,0,27,8,0,15,0,6,14,14,0,14,0,0,14,0
97145,199,117,2,48,58,9,19,74,7,17,82,7,28,32,15,56,26
97146,1998,1364,242,588,415,119,444,687,142,91,634,54,241,243,96,519,115
97147,124,74,10,28,30,6,18,44,9,3,50,9,16,19,6,42,8
97148,1030,876,72,514,218,72,375,379,75,47,154,6,84,43,21,134,20
97149,214,140,5,55,70,10,37,99,4,0,74,7,20,37,10,66,8
97201,13789,5125,1031,2224,1378,492,1305,3024,404,392,8664,4048,2420,1324,872,6719,1945
97202,16866,8230,2128,3969,1419,714,2439,3562,1261,968,8636,3265,2800,1503,1068,6003,2633
97203,9985,6432,2000,2946,1141,345,2185,1981,1319,947,3553,798,1390,814,551,2595,958
97204,395,15,7,0,8,0,0,15,0,0,380,101,132,134,13,350,30
97205,4413,472,212,173,60,27,80,300,23,69,3941,1378,1367,758,438,3563,378
97206,18023,10733,2773,5230,1956,774,3567,4279,1611,1276,7290,1900,2748,1354,1288,5223,2067
97209,5249,663,272,262,112,17,45,363,122,133,4586,2279,1393,703,211,3938,648
97210,5887,1780,389,844,406,141,445,995,182,158,4107,2057,1292,530,228,3156,951
97211,11607,6958,1992,3221,1305,440,1921,2496,1541,1000,4649,1325,1960,888,476,3101,1548
97212,9760,5507,951,3125,1114,317,1918,2090,800,699,4253,1404,1702,635,512,2813,1440
97213,12821,7043,1593,3692,1259,499,2286,2761,985,1011,5778,1359,2310,1207,902,4330,1448
97214,11398,3759,1040,1888,610,221,1065,1663,594,437,7639,3769,2650,760,460,5085,2554
97215,6996,3891,804,2029,733,325,1288,1677,477,449,3105,1073,1124,462,446,2011,1094
97216,4954,3203,826,1424,663,290,1055,1243,536,369,1751,391,586,431,343,1336,415
97217,12505,6904,1819,3215,1372,498,2006,2613,1146,1139,5601,1324,2178,1324,775,4076,1525
97218,5215,3229,859,1570,572,228,1016,1195,568,450,1986,445,878,438,225,1462,524
97219,15287,9212,1738,5274,1738,462,3508,3983,1015,706,6075,2033,2318,1072,652,4385,1690
97220,10420,6330,1476,2976,1217,661,2069,2619,942,700,4090,744,1553,949,844,3166,924
97221,4853,3114,378,1709,797,230,1187,1529,219,179,1739,341,606,422,370,1382,357
97222,14532,9004,2162,4089,2047,706,2886,3898,1261,959,5528,1164,1991,1108,1265,4416,1112
97223,17663,11668,2991,5978,2169,530,4747,4687,1407,827,5995,2023,2435,1074,463,4545,1450
97224,11042,6657,1277,3086,1421,873,2375,3246,611,425,4385,869,934,1018,1564,3729,656
97225,9724,5546,959,2635,1453,499,1899,2757,422,468,4178,1314,1451,806,607,3395,783
97227,1523,762,268,325,89,80,219,212,186,145,761,253,303,155,50,566,195
97229,16297,12088,2723,6718,2253,394,5765,4762,1049,512,4209,1475,1572,848,314,3214,995
97230,13720,9020,1770,3878,2334,1038,2761,4110,1247,902,4700,900,1487,1329,984,3777,923
97231,1768,1227,95,683,337,112,403,676,84,64,541,81,288,131,41,399,142
97232,5759,1924,498,948,321,157,550,944,229,201,3835,1458,1219,499,659,3041,794
97233,11987,8131,2695,3568,1490,378,2993,2657,1552,929,3856,899,1523,868,566,2801,1055
97236,11501,8475,1871,4403,1817,384,3192,3095,1260,928,3026,575,1145,825,481,2280,746
97266,14366,9270,2463,4313,1913,581,3341,3452,1397,1080,5096,1233,1828,1155,880,3851,1245
97267,11454,7935,1314,3866,2062,693,2638,3920,792,585,3519,509,1183,1063,764,2894,625
97301,17706,11365,3037,5122,2420,786,4000,4383,1828,1154,6341,1300,2124,1540,1377,5048,1293
97302,15120,9638,1931,4560,2373,774,3153,4493,1287,705,5482,1324,1710,1195,1253,4421,1061
97303,19428,13548,3730,6466,2445,907,4888,5191,2271,1198,5880,1125,2183,1562,1010,4554,1326
97304,8647,5952,952,2882,1496,622,2141,3044,457,310,2695,501,796,695,703,2186,509
97305,12678,8945,2827,3665,1801,652,3132,3663,1365,785,3733,899,1331,1011,492,2825,908
97306,8764,6419,1483,3282,1379,275,2350,2829,896,344,2345,714,720,699,212,1781,564
97321,19238,13347,3380,6090,2909,968,4701,5901,1767,978,5891,1299,1881,1310,1401,4742,1149
97324,426,334,51,180,79,24,126,159,33,16,92,13,35,28,16,72,20
97325,1971,1623,338,789,376,120,575,703,218,127,348,25,114,122,87,288,60
97326,310,228,28,119,60,21,97,127,4,0,82,6,26,38,12,75,7
97327,943,701,112,335,202,52,243,314,81,63,242,35,88,62,57,178,64
97329,22,11,0,6,5,0,0,11,0,0,11,0,0,5,6,11,0
97330,16602,9356,2051,4659,1993,653,3458,4425,931,542,7246,3665,1634,1045,902,4934,2312
97331,3,3,3,0,0,0,3,0,0,0,0,0,0,0,0,0,0
97333,7088,3825,1079,1632,761,353,1215,1889,414,307,3263,1824,826,370,243,1973,1290
97338,6631,4940,936,2350,1255,399,1777,2287,555,321,1691,268,436,483,504,1394,297
97341,1153,685,48,259,288,90,99,468,64,54,468,53,134,220,61,396,72
97342,170,111,27,55,25,4,42,38,21,10,59,9,15,26,9,53,6
97343,171,135,20,92,12,11,30,67,23,15,36,14,0,22,0,30,6
97344,297,209,43,99,52,15,82,71,27,29,88,8,36,34,10,63,25
97345,213,174,11,81,82,0,39,104,15,16,39,13,5,6,15,26,13
97346,364,266,35,123,95,13,79,148,19,20,98,8,29,29,32,83,15
97347,572,404,93,124,177,10,129,182,52,41,168,19,76,58,15,137,31
97348,508,375,84,141,116,34,108,220,23,24,133,18,49,46,20,103,30
97350,60,44,1,27,15,1,19,19,3,3,16,2,4,0,10,14,2
97351,2292,1729,430,867,387,45,670,718,211,130,563,105,226,120,112,398,165
97352,1696,1344,319,663,299,63,529,517,189,109,352,58,143,100,51,282,70
97355,10041,7413,1513,3269,1927,704,2500,3534,911,468,2628,241,907,646,834,2219,409
97357,92,82,14,29,39,0,30,45,7,0,10,0,3,7,0,7,3
97358,951,718,91,361,210,56,206,426,62,24,233,20,63,99,51,161,72
97360,723,539,113,233,142,51,206,244,46,43,184,41,43,54,46,158,26
97361,3740,2271,526,1002,565,178,712,1153,234,172,1469,894,200,201,174,812,657
97362,1341,886,196,413,210,67,391,323,93,79,455,44,103,121,187,399,56
97364,174,135,4,74,30,27,54,76,5,0,39,0,0,25,14,39,0
97365,4581,2794,529,1288,691,286,752,1300,498,244,1787,237,572,659,319,1468,319
97366,436,309,52,119,116,22,77,173,36,23,127,24,40,37,26,99,28
97367,4686,2714,512,1062,828,312,571,1456,479,208,1972,237,615,631,489,1614,358
97368,1391,1006,101,478,340,87,249,616,109,32,385,43,118,150,74,298,87
97370,2989,2329,391,1335,517,86,1005,963,254,107,660,158,240,162,100,507,153
97371,218,172,2,93,59,18,53,76,24,19,46,5,4,21,16,43,3
97374,1807,1497,226,639,542,90,391,887,115,104,310,31,89,123,67,237,73
97375,445,336,50,166,95,25,122,156,23,35,109,24,56,25,4,95,14
97376,482,306,42,125,125,14,69,210,10,17,176,15,58,66,37,160,16
97377,322,261,51,147,54,9,131,111,7,12,61,11,16,17,17,50,11
97378,2133,1617,409,759,352,97,615,738,164,100,516,57,184,188,87,395,121
97380,837,632,97,320,189,26,214,296,79,43,205,15,92,52,46,155,50
97381,4610,3501,627,1741,874,259,1370,1498,440,193,1109,169,288,348,304,925,184
97383,3331,2475,641,1166,471,197,969,969,339,198,856,207,201,261,187,716,140
97385,858,651,96,283,204,68,254,307,55,35,207,35,37,80,55,163,44
97386,4798,3519,644,1487,1076,312,1127,1755,383,254,1279,120,403,358,398,1058,221
97389,507,392,75,166,107,44,139,209,20,24,115,10,68,22,15,79,36
97390,270,167,0,91,69,7,26,112,23,6,103,6,52,39,6,77,26
97391,2021,1497,325,752,368,52,511,621,247,118,524,79,170,158,117,409,115
97392,1705,1329,153,627,423,126,421,706,97,105,376,47,156,97,76,305,71
97394,2163,1390,187,499,504,200,289,775,196,130,773,58,235,332,148,638,135
97396,1132,822,171,388,206,57,275,346,121,80,310,65,101,79,65,273,37
97401,17223,7072,1798,3077,1551,646,2226,3264,1022,560,10151,5485,1966,1250,1450,7145,3006
97402,18619,11011,3308,4870,2009,824,3459,4468,2109,975,7608,2455,2790,1440,923,5409,2199
97403,3676,1636,197,881,410,148,473,752,222,189,2040,1053,462,337,188,1272,768
97404,10917,7968,1583,4016,1883,486,2817,3610,1023,518,2949,660,1091,793,405,2078,871
97405,17950,11444,1711,6036,2751,946,3773,5245,1628,798,6506,1904,2110,1456,1036,4436,2070
97406,63,28,4,8,11,5,9,16,0,3,35,4,12,10,9,35,0
97408,3881,2728,368,1350,652,358,1038,1392,150,148,1153,156,377,386,234,932,221
97410,258,176,14,67,73,22,25,122,11,18,82,4,24,44,10,64,18
97411,2932,1899,163,827,698,211,453,1128,172,146,1033,71,323,401,238,867,166
97412,206,163,21,95,36,11,45,82,26,10,43,5,18,14,6,27,16
97413,391,238,27,81,116,14,61,158,13,6,153,10,62,39,42,139,14
97414,71,55,9,17,19,10,0,38,17,0,16,9,0,0,7,16,0
97415,5970,3949,484,1496,1384,585,951,2468,336,194,2021,142,438,788,653,1717,304
97416,274,214,20,100,82,12,82,105,17,10,60,13,11,30,6,37,23
97417,748,485,78,201,154,52,146,246,56,37,263,20,74,88,81,221,42
97419,493,414,23,197,147,47,102,279,26,7,79,16,21,21,21,70,9
97420,11184,7326,1217,3271,2126,712,2008,3667,1049,602,3858,549,1223,1238,848,3082,776
97423,2884,1992,362,808,640,182,560,1144,191,97,892,68,226,356,242,768,124
97424,6368,4619,800,2192,1277,350,1584,2211,527,297,1749,208,518,538,485,1466,283
97425,50,50,0,19,24,7,12,38,0,0,0,0,0,0,0,0,0
97426,2752,2023,459,1024,414,126,712,917,282,112,729,79,216,278,156,548,181
97427,149,92,21,42,19,10,39,49,4,0,57,19,28,10,0,23,34
97428,60,50,9,21,16,4,14,29,2,5,10,1,1,4,4,8,2
97429,234,180,21,83,66,10,46,106,21,7,54,5,19,16,14,50,4
97430,158,117,20,64,27,6,41,53,15,8,41,1,24,14,2,37,4
97431,929,729,74,397,176,82,284,292,62,91,200,0,126,58,16,147,53
97434,119,91,12,46,27,6,34,38,13,6,28,0,9,19,0,17,11
97435,867,619,94,296,189,40,191,300,75,53,248,24,72,89,63,203,45
97436,345,270,36,103,103,28,70,165,21,14,75,6,23,30,16,64,11
97437,984,849,76,414,304,55,260,472,64,53,135,9,82,24,20,108,27
97438,573,450,93,220,112,25,143,228,43,36,123,21,65,24,13,95,28
97439,6127,3978,339,1260,1620,759,692,2690,347,249,2149,202,525,935,487,1809,340
97441,130,111,40,29,38,4,40,63,4,4,19,19,0,0,0,11,8
97442,808,600,96,284,164,56,162,285,106,47,208,24,69,69,46,168,40
97443,846,628,80,330,184,34,218,343,37,30,218,39,70,85,24,191,27
97444,2140,1410,186,548,502,174,360,830,141,79,730,48,170,351,161,634,96
97446,1477,1159,247,577,250,85,475,479,118,87,318,56,129,87,46,243,75
97447,340,250,40,151,42,17,92,106,43,9,90,14,24,37,15,82,8
97448,4650,3303,618,1672,765,248,1215,1614,309,165,1347,185,491,397,274,1081,266
97449,700,460,30,159,231,40,91,324,31,14,240,10,83,99,48,191,49
97450,251,171,6,82,65,18,39,110,12,10,80,20,18,35,7,72,8
97451,134,101,37,38,26,0,50,45,0,6,33,0,18,7,8,22,11
97452,325,232,35,125,66,6,82,114,22,14,93,28,36,23,6,78,15
97453,378,273,10,128,117,18,62,168,37,6,105,36,23,27,19,68,37
97454,409,285,28,151,104,2,109,154,15,7,124,24,43,39,18,96,28
97455,1078,888,26,528,249,85,290,497,58,43,190,30,32,78,50,132,58
97456,958,726,104,402,176,44,282,363,54,27,232,48,76,63,45,177,55
97457,3832,2805,533,1128,925,219,768,1403,391,243,1027,119,324,336,248,822,205
97458,2103,1494,213,631,525,125,407,777,185,125,609,66,183,196,164,505,104
97459,5937,4046,683,1946,1076,341,1360,2009,470,207,1891,394,503,513,481,1579,312
97461,290,214,29,116,54,15,63,85,40,26,76,21,17,2,36,47,29
97462,1521,1163,133,511,387,132,326,650,109,78,358,73,98,141,46,255,103
97463,1571,1076,126,503,347,100,355,519,95,107,495,41,164,158,132,439,56
97465,1015,594,48,234,233,79,117,378,59,40,421,36,144,160,81,335,86
97466,362,210,19,98,66,27,55,116,14,25,152,15,31,60,46,130,22
97467,2628,1701,225,675,566,235,382,1051,212,56,927,100,192,374,261,823,104
97469,987,732,123,334,213,62,231,343,79,79,255,24,70,112,49,210,45
97470,18379,12930,2218,5762,3784,1166,4086,6609,1383,852,5449,722,1579,1778,1370,4519,930
97473,117,86,14,30,36,6,28,50,6,2,31,6,10,6,9,23,8
97476,123,81,10,39,25,7,39,32,10,0,42,0,0,28,14,42,0
97477,14505,9129,2630,3899,1880,720,2652,3647,1904,926,5376,1583,1686,1259,848,4070,1306
97478,11949,8992,2021,4403,1975,593,3241,3861,1206,684,2957,605,1050,879,423,2180,777
97479,3349,2353,437,956,670,290,709,1225,249,170,996,50,253,426,267,821,175
97480,177,101,16,53,25,7,36,46,16,3,76,19,38,16,3,65,11
97481,214,193,36,99,44,14,106,72,5,10,21,0,10,4,7,17,4
97484,139,83,2,44,33,4,23,49,9,2,56,5,21,21,9,44,12
97486,255,179,24,55,71,29,50,108,7,14,76,9,7,49,11,69,7
97487,2415,1831,262,1042,462,65,658,880,176,117,584,49,229,207,99,421,163
97488,473,318,34,155,112,17,127,146,31,14,155,16,109,16,14,105,50
97489,324,226,14,137,51,24,63,123,13,27,98,0,31,26,41,75,23
97490,103,77,11,29,28,9,26,28,3,20,26,2,14,2,8,19,7
97492,248,186,35,77,58,16,69,111,2,4,62,6,34,17,5,37,25
97493,126,67,5,23,21,18,14,47,0,6,59,0,0,34,25,46,13
97496,2665,1953,431,793,542,187,619,940,236,158,712,109,208,275,120,580,132
97497,686,445,57,182,174,32,107,257,69,12,241,0,160,58,23,148,93
97498,676,394,47,135,165,47,83,253,36,22,282,10,84,105,83,237,45
97499,818,567,110,245,169,43,207,267,51,42,251,20,83,106,42,203,48
97501,14302,9598,2537,4322,2033,706,3280,3941,1618,759,4704,894,1455,1420,935,3808,896
97502,8489,6524,1185,3027,1756,556,2457,3080,596,391,1965,277,689,589,410,1534,431
97503,2748,2207,452,974,688,93,818,891,332,166,541,44,246,189,62,444,97
97504,16771,11374,2001,5068,3033,1272,3638,5657,1406,673,5397,907,1334,1416,1740,4470,927
97520,10347,5705,878,2774,1529,524,1641,2565,1052,447,4642,1493,1474,933,742,3294,1348
97522,233,179,50,75,40,14,58,72,43,6,54,7,16,16,15,42,12
97523,2571,1681,275,710,558,138,414,879,283,105,890,78,332,348,132,712,178
97524,3852,3030,657,1451,738,184,1113,1322,331,264,822,65,329,282,146,636,186
97525,2208,1507,152,751,396,208,392,851,145,119,701,72,235,276,118,573,128
97526,13151,8941,1553,3677,2747,964,2643,4451,1038,809,4210,578,1037,1210,1385,3649,561
97527,11822,8566,1383,3331,2751,1101,2313,4653,973,627,3256,361,1007,1176,712,2677,579
97530,2693,1927,121,1013,629,164,629,1103,117,78,766,86,224,286,170,615,151
97531,177,75,14,16,33,12,18,45,4,8,102,11,40,23,28,83,19
97532,843,655,70,232,306,47,128,482,27,18,188,11,59,83,35,156,32
97534,215,128,0,68,60,0,43,78,7,0,87,0,50,20,17,70,17
97535,1837,1138,192,473,298,175,322,575,161,80,699,82,185,278,154,540,159
97536,406,296,25,123,143,5,53,194,34,15,110,17,27,34,32,94,16
97537,2861,1979,232,904,637,206,437,1187,248,107,882,36,185,333,328,735,147
97538,807,575,76,286,182,31,156,311,80,28,232,31,82,100,19,173,59
97539,1182,819,109,362,283,65,198,486,61,74,363,26,98,140,99,290,73
97540,3054,2023,381,915,486,241,614,903,332,174,1031,254,243,259,275,765,266
97541,497,370,63,107,164,36,83,244,28,15,127,22,32,57,16,105,22
97543,29,14,7,7,0,0,0,7,7,0,15,0,15,0,0,7,8
97544,814,564,56,218,214,76,127,350,37,50,250,38,86,78,48,192,58
97601,8731,5548,1383,2541,1239,385,1865,2330,924,429,3183,855,1040,741,547,2552,631
97603,11211,8026,1709,3432,2237,648,2509,3900,1017,600,3185,551,828,1060,746,2651,534
97604,13,13,7,0,6,0,0,13,0,0,0,0,0,0,0,0,0
97620,41,28,5,19,4,0,13,13,2,0,13,3,3,5,2,13,0
97621,182,101,20,47,22,12,29,43,13,16,81,0,36,23,22,76,5
97622,227,160,19,70,71,0,40,96,17,7,67,0,31,10,26,67,0
97623,781,594,60,299,190,45,200,316,39,39,187,5,83,67,32,160,27
97624,1294,958,90,425,362,81,232,548,85,93,336,17,107,168,44,249,87
97625,31,26,15,0,11,0,9,11,6,0,5,0,5,0,0,0,5
97626,24,20,0,10,10,0,4,16,0,0,4,0,0,0,4,4,0
97627,442,311,22,177,82,30,100,165,38,8,131,9,61,48,13,101,30
97630,2083,1451,229,650,444,128,433,746,174,98,632,73,189,201,169,555,77
97632,378,295,63,140,80,12,109,115,26,45,83,5,26,37,15,74,9
97633,506,366,64,171,81,50,110,204,41,11,140,25,36,38,41,126,14
97634,28,13,0,6,7,0,7,6,0,0,15,0,15,0,0,15,0
97635,160,68,4,21,31,12,6,51,10,1,92,0,42,40,10,68,24
97636,185,139,23,65,32,19,50,78,7,4,46,7,19,12,8,40,6
97637,39,28,5,12,9,2,4,24,0,0,11,3,4,4,0,9,2
97638,152,137,22,68,41,6,55,67,15,0,15,2,7,6,0,10,5
97639,151,105,23,42,31,9,36,69,0,0,46,4,25,17,0,41,5
97640,30,24,8,8,8,0,11,13,0,0,6,0,0,2,4,4,2
97641,429,272,48,116,85,23,79,147,31,15,157,16,55,67,19,131,26
97701,17804,11781,2538,5868,2715,660,4200,5424,1537,620,6023,1823,1998,1325,877,4311,1712
97702,11201,8148,1605,4123,1884,536,3111,3764,907,366,3053,668,1070,744,571,2328,725
97707,2164,1615,155,502,845,113,360,1114,94,47,549,161,209,129,50,437,112
97710,31,21,9,10,2,0,13,8,0,0,10,2,6,2,0,8,2
97711,40,30,3,14,13,0,8,20,2,0,10,0,3,2,5,10,0
97712,18,13,4,4,5,0,0,13,0,0,5,0,3,2,0,3,2
97720,2601,1788,252,879,543,114,533,955,189,111,813,120,268,289,136,679,134
97721,94,68,20,35,9,4,36,30,2,0,26,9,5,6,6,23,3
97722,23,15,5,6,2,2,8,7,0,0,8,3,0,2,3,8,0
97730,102,89,8,37,32,12,32,53,2,2,13,3,5,4,1,13,0
97731,188,153,29,76,36,12,43,77,33,0,35,0,20,15,0,35,0
97732,58,45,5,26,12,2,16,13,13,3,13,7,2,3,1,11,2
97733,300,195,45,81,62,7,59,100,29,7,105,7,28,56,14,83,22
97734,802,638,113,263,198,64,193,344,66,35,164,17,47,71,29,133,31
97735,56,36,2,16,16,2,11,23,0,2,20,5,2,7,6,17,3
97736,33,22,3,15,4,0,12,6,0,4,11,8,0,0,3,11,0
97737,173,128,16,48,36,28,30,61,19,18,45,7,14,14,10,45,0
97738,93,79,22,40,15,2,31,35,8,5,14,0,11,0,3,14,0
97739,3580,2629,344,1021,1038,226,643,1619,233,134,951,73,321,361,196,707,244
97741,3765,2783,800,1198,655,130,1131,1143,358,151,982,211,278,283,210,807,175
97750,177,125,22,40,49,14,31,76,15,3,52,0,16,22,14,44,8
97751,48,17,4,13,0,0,12,5,0,0,31,7,17,7,0,26,5
97752,31,31,0,31,0,0,26,5,0,0,0,0,0,0,0,0,0
97753,683,631,61,350,185,35,202,398,25,6,52,4,15,15,18,31,21
97754,6502,4710,1101,1905,1354,350,1599,2279,525,307,1792,237,495,586,474,1470,322
97756,8547,6191,1455,2775,1535,426,2123,2968,828,272,2356,520,752,655,429,1852,504
97758,31,18,2,13,3,0,10,6,2,0,13,5,4,2,2,6,7
97759,1890,1484,153,603,615,113,500,888,60,36,406,69,154,122,61,319,87
97760,2355,1837,335,713,652,137,576,1055,123,83,518,58,188,198,74,373,145
97761,814,678,179,361,114,24,186,118,237,137,136,29,59,42,6,109,27
97801,7919,5303,1187,2480,1284,352,1795,2287,828,393,2616,619,810,574,613,2156,460
97810,296,228,31,94,81,22,71,123,11,23,68,6,29,21,12,59,9
97812,335,226,40,120,52,14,92,106,17,11,109,30,31,34,14,92,17
97813,494,390,76,198,86,30,160,172,42,16,104,11,27,29,37,91,13
97814,5061,3459,598,1507,1054,300,1111,1748,390,210,1602,185,449,559,409,1393,209
97817,7,3,0,0,1,2,0,3,0,0,4,0,4,0,0,4,0
97818,1197,959,280,461,190,28,446,327,136,50,238,47,90,83,18,184,54
97819,28,24,0,12,9,3,6,17,1,0,4,0,2,2,0,4,0
97820,385,288,23,165,76,24,104,136,30,18,97,17,19,30,31,78,19
97823,495,327,40,137,102,48,100,177,28,22,168,12,36,56,64,152,16
97824,559,463,59,218,150,36,150,266,28,19,96,7,26,27,36,85,11
97825,107,68,4,32,21,11,26,36,3,3,39,2,17,14,6,39,0
97826,380,262,60,131,58,13,109,109,29,15,118,17,32,48,21,104,14
97827,956,686,98,316,220,52,195,374,70,47,270,36,73,102,59,219,51
97828,1324,891,96,447,266,82,279,478,103,31,433,72,115,141,105,378,55
97830,309,201,22,69,85,25,51,126,12,12,108,6,37,44,21,91,17
97833,381,289,28,135,105,21,82,155,35,17,92,4,20,41,27,80,12
97834,478,305,38,121,108,38,106,150,33,16,173,14,56,63,40,153,20
97835,122,105,23,58,12,12,54,35,11,5,17,3,3,7,4,17,0
97836,850,612,95,286,185,46,190,339,62,21,238,31,62,82,63,208,30
97837,59,43,6,16,15,6,10,27,6,0,16,0,7,4,5,9,7
97838,7836,5601,1360,2683,1308,250,2120,2301,853,327,2235,407,775,553,500,1791,444
97839,174,122,15,60,39,8,47,73,2,0,52,8,18,13,13,36,16
97840,69,38,0,26,8,4,15,21,0,2,31,7,2,17,5,27,4
97841,147,111,19,59,21,12,53,48,10,0,36,2,10,15,9,36,0
97842,74,42,5,24,5,8,19,12,10,1,32,13,0,5,14,24,8
97843,273,204,16,106,73,9,93,100,5,6,69,15,12,18,24,56,13
97844,1264,1014,244,481,244,45,351,416,161,86,250,47,100,68,35,190,60
97845,1096,746,128,358,202,58,271,340,95,40,350,73,92,101,84,322,28
97846,846,591,44,267,221,59,184,329,45,33,255,25,83,93,54,222,33
97848,102,65,0,22,29,14,15,50,0,0,37,5,18,6,8,37,0
97850,6650,4216,957,1924,1025,310,1425,2004,497,290,2434,725,657,472,580,1901,533
97856,159,110,18,39,34,19,36,58,9,7,49,0,11,23,15,36,13
97857,202,149,27,68,40,14,49,88,10,2,53,5,21,19,8,45,8
97859,54,25,0,12,7,6,12,13,0,0,29,0,22,7,0,23,6
97862,4093,2958,562,1327,778,291,1039,1341,368,210,1135,264,248,243,380,984,151
97864,101,73,12,33,19,9,19,43,9,2,28,2,9,10,7,25,3
97865,504,338,49,153,109,27,91,175,42,30,166,14,50,61,41,144,22
97867,275,196,40,99,47,10,61,104,18,13,79,7,37,24,11,58,21
97868,793,610,91,301,161,57,201,314,55,40,183,26,64,53,40,160,23
97869,538,377,53,197,108,19,149,183,34,11,161,28,41,72,20,136,25
97870,282,179,2,61,82,34,38,131,7,3,103,0,19,48,36,96,7
97872,13,13,2,7,2,2,2,11,0,0,0,0,0,0,0,0,0
97873,133,97,30,45,22,0,34,49,14,0,36,6,9,17,4,26,10
97874,160,111,7,44,49,11,31,71,5,4,49,9,11,21,8,41,8
97875,908,696,181,310,157,48,266,305,65,60,212,45,66,56,45,164,48
97876,292,234,35,102,78,19,83,143,6,2,58,13,12,30,3,50,8
97877,97,53,5,18,30,0,5,47,1,0,44,0,14,17,13,36,8
97880,152,108,16,46,38,8,33,64,11,0,44,6,13,15,10,32,12
97882,1717,1327,415,589,241,82,537,469,256,65,390,70,125,149,46,297,93
97883,857,654,107,280,203,64,230,344,59,21,203,23,50,48,82,185,18
97884,90,53,6,33,12,2,24,15,14,0,37,6,12,13,6,35,2
97885,595,432,55,214,124,39,140,218,45,29,163,13,48,48,54,147,16
97886,463,353,44,185,105,19,119,169,44,21,110,4,34,41,31,77,33
97901,231,178,25,86,55,12,80,75,11,12,53,8,7,24,14,47,6
97903,58,48,9,0,29,10,9,39,0,0,10,0,0,10,0,0,10
97904,58,35,3,20,8,4,12,21,0,2,23,3,10,3,7,21,2
97905,70,50,0,22,23,5,3,39,6,2,20,0,7,13,0,16,4
97906,86,77,11,38,22,6,35,28,7,7,9,0,5,4,0,7,2
97907,283,189,29,63,70,27,43,119,18,9,94,9,41,20,24,81,13
97908,31,20,3,7,6,4,6,9,2,3,11,0,3,8,0,11,0
97909,7,7,0,0,7,0,0,7,0,0,0,0,0,0,0,0,0
97910,269,186,28,91,50,17,72,83,21,10,83,23,11,25,24,70,13
97911,44,29,6,11,10,2,9,18,0,2,15,3,3,3,6,14,1
97913,1869,1459,300,656,361,142,559,568,202,130,410,81,107,105,117,341,69
97914,5999,4147,1044,1759,1071,273,1633,1722,538,254,1852,279,382,593,598,1602,250
97918,1631,1263,300,517,329,117,488,563,145,67,368,31,102,138,97,325,43
97920,13,10,2,5,3,0,7,3,0,0,3,0,0,3,0,3,0
98001,8862,6804,1035,4026,1573,170,2882,2815,719,388,2058,368,848,568,274,1464,594
98002,12517,7657,2428,3246,1409,574,2336,2904,1695,722,4860,1081,1651,1359,769,3784,1076
98003,16942,10756,3190,5233,1901,432,3844,3662,2173,1077,6186,2030,2098,1457,601,4840,1346
98004,10579,6038,757,2687,1882,712,1966,3256,431,385,4541,1229,1401,978,933,3777,764
98005,7593,4411,982,1845,1237,347,1450,2292,285,384,3182,1146,1195,501,340,2501,681
98006,13057,10199,1250,5641,2793,515,4356,4641,654,548,2858,830,1158,568,302,2175,683
98007,10179,5675,1772,2293,1215,395,2026,2397,576,676,4504,1932,1419,640,513,3396,1108
98008,9108,6481,978,3026,2015,462,2373,3190,357,561,2627,399,948,826,454,2039,588
98010,1591,1258,261,731,214,52,601,515,88,54,333,33,137,104,59,284,49
98011,10390,6947,1527,3826,1320,274,2749,2745,797,656,3443,1046,1463,580,354,2598,845
98012,14286,10504,2321,6036,1801,346,4623,4286,1067,528,3782,1209,1328,731,514,2754,1028
98014,2401,1888,280,1229,306,73,949,718,179,42,513,76,283,100,54,349,164
98019,2830,2300,434,1454,376,36,1079,903,245,73,530,88,390,36,16,382,148
98020,7966,5018,493,2270,1556,699,1589,2631,354,444,2948,356,817,967,808,2490,458
98021,7508,5544,850,3188,1138,368,2536,2242,387,379,1964,382,699,580,303,1518,446
98022,7948,5724,952,3173,1225,374,2483,2322,600,319,2224,354,727,629,514,1801,423
98023,17063,12532,2864,6969,2367,332,5346,4675,1780,731,4531,1514,1860,797,360,3358,1173
98024,1787,1389,181,858,270,80,560,640,135,54,398,88,146,96,68,336,62
98025,8,8,0,8,0,0,0,8,0,0,0,0,0,0,0,0,0
98026,13555,9646,1605,5223,2357,461,3490,4370,1063,723,3909,965,1456,1057,431,3084,825
98027,8766,6004,871,3549,1400,184,2445,2655,591,313,2762,777,1111,578,296,2113,649
98028,7199,4856,795,2778,1041,242,1960,2045,496,355,2343,630,988,444,281,1735,608
98029,9822,7894,1206,5086,1275,327,4555,2767,435,137,1928,290,605,469,564,1586,342
98031,23115,16498,4317,8923,2716,542,7102,5427,2728,1241,6617,2274,2598,1151,594,4955,1662
98032,12310,6704,2341,2964,1214,185,2092,2457,1387,768,5606,1617,2206,1317,466,4493,1113
98033,13475,7611,1549,3887,1754,421,2477,3783,797,554,5864,1966,2271,1139,488,4416,1448
98034,16361,10181,2364,5430,2062,325,3884,4110,1198,989,6180,2160,2453,1084,483,4664,1516
98036,12603,8599,2041,4663,1552,343,3544,3224,1199,632,4004,998,1480,1031,495,3037,967
98037,17079,11204,3059,5631,2091,423,4435,4192,1601,976,5875,1957,2165,1273,480,4363,1512
98038,7722,6313,1283,3810,1071,149,3221,2393,465,234,1409,216,647,336,210,1047,362
98039,1111,901,69,436,286,110,398,464,25,14,210,8,65,83,54,170,40
98040,8434,6266,321,3280,1942,723,2602,3071,353,240,2168,313,603,569,683,1864,304
98042,12819,10442,1662,6268,2214,298,4958,4203,834,447,2377,433,1124,608,212,1760,617
98043,7956,5064,1285,2687,879,213,1842,1930,850,442,2892,866,1079,708,239,2076,816
98045,5044,3759,797,2268,596,98,1718,1492,392,157,1285,311,486,286,202,944,341
98047,1867,1352,456,659,194,43,505,373,385,89,515,157,246,95,17,368,147
98051,1080,840,143,527,133,37,326,400,88,26,240,44,118,62,16,175,65
98052,20706,12832,3291,6778,2245,518,5193,5544,1184,911,7874,3221,2642,1218,793,5931,1943
98053,10276,8837,1396,5939,1328,174,4828,3198,481,330,1439,435,688,230,86,1027,412
98055,11545,6264,1707,3132,1125,300,2043,2535,1093,593,5281,1578,2024,943,736,4165,1116
98056,10216,6257,1651,2961,1338,307,2073,2810,787,587,3959,1258,1482,704,515,3028,931
98058,13690,10320,1873,5840,2346,261,4253,4315,1074,678,3370,918,1546,778,128,2549,821
98059,10825,7787,1563,4218,1688,318,3083,3524,619,561,3038,1051,1195,568,224,2330,708
98065,1406,1039,253,567,182,37,391,443,146,59,367,76,184,52,55,281,86
98068,74,57,14,31,12,0,21,32,0,4,17,8,5,4,0,7,10
98070,4196,2861,280,1689,707,185,1019,1321,335,186,1335,140,602,369,224,992,343
98072,12005,9691,1123,6513,1769,286,4856,3776,693,366,2314,639,863,505,307,1788,526
98092,8672,6741,1308,3946,1323,164,2955,2434,812,540,1931,407,924,479,121,1337,594
98101,5785,863,250,275,217,121,61,650,55,97,4922,1889,1403,902,728,4377,545
98102,12507,2495,973,956,440,126,478,1532,157,328,10012,5334,3258,1119,301,7259,2753
98103,21162,7916,2121,4123,1111,561,2511,3610,848,947,13246,6339,4657,1260,990,8757,4489
98104,5545,1325,346,485,350,144,215,651,213,246,4220,1355,1444,885,536,3652,568
98105,14870,5563,1625,2443,1108,387,1859,2584,431,689,9307,5517,2259,882,649,5803,3504
98106,8468,5356,1531,2620,988,217,1848,1650,1179,679,3112,802,1422,555,333,2240,872
98107,9627,3638,1079,1646,587,326,989,1590,481,578,5989,2273,2133,847,736,4290,1699
98108,7111,4758,1176,2203,1018,361,1538,1543,812,865,2353,524,968,469,392,1711,642
98109,9506,2621,874,1083,513,151,592,1613,157,259,6885,3412,2208,763,502,5302,1583
98110,7969,5769,452,3438,1541,338,2391,2592,486,300,2200,179,809,633,579,1802,398
98112,9956,4429,784,2129,1148,368,1404,2170,426,429,5527,2037,1894,894,702,4049,1478
98115,19530,10451,2064,5178,2091,1118,3710,5002,773,966,9079,3246,3162,1408,1263,6373,2706
98116,10590,5043,959,2611,946,527,1457,2711,483,392,5547,1467,2164,1055,861,4297,1250
98117,13432,7413,1575,3624,1397,817,2363,3535,737,778,6019,1734,2578,850,857,4199,1820
98118,13840,9243,1716,4757,2112,658,2944,3094,1579,1626,4597,930,1855,1190,622,3545,1052
98119,9970,3301,817,1529,698,257,909,1827,263,302,6669,2976,2318,797,578,5036,1633
98121,5917,1084,332,403,258,91,96,760,124,104,4833,2232,1659,681,261,4332,501
98122,13876,4315,1260,1982,732,341,992,1567,977,779,9561,4692,3180,1134,555,6881,2680
98125,15888,8070,1722,3970,1652,726,2467,3636,895,1072,7818,2613,2408,1395,1402,5783,2035
98126,8503,4728,1214,2338,783,393,1436,1964,739,589,3775,860,1655,596,664,2830,945
98133,19083,10028,1982,4854,2241,951,3109,4316,1263,1340,9055,2714,3117,1586,1638,6832,2223
98134,22,0,0,0,0,0,0,0,0,0,22,17,0,0,5,5,17
98136,6742,3497,573,1795,673,456,1149,1968,208,172,3245,866,1189,695,495,2457,788
98144,9984,5672,1273,2703,1263,433,1414,2008,1201,1049,4312,1138,1573,907,694,3234,1078
98146,9646,6470,1242,3395,1415,418,2238,2675,866,691,3176,614,1237,809,516,2418,758
98148,4303,2359,670,1090,458,141,677,911,467,304,1944,447,814,398,285,1645,299
98154,0,0,0,0,0,0,0,0,0,0,0,0,0,0,0,0,0
98155,13138,8904,1364,4929,2089,522,3373,3827,895,809,4234,942,1715,907,670,3210,1024
98164,0,0,0,0,0,0,0,0,0,0,0,0,0,0,0,0,0
98166,8556,5624,820,2670,1484,650,1791,2690,606,537,2932,394,1044,883,611,2447,485
98168,11403,7177,1761,3555,1423,438,2629,2429,1171,948,4226,991,1796,840,599,3203,1023
98174,0,0,0,0,0,0,0,0,0,0,0,0,0,0,0,0,0
98177,7510,5380,451,2804,1572,553,1898,2729,365,388,2130,291,687,698,454,1666,464
98178,8529,5714,1057,2669,1489,499,1773,2359,826,756,2815,487,1063,779,486,2224,591
98188,9651,5440,1452,2636,1039,313,1809,2095,914,622,4211,1095,1894,901,321,3429,782
98198,12664,8107,2059,3698,1823,527,2581,3205,1516,805,4557,1360,1955,829,413,3543,1014
98199,9184,4886,978,2242,1116,550,1554,2626,318,388,4298,1317,1453,830,698,3236,1062
98201,11810,6151,1736,2990,1032,393,1948,2196,1281,726,5659,1389,2057,1190,1023,4604,1055
98203,12262,8420,1983,4196,1674,567,3216,3513,1072,619,3842,867,1595,815,565,3001,841
98204,13128,7595,3193,3068,1140,194,2515,2266,1897,917,5533,1982,2118,987,446,4266,1267
98205,6093,4795,1436,2521,696,142,2324,1570,659,242,1298,268,552,330,148,957,341
98208,16617,12225,3097,6499,2154,475,5177,4638,1543,867,4392,1226,1751,920,495,3280,1112
98220,234,177,41,75,52,9,53,111,5,8,57,13,26,6,12,43,14
98221,7815,5417,615,2489,1650,663,1550,2997,528,342,2398,351,651,699,697,2019,379
98222,27,9,0,0,9,0,0,9,0,0,18,0,0,7,11,18,0
98223,12124,9101,2076,4690,1948,387,3759,3935,978,429,3023,532,1291,683,517,2332,691
98224,104,50,4,25,19,2,9,37,4,0,54,13,27,8,6,44,10
98225,17886,7923,2121,3621,1470,711,2406,3482,1194,841,9963,4856,2425,1262,1420,6634,3329
98226,22057,15114,2944,7470,3608,1092,5243,7158,1673,1040,6943,2467,1962,1440,1074,4836,2107
98230,4315,2993,552,1347,900,194,844,1585,427,137,1322,268,522,389,143,1071,251
98232,1307,1041,153,523,324,41,443,479,58,61,266,21,136,101,8,213,53
98233,4607,3306,762,1516,838,190,1257,1375,392,282,1301,312,384,327,278,1013,288
98235,40,15,0,9,6,0,0,15,0,0,25,8,7,6,4,21,4
98236,2315,1717,181,822,518,196,555,941,157,64,598,50,215,206,127,478,120
98237,1078,762,139,454,133,36,266,300,131,65,316,33,120,103,60,260,56
98238,18,9,0,9,0,0,9,0,0,0,9,0,9,0,0,0,9
98239,2474,1717,227,682,593,215,491,1018,121,87,757,68,260,283,146,644,113
98240,912,715,75,411,206,23,289,348,70,8,197,26,67,41,63,152,45
98241,811,560,112,242,162,44,224,252,66,18,251,29,80,77,65,217,34
98243,67,45,0,0,45,0,0,45,0,0,22,0,8,14,0,22,0
98244,896,628,88,365,155,20,241,288,74,25,268,72,84,89,23,195,73
98245,1495,923,109,474,266,74,276,471,125,51,572,78,220,198,76,451,121
98247,2626,2056,490,1037,408,121,935,763,213,145,570,130,202,146,92,452,118
98248,6576,5068,1086,2583,1177,222,1984,2153,661,270,1508,231,590,389,298,1185,323
98249,1667,1130,108,504,408,110,243,725,83,79,537,41,186,168,142,441,96
98250,3058,1922,160,962,613,187,524,1081,226,91,1136,159,399,384,194,897,239
98251,1575,1146,245,626,232,43,438,477,157,74,429,83,203,122,21,333,96
98252,2311,1719,425,895,337,62,746,657,192,124,592,88,327,119,58,444,148
98253,625,374,36,118,166,54,102,230,15,27,251,16,107,69,59,192,59
98256,265,138,9,90,29,10,40,77,19,2,127,31,55,37,4,99,28
98257,1562,1124,134,390,424,176,234,709,102,79,438,33,136,138,131,368,70
98258,5804,4571,852,2724,849,146,1916,1842,523,290,1233,266,570,272,125,894,339
98260,2033,1360,134,716,402,108,504,641,145,70,673,63,263,197,150,554,119
98261,1099,695,68,299,257,71,177,459,56,3,404,74,138,111,81,344,60
98262,363,226,17,111,84,14,84,99,17,26,137,9,60,51,17,104,33
98264,5849,4517,1010,2041,1115,351,1940,2023,350,204,1332,191,263,318,560,1184,148
98267,270,177,8,108,61,0,51,89,26,11,93,11,19,47,16,67,26
98270,12552,9338,2560,4692,1517,569,4197,3327,1169,645,3214,608,1090,771,745,2593,621
98271,7982,6267,1216,3320,1369,362,2615,2607,644,401,1715,260,749,541,165,1250,465
98272,7382,5573,1647,2886,861,179,2550,2036,642,345,1809,429,720,361,299,1375,434
98273,9191,6226,1599,2923,1296,408,2491,2527,769,439,2965,601,959,748,657,2343,622
98274,4843,3495,689,1717,776,313,1284,1590,415,206,1348,199,398,398,353,1064,284
98275,7111,5389,878,3245,1103,163,2471,2094,551,273,1722,429,911,266,116,1318,404
98277,13240,9867,3139,4384,1818,526,4221,4190,1016,440,3373,1164,963,735,511,2572,801
98279,359,228,0,80,107,41,19,178,21,10,131,10,44,42,35,121,10
98280,184,96,0,36,50,10,16,71,0,9,88,0,26,51,11,71,17
98281,624,382,61,156,132,33,91,216,44,31,242,49,108,60,25,203,39
98283,154,97,8,53,36,0,33,53,0,11,57,7,22,20,8,54,3
98284,8270,5945,1277,2987,1258,423,2096,2577,918,354,2325,458,784,577,506,1732,593
98286,106,62,0,22,20,20,14,43,2,3,44,6,7,18,13,32,12
98288,196,119,10,61,45,3,31,72,10,6,77,13,26,29,9,53,24
98290,10190,7798,1161,4882,1477,278,3423,3083,824,468,2392,370,1049,608,365,1832,560
98292,11887,8935,1308,4596,2264,767,3373,4466,624,472,2952,341,1007,847,757,2378,574
98294,2052,1534,354,790,326,64,579,595,262,98,518,78,183,137,120,411,107
98295,1657,1214,301,625,223,65,546,436,143,89,443,137,142,147,17,327,116
98296,6324,5307,795,3344,992,176,2694,2003,355,255,1017,198,542,192,85,709,308
98297,64,38,0,31,7,0,12,15,11,0,26,8,9,0,9,26,0
98303,393,231,29,51,110,41,57,168,0,6,162,0,32,68,62,158,4
98304,385,250,13,160,69,8,91,133,17,9,135,14,78,34,9,92,43
98305,171,91,15,52,24,0,24,45,14,8,80,11,37,32,0,52,28
98310,8157,4789,1254,2012,1092,431,1507,2057,806,419,3368,742,908,770,948,2820,548
98311,8308,6450,1239,3525,1440,246,2605,2783,770,292,1858,428,680,462,288,1406,452
98312,12478,8344,2485,3799,1568,492,3106,3317,1342,579,4134,967,1665,847,655,3187,947
98315,1282,1275,970,305,0,0,944,243,82,6,7,7,0,0,0,0,7
98320,576,374,16,118,177,63,51,268,33,22,202,8,82,78,34,173,29
98321,4901,3765,710,2173,718,164,1744,1313,460,248,1136,204,489,343,100,789,347
98323,273,224,44,138,36,6,125,66,23,10,49,2,23,12,12,39,10
98325,567,416,48,278,63,27,152,185,44,35,151,24,51,40,36,121,30
98326,224,144,39,55,44,6,46,56,30,12,80,3,48,16,13,77,3
98327,877,614,176,329,86,23,262,272,52,28,263,61,123,46,33,220,43
98328,3121,2360,382,1290,601,87,884,1096,274,106,761,128,292,243,98,620,141
98329,3303,2668,506,1564,530,68,1161,1078,293,136,635,68,302,172,93,460,175
98330,28,22,9,0,10,3,9,13,0,0,6,0,0,6,0,6,0
98331,2182,1571,326,847,339,59,589,624,210,148,611,140,223,188,60,477,134
98332,4747,3701,421,1848,1142,290,1283,1982,279,157,1046,194,380,277,195,864,182
98333,1041,859,72,473,266,48,303,435,98,23,182,26,86,47,23,156,26
98335,8823,6700,930,3581,1699,490,2590,3257,584,269,2123,316,789,611,407,1789,334
98336,519,350,85,122,138,5,109,166,62,13,169,18,36,81,34,141,28
98337,2924,1436,561,653,169,53,399,414,420,203,1488,433,709,234,112,1165,323
98338,6965,5795,1138,3408,1140,109,2588,2320,596,291,1170,148,523,374,125,934,236
98339,1367,961,158,500,242,61,306,423,186,46,406,17,163,133,93,354,52
98340,821,603,96,204,225,78,163,385,50,5,218,32,103,52,31,173,45
98342,317,233,30,109,84,10,66,130,28,9,84,12,29,33,10,69,15
98345,148,99,31,61,0,7,50,32,8,9,49,15,5,23,6,41,8
98346,3164,2338,358,1374,487,119,929,952,267,190,826,156,351,213,106,637,189
98349,1434,990,166,426,353,45,327,505,80,78,444,35,197,165,47,335,109
98350,124,83,17,51,15,0,30,17,25,11,41,2,15,18,6,37,4
98351,471,379,29,187,139,24,112,235,9,23,92,8,34,43,7,57,35
98353,54,31,0,9,22,0,0,11,20,0,23,0,23,0,0,23,0
98354,2336,1565,336,792,321,116,482,728,279,76,771,129,273,199,170,619,152
98355,273,190,11,108,67,4,48,90,14,38,83,15,40,8,20,73,10
98356,874,575,76,280,159,60,150,338,54,33,299,27,95,83,94,256,43
98357,470,321,80,174,51,16,101,64,104,52,149,45,39,58,7,129,20
98358,394,289,23,124,100,42,65,207,6,11,105,7,19,29,50,77,28
98359,1354,1073,163,609,266,35,396,500,105,72,281,15,148,72,46,186,95
98360,2572,2011,501,1070,378,62,864,883,213,51,561,120,180,183,78,477,84
98361,507,311,30,122,129,30,69,176,53,13,196,18,50,100,28,140,56
98362,9250,5884,865,2574,1854,591,1645,3105,753,381,3366,446,1000,1000,920,2837,529
98363,5011,3437,554,1711,896,276,1074,1638,483,242,1574,202,529,553,290,1281,293
98364,25,15,0,0,10,5,0,15,0,0,10,0,10,0,0,10,0
98365,1676,1222,84,318,603,217,195,945,30,52,454,22,136,182,114,356,98
98366,11772,8282,1849,4345,1706,382,2954,3627,1237,464,3490,749,1149,883,709,2714,776
98367,8561,6902,1117,3849,1709,227,2730,3185,692,295,1659,226,805,424,204,1280,379
98368,5945,3593,445,1647,1182,319,848,1971,504,270,2352,260,739,851,502,1963,389
98370,9725,7113,1081,3805,1768,459,2740,3371,671,331,2612,418,1017,679,498,2102,510
98371,8032,5434,1140,2638,1313,343,1950,2403,705,376,2598,508,784,716,590,2108,490
98372,8225,5443,1156,2726,1229,332,2087,2362,675,319,2782,658,1071,675,378,2173,609
98373,6419,4606,1121,2276,1030,179,1701,1975,640,290,1813,763,569,341,140,1380,433
98374,10293,8188,1774,4549,1572,293,3737,3135,1048,268,2105,497,757,460,391,1606,499
98375,4604,3835,913,2201,612,109,1797,1300,517,221,769,191,267,274,37,529,240
98376,751,484,45,246,156,37,131,252,78,23,267,24,133,70,40,205,62
98377,878,639,106,272,201,60,145,380,89,25,239,15,109,72,43,224,15
98380,1247,926,82,567,231,46,398,429,62,37,321,36,125,105,55,228,93
98381,269,167,13,69,62,23,49,100,11,7,102,6,59,33,4,99,3
98382,9836,6734,564,2186,2623,1361,1378,4484,527,345,3102,192,705,1068,1137,2709,393
98383,7144,5237,1215,2808,1040,174,2343,2047,588,259,1907,749,574,347,237,1465,442
98385,63,47,11,30,6,0,23,16,5,3,16,6,5,3,2,12,4
98387,12203,9648,2523,5198,1628,299,3969,3637,1424,618,2555,543,1091,697,224,1988,567
98388,2613,1797,333,804,546,114,489,894,283,131,816,199,279,229,109,683,133
98390,15930,12280,2485,7321,2059,415,5173,4624,1704,779,3650,884,1487,819,460,2741,909
98392,968,628,147,326,125,30,184,271,116,57,340,71,177,54,38,224,116
98394,356,261,7,133,68,53,63,177,0,21,95,10,31,39,15,95,0
98396,144,106,17,63,26,0,44,43,10,9,38,5,13,12,8,29,9
98402,2334,491,243,139,58,51,97,232,121,41,1843,481,625,336,401,1717,126
98403,4237,1658,511,679,360,108,428,850,256,124,2579,1011,949,409,210,2122,457
98404,10201,7306,1948,3588,1384,386,2459,2189,1769,889,2895,509,1146,835,405,2216,679
98405,8919,4870,1518,2122,889,341,1545,1439,1267,619,4049,916,1487,940,706,3359,690
98406,9543,5523,958,2861,1160,544,1835,2475,669,544,4020,989,1082,933,1016,3219,801
98407,8809,5428,997,2731,1261,439,1750,2556,642,480,3381,705,1178,751,747,2796,585
98408,10886,7240,1736,3648,1308,548,2324,2696,1373,847,3646,808,1336,908,594,2944,702
98409,8643,5289,1819,2407,811,252,1534,1623,1482,650,3354,1046,1149,625,534,2569,785
98421,23,1,1,0,0,0,1,0,0,0,22,2,18,2,0,20,2
98422,7320,5593,1167,3100,1178,148,2256,2471,572,294,1727,434,788,369,136,1273,454
98424,2152,1153,492,434,177,50,366,337,294,156,999,400,385,139,75,803,196
98433,3571,3525,2415,1110,0,0,2786,404,313,22,46,24,17,5,0,46,0
98439,2052,1665,1026,564,68,7,996,351,273,45,387,170,162,46,9,287,100
98443,2090,1602,210,862,436,94,594,729,157,122,488,55,114,177,142,400,88
98444,11892,7752,2896,3196,1373,287,2338,2535,1968,911,4140,1231,1507,1019,383,3250,890
98445,7997,5932,1158,3068,1393,313,2271,2316,833,512,2065,361,817,604,283,1627,438
98446,3427,2611,552,1239,657,163,837,1200,375,199,816,139,338,253,86,632,184
98465,3090,1742,410,720,480,132,478,842,308,114,1348,295,541,286,226,1105,243
98466,10622,6751,1227,3247,1696,581,2114,2905,1205,527,3871,1058,1207,1041,565,3155,716
98467,5769,4108,1185,2048,782,93,1587,1583,710,228,1661,459,702,391,109,1328,333
98498,11516,7628,1652,3335,2054,587,2210,3696,1184,538,3888,810,1247,1279,552,3205,683
98499,12225,7512,2412,3180,1360,560,2168,2838,1757,749,4713,1406,1659,1015,633,3773,940
98501,13840,8726,1639,4628,1861,598,3185,3613,1391,537,5114,1483,1647,1299,685,4022,1092
98502,10684,6450,1197,3225,1625,403,2253,2827,918,452,4234,1600,1365,822,447,3035,1199
98503,12795,8615,2172,3989,1816,638,2941,3583,1358,733,4180,852,1433,845,1050,3381,799
98506,7382,4330,853,2163,960,354,1492,1966,534,338,3052,855,1008,621,568,2344,708
98512,9621,6446,1198,3279,1588,381,2348,3009,686,403,3175,896,1181,630,468,2460,715
98513,8781,6912,1325,3743,1505,339,2594,3083,755,480,1869,409,764,485,211,1468,401
98516,5550,3986,767,2182,876,161,1554,1721,408,303,1564,282,619,474,189,1191,373
98520,8662,5648,1287,2618,1276,467,1762,2393,1039,454,3014,511,1011,839,653,2452,562
98524,645,508,46,151,241,70,113,364,20,11,137,18,25,63,31,101,36
98526,170,119,19,67,27,6,48,38,25,8,51,8,18,14,11,41,10
98527,101,58,9,29,20,0,22,22,7,7,43,6,13,14,10,37,6
98528,3087,2178,385,1148,478,167,733,1048,272,125,909,152,364,226,167,728,181
98530,168,134,27,74,25,8,47,53,16,18,34,6,8,16,4,23,11
98531,8627,5697,1278,2549,1324,546,1808,2622,855,412,2930,505,726,755,944,2414,516
98532,7524,5489,1026,2615,1448,400,1935,2619,664,271,2035,348,552,587,548,1683,352
98533,224,165,29,77,27,32,42,123,0,0,59,0,15,36,8,52,7
98535,228,152,0,78,74,0,38,75,32,7,76,0,8,18,50,66,10
98536,136,74,18,36,20,0,13,49,6,6,62,0,20,29,13,53,9
98537,702,482,78,229,131,44,163,255,39,25,220,36,65,81,38,183,37
98538,115,87,10,55,17,5,35,40,12,0,28,4,6,15,3,19,9
98539,65,58,12,26,17,3,21,26,8,3,7,2,0,2,3,7,0
98541,3496,2499,553,1104,678,164,869,1063,375,192,997,183,293,368,153,770,227
98542,202,170,23,75,45,27,63,87,9,11,32,0,17,10,5,32,0
98546,873,671,65,240,266,100,175,432,38,26,202,27,65,67,43,150,52
98547,789,450,69,130,220,31,91,280,48,31,339,45,127,126,41,251,88
98548,884,569,52,136,318,63,83,427,43,16,315,19,101,153,42,272,43
98550,4590,3040,593,1432,750,265,879,1281,584,296,1550,229,472,476,373,1299,251
98552,232,168,35,82,42,9,73,65,20,10,64,9,32,17,6,51,13
98555,234,192,0,23,115,54,17,150,9,16,42,0,9,8,25,42,0
98557,1072,769,151,356,202,60,244,342,115,68,303,30,88,117,68,253,50
98559,24,15,5,10,0,0,15,0,0,0,9,9,0,0,0,9,0
98560,61,40,2,19,19,0,11,21,5,3,21,0,13,6,2,14,7
98562,110,42,0,32,6,4,5,27,0,10,68,5,32,17,14,68,0
98563,2889,2110,385,1079,507,139,684,1004,282,140,779,70,181,291,237,661,118
98564,816,610,108,281,179,42,193,311,66,40,206,11,71,79,45,160,46
98565,172,121,33,58,22,8,43,43,20,15,51,7,18,17,9,38,13
98568,798,609,112,275,185,37,195,248,103,63,189,32,65,65,27,140,49
98569,1938,1273,163,381,566,163,198,827,128,120,665,53,189,267,156,509,156
98570,1259,1010,162,465,318,65,375,444,90,101,249,48,65,105,31,193,56
98571,194,119,28,48,24,19,50,42,18,9,75,4,25,40,6,74,1
98572,322,228,58,94,61,15,81,100,32,15,94,4,31,32,27,73,21
98575,68,43,6,24,11,2,6,22,15,0,25,4,10,9,2,20,5
98576,1207,888,159,480,207,42,313,355,138,82,319,26,141,103,49,240,79
98577,2593,1800,302,805,507,186,579,923,185,113,793,73,208,271,241,665,128
98579,3499,2690,547,1334,679,130,967,1201,362,160,809,124,334,214,137,621,188
98580,3284,2530,449,1412,565,104,1021,1145,225,139,754,160,376,162,56,531,223
98581,252,155,2,8,84,61,0,147,2,6,97,0,0,37,60,88,9
98582,150,85,16,23,46,0,29,42,8,6,65,3,36,13,13,62,3
98584,11335,8019,1524,3496,2346,653,2367,3897,1159,596,3316,457,1168,989,702,2660,656
98585,228,207,16,81,100,10,52,139,16,0,21,8,7,0,6,13,8
98586,902,591,108,252,184,47,202,285,64,40,311,29,101,97,84,262,49
98587,253,203,51,87,61,4,60,60,46,37,50,7,22,19,2,37,13
98588,645,426,22,201,158,45,111,283,17,15,219,29,82,97,11,167,52
98589,2450,1840,312,936,486,106,698,823,181,138,610,98,210,209,93,467,143
98590,176,112,32,34,39,7,36,57,15,4,64,16,4,28,16,60,4
98591,1135,875,156,369,275,75,291,442,79,63,260,31,55,112,62,208,52
98592,594,430,32,178,198,22,105,281,15,29,164,17,43,55,49,145,19
98593,366,266,55,138,57,16,104,109,37,16,100,4,43,30,23,84,16
98595,1291,776,112,299,246,119,179,448,102,47,515,59,192,152,112,423,92
98596,2407,1818,290,838,560,130,666,866,173,113,589,88,171,180,150,485,104
98597,5309,3901,890,1957,917,137,1483,1569,556,293,1408,187,537,493,191,1141,267
98601,795,627,87,352,169,19,249,319,41,18,168,44,71,39,14,130,38
98602,85,73,5,42,24,2,27,38,0,8,12,0,8,4,0,12,0
98603,253,181,44,99,31,7,94,48,28,11,72,10,39,17,6,58,14
98604,7946,6582,1353,3684,1275,270,3119,2625,552,286,1364,245,496,400,223,1049,315
98605,452,273,68,135,55,15,108,114,49,2,179,37,69,44,29,158,21
98606,2759,2263,208,1406,564,85,1003,1112,92,56,496,75,152,191,78,378,118
98607,6403,5078,958,2860,1009,251,2366,1932,474,306,1325,253,469,433,170,1058,267
98610,1080,763,129,380,213,41,245,336,120,62,317,43,135,84,55,276,41
98611,3133,2367,407,1142,687,131,808,1163,245,151,766,41,280,261,184,659,107
98612,1018,730,105,316,228,81,210,384,98,38,288,23,88,136,41,233,55
98613,188,157,25,82,42,8,63,77,14,3,31,5,6,17,3,29,2
98614,243,169,0,77,50,42,46,95,13,15,74,6,23,38,7,68,6
98616,9,9,0,9,0,0,9,0,0,0,0,0,0,0,0,0,0
98617,405,294,66,103,93,32,107,158,25,4,111,6,21,63,21,111,0
98619,201,153,15,76,52,10,51,76,14,12,48,9,18,17,4,43,5
98620,2743,1916,402,771,615,128,609,927,290,90,827,111,237,256,223,699,128
98621,93,65,7,32,22,4,23,39,0,3,28,2,6,13,7,26,2
98624,559,367,73,152,99,43,122,192,39,14,192,16,47,78,51,168,24
98625,1726,1274,208,604,378,84,380,695,138,61,452,72,201,125,54,336,116
98626,8654,6200,1568,2780,1515,337,2085,2747,968,400,2454,376,904,710,464,1979,475
98628,107,88,26,41,19,2,47,29,10,2,19,1,5,8,5,19,0
98629,2410,1956,390,1092,409,65,911,780,164,101,454,98,210,118,28,329,125
98631,1589,951,126,361,360,104,217,590,71,73,638,73,186,229,150,513,125
98632,18550,12528,2948,5711,2952,917,4028,5562,2060,878,6022,1139,1908,1522,1453,5011,1011
98635,834,631,64,365,155,47,163,346,77,45,203,31,71,70,31,168,35
98638,496,359,27,192,96,44,97,200,34,28,137,13,38,45,41,115,22
98639,207,158,22,83,42,11,49,78,16,15,49,8,21,15,5,42,7
98640,1824,1140,76,315,586,163,188,822,74,56,684,48,144,277,215,582,102
98641,33,33,0,7,26,0,0,33,0,0,0,0,0,0,0,0,0
98642,4514,3625,489,1927,1055,154,1440,1676,262,247,889,42,385,322,140,712,177
98643,152,113,9,50,43,11,24,66,13,10,39,7,2,20,10,35,4
98644,298,157,16,33,69,39,8,99,18,32,141,18,73,43,7,129,12
98645,477,379,52,205,99,23,134,202,27,16,98,25,27,32,14,86,12
98647,206,124,12,61,39,12,21,91,8,4,82,9,39,23,11,73,9
98648,1111,775,130,385,218,42,250,380,85,60,336,24,154,101,57,263,73
98649,247,199,23,85,75,16,52,103,33,11,48,7,22,7,12,29,19
98650,299,224,17,97,90,20,70,115,21,18,75,31,23,15,6,50,25
98651,364,301,34,144,112,11,101,154,32,14,63,8,25,21,9,42,21
98660,4156,2126,666,952,393,115,624,702,546,254,2030,387,736,500,407,1669,361
98661,14785,9080,2967,3789,1752,572,3002,3233,1835,1010,5705,1398,2059,1352,896,4512,1193
98662,8714,6274,1465,3056,1456,297,2321,2700,760,493,2440,614,853,565,408,1849,591
98663,5683,3553,869,1702,717,265,1036,1441,638,438,2130,518,803,459,350,1642,488
98664,8229,5479,1375,2403,1335,366,1793,2492,734,460,2750,721,908,599,522,2136,614
98665,8175,5414,1146,2561,1433,274,1759,2421,816,418,2761,457,1113,681,510,2150,611
98670,32,27,2,20,5,0,20,7,0,0,5,0,2,3,0,3,2
98671,5619,4189,916,2133,925,215,1474,1813,647,255,1430,192,655,313,270,1130,300
98672,2017,1458,232,753,365,108,551,697,154,56,559,81,225,148,105,464,95
98673,78,44,2,23,13,6,2,23,11,8,34,4,15,11,4,29,5
98674,3271,2464,473,1196,648,147,966,1168,234,96,807,136,317,205,149,614,193
98675,1338,1123,254,625,224,20,570,402,95,56,215,19,70,79,47,153,62
98682,14473,11333,3517,5980,1560,276,5162,3636,1709,826,3140,1099,1191,620,230,2261,879
98683,11389,7723,2087,3602,1532,502,3039,3333,959,392,3666,1086,1244,690,646,2907,759
98684,7428,5471,1490,2838,968,175,2292,1928,846,405,1957,716,779,379,83,1383,574
98685,7769,5910,898,3444,1323,245,2470,2507,592,341,1859,322,647,635,255,1479,380
98686,4847,3806,615,2062,903,226,1558,1657,402,189,1041,186,398,354,103,803,238
98801,13781,9236,2119,4218,2125,774,3646,3827,1169,594,4545,833,1569,1022,1121,3739,806
98802,8461,6391,1360,3061,1515,455,2356,2845,870,320,2070,386,637,643,404,1697,373
98811,25,23,5,9,9,0,11,12,0,0,2,0,2,0,0,0,2
98812,1695,1325,358,615,278,74,568,455,206,96,370,23,107,110,130,324,46
98813,758,610,171,279,114,46,277,186,95,52,148,13,55,61,19,130,18
98814,243,177,22,84,67,4,55,91,25,6,66,8,23,22,13,49,17
98815,2762,1985,321,1113,464,87,862,858,160,105,777,166,162,214,235,649,128
98816,2482,1678,241,812,469,156,544,804,223,107,804,148,244,234,178,693,111
98817,90,57,0,32,18,7,16,29,12,0,33,0,9,16,8,24,9
98819,132,80,7,16,46,11,8,58,5,9,52,2,25,19,6,39,13
98821,112,79,6,65,8,0,39,21,10,9,33,0,0,20,13,33,0
98822,661,511,101,260,121,29,205,223,57,26,150,21,67,39,23,105,45
98823,3533,2614,484,1297,598,235,1034,1145,319,116,919,200,203,295,221,802,117
98826,2689,1876,299,737,677,163,609,1059,133,75,813,88,304,225,196,622,191
98827,190,149,20,35,57,37,37,93,13,6,41,0,18,14,9,32,9
98828,631,538,84,265,168,21,229,230,52,27,93,0,54,31,8,73,20
98829,205,163,22,50,66,25,34,97,19,13,42,9,19,0,14,38,4
98830,225,142,25,38,59,20,35,88,17,2,83,8,27,22,26,68,15
98831,1102,835,161,412,198,64,328,350,118,39,267,37,86,80,64,217,50
98832,80,60,6,29,18,7,31,22,3,4,20,0,9,3,8,9,11
98833,29,24,6,0,18,0,0,24,0,0,5,0,5,0,0,0,5
98834,89,71,3,48,16,4,44,23,2,2,18,0,5,4,9,15,3
98836,129,107,30,66,11,0,64,43,0,0,22,0,0,0,22,22,0
98837,11356,8301,2136,3865,1841,459,3273,3220,1246,562,3055,726,934,762,633,2539,516
98840,1765,1265,215,644,340,66,424,534,238,69,500,89,194,116,101,424,76
98841,3377,2420,535,1116,609,160,758,979,449,234,957,173,261,267,256,822,135
98843,464,372,105,178,77,12,202,130,18,22,92,27,38,20,7,72,20
98844,1763,1205,222,535,356,92,371,527,208,99,558,45,208,212,93,464,94
98845,30,25,5,7,11,2,5,20,0,0,5,0,0,2,3,5,0
98846,358,261,57,117,72,15,119,113,17,12,97,16,27,30,24,80,17
98847,457,364,45,213,71,35,199,156,9,0,93,45,35,0,13,71,22
98848,3090,2466,612,1070,613,171,1126,926,230,184,624,114,197,183,130,553,71
98849,358,250,40,99,86,25,59,159,28,4,108,6,54,27,21,80,28
98850,610,495,130,227,126,12,242,177,46,30,115,22,47,42,4,90,25
98851,1568,1011,229,335,329,118,238,567,155,51,557,59,163,230,105,470,87
98852,38,16,3,13,0,0,10,6,0,0,22,3,16,3,0,19,3
98853,20,17,0,4,13,0,0,17,0,0,3,3,0,0,0,0,3
98855,2054,1410,224,673,425,88,481,693,123,113,644,84,248,211,101,539,105
98856,975,638,87,326,167,58,163,348,95,32,337,41,108,135,53,261,76
98857,1134,918,270,421,195,32,469,331,80,38,216,26,57,77,56,178,38
98858,628,464,46,247,138,33,192,225,21,26,164,5,65,34,60,143,21
98859,101,70,12,45,13,0,39,18,7,6,31,3,22,6,0,27,4
98860,105,68,9,25,27,7,11,46,11,0,37,1,12,20,4,27,10
98862,913,580,83,290,179,28,193,299,61,27,333,25,166,109,33,283,50
98901,9192,6490,1873,2881,1295,441,2495,2219,1316,460,2702,560,907,769,466,2134,568
98902,16491,10509,3441,4480,1747,841,3756,3717,2211,825,5982,1219,1704,1421,1638,4998,984
98903,4994,3555,743,1587,972,253,1290,1560,442,263,1439,117,385,558,379,1170,269
98908,12218,9013,1470,4513,2236,794,3291,4408,874,440,3205,556,902,892,855,2720,485
98922,2015,1346,169,670,421,86,409,758,112,67,669,71,195,278,125,556,113
98923,462,387,80,209,82,16,193,149,38,7,75,19,23,18,15,57,18
98925,257,173,36,67,53,17,50,95,17,11,84,21,31,30,2,44,40
98926,9799,5462,1409,2450,1225,378,1982,2446,659,375,4337,2292,842,652,551,2837,1500
98930,3852,3169,841,1489,676,163,1504,1044,375,246,683,117,184,239,143,585,98
98932,1020,857,252,379,170,56,393,287,110,67,163,48,45,46,24,141,22
98933,333,276,67,145,59,5,144,81,31,20,57,3,24,18,12,55,2
98934,198,132,54,45,26,7,50,53,16,13,66,16,27,15,8,57,9
98935,964,830,179,411,204,36,371,275,126,58,134,28,23,25,58,111,23
98936,1139,930,183,511,206,30,386,383,116,45,209,8,91,58,52,189,20
98937,1242,942,110,393,366,73,214,585,70,73,300,35,56,130,79,274,26
98938,638,540,63,322,92,63,217,202,62,59,98,11,29,26,32,77,21
98940,211,120,9,48,63,0,33,73,5,9,91,21,37,5,28,61,30
98941,457,264,44,121,81,18,94,124,30,16,193,27,56,54,56,153,40
98942,5439,4333,937,2334,928,134,1822,1694,630,187,1106,249,333,346,178,931,175
98943,176,121,22,61,25,13,50,56,13,2,55,2,19,14,20,43,12
98944,5562,4498,1479,1851,954,214,2013,1292,891,302,1064,94,299,260,411,905,159
98946,173,128,13,74,37,4,62,48,13,5,45,0,22,16,7,39,6
98947,867,713,176,376,122,39,350,252,82,29,154,10,44,50,50,134,20
98948,3588,2906,784,1400,584,138,1327,773,491,315,682,62,199,223,198,571,111
98950,29,20,2,12,6,0,8,12,0,0,9,3,3,0,3,9,0
98951,3665,3047,691,1491,668,197,1237,900,550,360,618,36,228,129,225,495,123
98952,626,550,134,278,101,37,230,163,96,61,76,9,47,15,5,49,27
98953,1986,1611,413,719,371,108,720,574,195,122,375,36,133,110,96,316,59
99001,524,335,111,123,86,15,115,110,82,28,189,46,71,54,18,153,36
99003,1653,1371,130,776,431,34,527,682,106,56,282,45,105,105,27,245,37
99004,5209,3202,762,1472,826,142,1217,1333,407,245,2007,1173,424,274,136,1328,679
99005,2180,1947,229,1120,504,94,904,897,89,57,233,42,100,44,47,194,39
99006,3222,2467,410,1289,654,114,1024,1122,214,107,755,94,227,281,153,637,118
99008,279,222,52,79,81,10,76,121,21,4,57,21,5,18,13,36,21
99009,1266,959,157,480,279,43,316,418,144,81,307,49,122,95,41,235,72
99011,1107,1094,755,333,0,6,715,316,63,0,13,6,2,0,5,11,2
99012,360,255,48,130,55,22,125,102,7,21,105,9,47,26,23,87,18
99013,331,233,47,128,55,3,75,83,44,31,98,22,28,37,11,75,23
99016,2720,1988,381,1037,439,131,722,886,249,131,732,121,287,215,109,590,142
99017,81,65,13,19,26,7,22,32,5,6,16,1,10,5,0,16,0
99018,118,90,12,59,17,2,36,35,17,2,28,4,4,2,18,28,0
99019,1972,1568,295,861,363,49,699,661,117,91,404,115,108,119,62,326,78
99020,21,13,13,0,0,0,5,0,0,8,8,0,0,8,0,8,0
99021,3057,2396,361,1429,521,85,963,1090,255,88,661,57,285,216,103,555,106
99022,2440,1879,310,1043,472,54,665,894,242,78,561,148,197,160,56,494,67
99023,127,109,7,47,55,0,33,69,7,0,18,9,0,9,0,9,9
99025,1563,1293,257,820,212,4,637,500,102,54,270,53,128,75,14,202,68
99026,2523,2161,311,1335,464,51,915,1005,179,62,362,16,224,84,38,289,73
99027,2345,1808,279,994,441,94,662,865,204,77,537,76,198,194,69,446,91
99029,505,403,43,225,113,22,128,214,41,20,102,10,28,31,33,100,2
99030,274,201,27,97,45,32,81,89,29,2,73,7,24,22,20,58,15
99031,360,292,22,141,117,12,76,189,22,5,68,2,18,24,24,63,5
99032,296,196,30,90,60,16,62,100,20,14,100,13,29,24,34,90,10
99033,360,246,50,101,62,33,74,128,36,8,114,7,25,43,39,109,5
99034,85,54,4,36,14,0,14,34,3,3,31,0,25,2,4,29,2
99036,363,218,32,126,39,21,78,115,19,6,145,0,120,19,6,135,10
99037,4103,3162,530,1821,649,162,1469,1283,282,128,941,207,265,260,209,761,180
99040,297,234,72,116,37,9,69,41,99,25,63,7,20,21,15,47,16
99101,487,336,54,168,105,9,149,166,19,2,151,13,60,22,56,130,21
99102,225,158,45,72,32,9,60,80,13,5,67,24,28,11,4,56,11
99103,214,151,30,78,32,11,64,66,17,4,63,8,24,8,23,56,7
99105,22,17,5,8,2,2,4,13,0,0,5,0,3,2,0,5,0
99109,1672,1191,180,513,402,96,386,564,174,67,481,53,143,137,148,402,79
99110,486,355,55,166,113,21,95,189,36,35,131,3,50,34,44,110,21
99111,1711,1106,173,521,290,122,386,605,96,19,605,110,167,144,184,559,46
99113,275,196,20,108,47,21,66,106,18,6,79,12,30,25,12,60,19
99114,4778,3340,582,1561,1006,191,1182,1569,370,219,1438,160,487,406,385,1217,221
99115,513,325,26,140,127,32,92,200,19,14,188,30,60,54,44,166,22
99116,701,466,68,191,133,74,99,251,69,47,235,29,92,73,41,208,27
99117,254,173,16,79,63,15,36,117,20,0,81,8,18,34,21,67,14
99118,378,273,45,153,61,14,84,134,43,12,105,12,49,30,14,88,17
99119,465,316,49,134,113,20,77,174,47,18,149,8,63,50,28,130,19
99121,44,27,4,9,14,0,6,19,2,0,17,0,8,6,3,17,0
99122,1326,889,135,399,275,80,322,450,77,40,437,54,120,143,120,360,77
99123,377,288,39,112,104,33,73,166,34,15,89,9,38,30,12,76,13
99124,61,32,4,12,13,3,8,22,0,2,29,2,9,12,6,27,2
99125,241,177,24,88,48,17,62,74,27,14,64,5,24,14,21,60,4
99126,279,219,30,137,43,9,127,66,22,4,60,0,25,14,21,60,0
99128,134,94,7,65,18,4,52,33,3,6,40,0,12,10,18,37,3
99129,254,198,50,76,60,12,61,74,46,17,56,10,2,35,9,49,7
99130,370,260,38,125,72,25,101,130,25,4,110,12,34,32,32,100,10
99131,82,60,6,30,18,6,20,33,3,4,22,3,9,7,3,18,4
99133,713,470,60,230,135,45,102,274,64,30,243,17,78,96,52,205,38
99134,272,171,25,75,51,20,44,97,27,3,101,12,38,20,31,95,6
99135,93,57,7,33,11,6,25,24,6,2,36,6,8,8,14,31,5
99136,20,19,2,4,11,2,2,17,0,0,1,0,1,0,0,1,0
99137,122,94,17,37,30,10,29,46,14,5,28,0,15,7,6,26,2
99138,449,311,61,148,89,13,72,127,85,27,138,14,49,49,26,116,22
99139,491,341,31,165,111,34,93,192,32,24,150,10,39,67,34,139,11
99140,151,107,21,48,30,8,32,37,21,17,44,7,21,11,5,36,8
99141,2091,1526,260,616,548,102,479,839,143,65,565,80,186,183,116,459,106
99143,320,230,29,106,74,21,91,115,15,9,90,8,25,31,26,83,7
99146,13,11,2,1,8,0,3,8,0,0,2,0,2,0,0,2,0
99148,796,582,60,221,265,36,143,334,69,36,214,7,90,77,40,170,44
99149,91,59,10,25,20,4,15,28,10,6,32,0,11,15,6,30,2
99150,99,64,10,32,11,11,23,29,8,4,35,0,19,8,8,28,7
99151,54,38,6,14,16,2,8,20,9,1,16,0,13,2,1,8,8
99152,82,49,13,13,21,2,12,20,14,3,33,0,16,6,11,28,5
99153,200,111,22,61,22,6,38,46,24,3,89,9,33,35,12,79,10
99154,10,10,0,6,4,0,3,7,0,0,0,0,0,0,0,0,0
99155,370,298,72,129,84,13,79,61,96,62,72,8,34,21,9,58,14
99156,2736,1931,280,1001,528,122,547,1053,271,60,805,66,263,326,150,665,140
99157,273,179,17,93,53,16,50,99,21,9,94,11,32,38,13,72,22
99158,260,190,23,88,55,24,74,98,12,6,70,4,17,30,19,66,4
99159,633,469,65,224,118,62,172,243,35,19,164,18,19,75,52,148,16
99160,51,34,6,12,14,2,9,19,4,2,17,0,8,6,3,17,0
99161,608,445,68,237,93,47,143,227,48,27,163,39,41,56,27,134,29
99163,9476,4076,1559,1667,626,224,1630,1796,393,257,5400,4067,754,291,288,2895,2505
99166,1221,832,158,385,230,59,259,425,114,34,389,43,158,133,55,325,64
99167,212,152,23,69,55,5,54,92,6,0,60,2,28,21,9,50,10
99169,1060,703,93,301,229,80,221,368,59,55,357,52,110,105,90,328,29
99170,452,346,46,168,92,40,115,176,30,25,106,11,22,47,26,100,6
99171,457,321,35,136,91,59,113,168,20,20,136,13,37,50,36,119,17
99173,467,354,46,156,142,10,106,180,43,25,113,7,37,47,22,89,24
99176,83,67,8,41,15,3,27,27,9,4,16,3,2,5,6,12,4
99179,202,147,22,72,33,20,53,72,15,7,55,9,20,17,9,48,7
99180,313,227,17,114,78,18,58,133,23,13,86,8,40,31,7,68,18
99181,709,519,97,267,130,25,189,234,73,23,190,22,80,60,28,160,30
99185,581,427,66,168,143,50,156,234,28,9,154,9,31,76,38,140,14
99201,5183,1919,629,851,331,108,550,659,477,233,3264,733,1270,883,378,2778,486
99202,7565,3955,1285,1779,637,254,1114,1306,1075,460,3610,1070,1148,697,695,2855,755
99203,9196,5773,1099,2736,1266,672,2030,2808,581,354,3423,545,967,916,995,2926,497
99204,5585,1810,768,702,227,113,367,700,573,170,3775,1518,1339,559,359,3177,598
99205,17961,11409,2931,5069,2372,1037,3566,4601,2064,1178,6552,1611,2049,1579,1313,5330,1222
99206,12543,8470,1790,4174,1851,655,2991,3438,1498,543,4073,1048,1347,941,737,3360,713
99207,15510,9250,3186,4010,1404,650,2874,2845,2441,1090,6260,1717,2000,1238,1305,4918,1342
99208,13699,9539,1580,4688,2511,760,3476,4640,792,631,4160,1092,1126,1000,942,3488,672
99212,8024,5060,992,2358,1280,430,1425,2441,755,439,2964,589,1104,696,575,2511,453
99216,8774,5961,1442,2812,1246,461,1957,2469,1016,519,2813,734,869,571,639,2343,470
99217,4108,2967,743,1486,635,103,1139,1235,392,201,1141,337,404,238,162,839,302
99218,4679,3338,636,1559,908,235,1173,1510,408,247,1341,402,383,305,251,1063,278
99223,9844,7012,1158,4065,1366,423,3149,2919,700,244,2832,652,796,748,636,2324,508
99224,5633,3811,793,1796,927,295,1257,1971,382,201,1822,514,685,419,204,1413,409
99301,12554,9790,2828,4487,1892,583,3965,3432,1531,862,2764,491,889,901,483,2283,481
99320,2803,2239,413,1167,572,87,842,953,306,138,564,74,263,146,81,454,110
99321,145,137,79,38,20,0,83,31,16,7,8,0,0,0,8,8,0
99322,89,73,12,43,14,4,43,25,5,0,16,0,10,6,0,16,0
99323,1176,1003,187,544,253,19,431,453,81,38,173,28,74,51,20,155,18
99324,3110,2015,463,817,457,278,666,916,212,221,1095,394,221,225,255,886,209
99326,991,790,192,387,173,38,353,283,104,50,201,46,45,61,49,162,39
99328,1557,1043,184,460,303,96,323,542,125,53,514,52,125,177,160,463,51
99329,91,69,5,32,26,6,18,45,2,4,22,4,6,2,10,20,2
99330,236,172,18,108,46,0,70,93,0,9,64,10,13,35,6,54,10
99332,22,14,8,6,0,0,9,0,2,3,8,0,6,2,0,8,0
99335,129,91,12,57,19,3,31,38,18,4,38,2,24,10,2,32,6
99336,15825,10173,3107,4615,1823,628,3781,3577,2085,730,5652,1555,1940,1330,827,4646,1006
99337,8866,7052,1275,3706,1680,391,2781,3041,840,390,1814,222,657,569,366,1459,355
99338,2599,2252,236,1390,592,34,1091,993,116,52,347,49,167,87,44,267,80
99341,362,283,44,146,65,28,101,134,33,15,79,8,21,25,25,69,10
99343,773,700,200,353,119,28,410,188,62,40,73,9,34,30,0,59,14
99344,4038,3389,957,1514,752,166,1607,1100,449,233,649,129,185,213,122,559,90
99345,66,52,5,43,4,0,42,5,3,2,14,2,8,4,0,9,5
99346,107,82,15,28,17,22,25,37,11,9,25,6,11,8,0,14,11
99347,1044,724,93,329,206,96,218,386,79,41,320,42,103,81,94,287,33
99348,491,420,152,187,64,17,229,128,49,14,71,17,25,26,3,67,4
99349,1302,1142,421,443,251,27,563,356,131,92,160,57,40,50,13,110,50
99350,3616,2891,640,1428,680,143,1311,1094,323,163,725,63,306,154,202,642,83
99352,15479,10638,1895,5168,2825,750,4001,4768,1280,589,4841,1017,1814,1151,859,4208,633
99353,3251,2538,610,1427,432,69,1235,952,229,122,713,151,307,167,88,573,140
99356,66,54,18,23,11,2,33,18,2,1,12,1,8,2,1,12,0
99357,1031,830,306,408,105,11,539,169,105,17,201,52,75,30,44,156,45
99359,33,17,0,3,12,2,2,14,0,1,16,4,3,7,2,16,0
99360,410,324,62,173,75,14,130,151,34,9,86,19,22,24,21,71,15
99361,742,527,69,284,124,50,224,225,46,32,215,22,48,88,57,193,22
99362,13623,8975,1576,4310,2174,915,3128,4071,1199,577,4648,1047,1082,1119,1400,3926,722
99363,87,79,24,13,23,19,15,38,7,19,8,0,8,0,0,8,0
99371,174,118,11,50,45,12,40,63,9,6,56,7,20,21,8,52,4
99401,83,56,5,22,29,0,20,36,0,0,27,8,12,3,4,19,8
99402,650,514,68,258,158,30,149,241,82,42,136,18,50,47,21,110,26
99403,7619,5098,1246,2129,1303,420,1488,2330,941,339,2521,364,825,730,602,2135,386
99501,7304,3090,866,1420,606,198,805,1091,814,380,4214,1092,1633,983,506,3365,849
99502,6597,4877,1179,2800,805,93,1908,1754,934,281,1720,521,844,300,55,1140,580
99503,6100,2940,855,1492,501,92,931,942,662,405,3160,1125,1298,623,114,2347,813
99504,13561,9512,2633,5044,1647,188,3621,3480,1676,735,4049,1126,1683,939,301,2914,1135
99505,1220,1141,828,313,0,0,852,217,66,6,79,56,23,0,0,67,12
99506,1602,1562,1019,543,0,0,1254,242,66,0,40,28,12,0,0,40,0
99507,10175,6955,2262,3824,794,75,3049,1996,1313,597,3220,1304,1382,478,56,2343,877
99508,12400,7910,2317,3753,1616,224,2556,2495,2003,856,4490,1345,2090,814,241,3284,1206
99513,0,0,0,0,0,0,0,0,0,0,0,0,0,0,0,0,0
99515,7470,5707,1225,3352,1020,110,2522,2065,766,354,1763,458,902,327,76,1276,487
99516,7209,6112,452,4308,1277,75,3099,2449,387,177,1097,179,656,196,66,760,337
99517,6791,4095,946,2151,831,167,1496,1562,780,257,2696,763,1384,455,94,1969,727
99518,3801,2344,651,1227,422,44,930,852,348,214,1457,430,680,324,23,1036,421
99540,107,53,0,46,0,7,14,22,8,9,54,0,35,19,0,46,8
99546,156,60,23,34,3,0,23,24,8,5,96,39,47,10,0,77,19
99547,31,17,0,10,5,2,4,7,4,2,14,0,10,2,2,13,1
99548,37,33,8,13,12,0,15,10,6,2,4,2,2,0,0,4,0
99549,37,16,0,12,4,0,12,4,0,0,21,4,13,4,0,19,2
99550,91,79,4,55,13,7,39,34,6,0,12,5,1,6,0,10,2
99551,132,117,29,61,25,2,74,12,20,11,15,3,5,7,0,15,0
99552,72,52,9,25,16,2,20,6,8,18,20,7,7,4,2,17,3
99553,30,15,0,14,0,1,7,6,0,2,15,4,9,0,2,12,3
99554,144,126,28,48,37,13,64,19,26,17,18,3,2,13,0,13,5
99555,69,46,7,28,9,2,15,8,14,9,23,9,2,12,0,14,9
99556,897,597,104,340,119,34,254,247,72,24,300,31,155,92,22,229,71
99557,242,184,28,115,34,7,73,40,54,17,58,5,28,25,0,50,8
99558,38,30,7,15,4,4,9,7,10,4,8,1,7,0,0,6,2
99559,2053,1429,278,804,252,95,628,287,312,202,624,196,298,115,15,477,147
99561,68,61,5,36,10,10,43,8,1,9,7,0,7,0,0,7,0
99563,164,133,35,62,28,8,61,6,54,12,31,9,18,4,0,29,2
99564,35,22,0,15,7,0,7,13,2,0,13,4,3,6,0,10,3
99565,32,23,0,21,0,2,18,3,2,0,9,4,5,0,0,9,0
99566,64,34,7,16,11,0,14,16,4,0,30,3,12,13,2,28,2
99567,2592,2061,271,1379,371,40,951,873,152,85,531,93,317,108,13,386,145
99568,105,65,9,34,20,2,24,29,10,2,40,6,15,12,7,35,5
99569,31,20,2,10,6,2,7,6,0,7,11,0,9,0,2,5,6
99571,69,33,6,18,9,0,17,16,0,0,36,9,18,9,0,28,8
99572,149,83,0,30,53,0,11,38,12,22,66,8,29,13,16,60,6
99573,460,306,36,188,72,10,133,106,53,14,154,18,72,56,8,136,18
99574,987,628,93,380,137,18,270,245,87,26,359,87,177,58,37,298,61
99575,44,32,9,14,6,3,14,0,10,8,12,0,6,2,4,12,0
99576,961,660,152,368,112,28,272,189,140,59,301,48,161,80,12,260,41
99577,7311,6072,1204,4015,820,33,2982,2274,631,185,1239,292,523,367,57,877,362
99578,76,52,10,30,11,1,20,15,10,7,24,3,10,11,0,24,0
99579,40,23,2,13,8,0,7,7,7,2,17,5,9,3,0,11,6
99580,36,24,11,6,6,1,11,9,2,2,12,0,5,7,0,12,0
99581,182,140,32,64,36,8,71,16,33,20,42,4,27,11,0,36,6
99583,25,18,3,9,4,2,8,2,2,6,7,0,3,2,2,7,0
99585,87,72,24,29,17,2,42,7,5,18,15,3,8,4,0,10,5
99586,258,155,17,104,29,5,43,74,23,15,103,9,50,31,13,87,16
99587,837,402,99,249,42,12,178,168,40,16,435,207,202,20,6,267,168
99588,437,297,58,154,76,9,113,129,41,14,140,32,63,33,12,110,30
99589,70,45,11,23,7,4,10,0,24,11,25,2,14,9,0,25,0
99590,45,29,9,15,5,0,7,5,10,7,16,4,6,4,2,12,4
99591,53,41,11,26,4,0,20,8,4,9,12,4,8,0,0,9,3
99602,66,48,8,18,16,6,23,6,7,12,18,4,8,6,0,14,4
99603,3267,2134,375,1227,447,85,909,856,298,71,1133,225,580,254,74,901,232
99604,238,190,30,88,54,18,63,22,71,34,48,7,33,8,0,44,4
99605,59,31,0,17,14,0,17,14,0,0,28,0,14,14,0,28,0
99606,133,107,19,56,28,4,34,26,29,18,26,9,3,8,6,22,4
99607,62,49,12,23,9,5,10,6,27,6,13,0,7,6,0,11,2
99608,12,8,5,0,3,0,0,0,5,3,4,2,2,0,0,4,0
99609,100,90,14,41,23,12,65,12,8,5,10,0,4,3,3,10,0
99610,617,440,45,288,99,8,178,194,50,18,177,40,83,40,14,152,25
99611,4316,3045,609,1790,557,89,1277,1102,530,136,1271,338,566,291,76,1045,226
99612,165,123,33,57,29,4,43,34,39,7,42,9,21,12,0,36,6
99613,206,113,22,65,24,2,49,49,15,0,93,14,68,9,2,86,7
99614,143,130,30,67,30,3,68,22,23,17,13,0,6,5,2,11,2
99615,4134,3096,842,1740,461,53,1585,963,417,131,1038,305,464,209,60,811,227
99620,122,103,24,60,15,4,67,11,15,10,19,4,3,5,7,17,2
99621,149,130,40,65,20,5,84,13,16,17,19,4,11,4,0,12,7
99622,66,59,10,30,12,7,33,13,11,2,7,0,7,0,0,3,4
99624,36,22,13,5,2,2,14,4,2,2,14,0,13,1,0,12,2
99625,46,24,9,7,8,0,7,6,7,4,22,2,12,5,3,22,0
99626,69,60,11,34,9,6,25,10,12,13,9,6,1,2,0,8,1
99627,150,104,12,54,38,0,48,26,22,8,46,8,27,6,5,42,4
99628,91,80,17,35,21,7,47,18,5,10,11,0,11,0,0,9,2
99630,72,51,2,25,22,2,22,17,0,12,21,5,10,6,0,21,0
99631,79,58,0,36,15,7,29,29,0,0,21,14,7,0,0,7,14
99632,178,142,32,76,25,9,60,16,50,16,36,5,20,9,2,30,6
99633,239,160,23,118,19,0,92,42,20,6,79,14,41,16,8,63,16
99634,89,74,24,19,25,6,38,9,11,16,15,1,10,0,4,12,3
99635,362,242,55,127,52,8,81,116,27,18,120,6,48,60,6,85,35
99636,105,89,20,35,25,9,49,9,12,19,16,1,7,8,0,15,1
99637,107,93,24,31,35,3,54,12,17,10,14,5,5,4,0,12,2
99638,18,17,2,9,4,2,5,6,4,2,1,0,0,1,0,1,0
99639,410,287,30,159,81,17,101,150,21,15,123,15,68,25,15,83,40
99640,73,51,12,17,18,4,22,5,12,12,22,3,10,5,4,19,3
99641,102,89,21,42,19,7,57,10,12,10,13,0,5,8,0,13,0
99643,70,52,12,34,5,1,23,1,21,7,18,6,5,7,0,16,2
99644,77,51,7,30,13,1,14,17,14,6,26,5,6,10,5,19,7
99645,6242,4754,908,2797,909,140,2192,1689,586,287,1488,262,695,400,131,1163,325
99647,19,15,0,12,3,0,6,3,6,0,4,0,4,0,0,1,3
99648,29,19,7,10,2,0,13,2,4,0,10,2,5,3,0,7,3
99649,35,27,0,22,5,0,13,8,6,0,8,2,5,1,0,3,5
99650,104,91,20,41,25,5,46,13,18,14,13,4,6,1,2,11,2
99651,19,12,1,3,8,0,4,2,6,0,7,3,2,2,0,7,0
99652,1267,864,166,493,184,21,345,341,123,55,403,48,215,109,31,295,108
99653,51,41,8,24,9,0,13,25,3,0,10,4,2,4,0,10,0
99654,10614,7992,1785,4705,1329,173,3636,2838,1266,252,2622,567,1369,533,153,1964,658
99655,137,114,18,52,42,2,48,21,23,22,23,6,11,6,0,17,6
99656,17,9,0,3,5,1,0,4,5,0,8,4,4,0,0,8,0
99657,78,68,21,22,20,5,23,10,21,14,10,8,2,0,0,8,2
99658,171,118,45,45,21,7,51,25,28,14,53,11,22,19,1,43,10
99659,95,66,28,24,13,1,45,5,15,1,29,5,16,5,3,17,12
99660,179,125,15,83,24,3,46,28,19,32,54,11,24,11,8,42,12
99661,233,156,37,77,34,8,42,59,48,7,77,23,42,12,0,61,16
99662,100,86,28,31,15,12,41,10,19,16,14,4,7,3,0,11,3
99663,298,185,26,98,56,5,66,82,17,20,113,14,48,45,6,87,26
99664,1724,1085,200,651,222,12,455,370,194,66,639,137,316,157,29,490,149
99665,38,34,9,18,5,2,12,2,11,9,4,2,2,0,0,4,0
99666,38,34,5,19,10,0,9,2,17,6,4,0,2,2,0,4,0
99667,61,29,6,19,0,4,13,12,0,4,32,6,20,6,0,32,0
99668,30,19,4,6,9,0,2,5,5,7,11,0,5,6,0,11,0
99669,5214,3749,717,2114,857,61,1425,1594,488,242,1465,287,700,336,142,1205,260
99670,47,31,2,17,11,1,6,12,7,6,16,6,3,7,0,6,10
99671,121,104,34,53,16,1,41,11,31,21,17,6,11,0,0,14,3
99672,830,685,118,378,140,49,285,293,78,29,145,27,68,50,0,115,30
99674,360,245,16,171,51,7,92,110,21,22,115,5,63,29,18,99,16
99675,19,10,2,2,6,0,1,3,3,3,9,0,4,5,0,9,0
99676,625,378,41,233,88,16,155,143,47,33,247,24,160,45,18,185,62
99677,33,28,4,16,8,0,6,9,7,6,5,4,1,0,0,5,0
99678,213,166,37,89,27,13,83,24,35,24,47,14,25,6,2,43,4
99679,90,80,8,39,24,9,46,12,4,18,10,0,4,5,1,10,0
99680,78,66,16,31,13,6,29,14,15,8,12,0,7,5,0,10,2
99681,78,54,2,29,16,7,24,3,11,16,24,4,19,1,0,22,2
99682,82,47,13,22,9,3,8,7,23,9,35,3,15,14,3,35,0
99683,211,119,27,64,28,0,32,57,25,5,92,7,50,29,6,92,0
99684,232,184,44,80,45,15,65,38,55,26,48,3,24,17,4,46,2
99685,218,148,58,79,9,2,93,37,11,7,70,10,48,11,1,53,17
99686,1503,1045,228,655,150,12,488,366,142,49,458,101,250,86,21,334,124
99687,78,41,0,27,8,6,0,28,7,6,37,0,32,5,0,37,0
99688,836,552,58,301,168,25,157,290,76,29,284,35,138,102,9,240,44
99689,261,161,31,99,27,4,50,54,40,17,100,19,62,16,3,79,21
99690,54,42,11,17,12,2,26,2,4,10,12,7,4,1,0,5,7
99691,40,21,0,8,8,5,5,7,4,5,19,3,4,9,3,19,0
99692,619,344,81,236,27,0,175,105,45,19,275,68,140,65,2,213,62
99693,94,53,8,35,10,0,16,21,11,5,41,9,26,4,2,35,6
99694,208,152,30,85,33,4,51,70,22,9,56,13,28,15,0,43,13
99695,14,7,0,3,4,0,3,4,0,0,7,2,0,5,0,5,2
99697,11,3,0,3,0,0,3,0,0,0,8,2,5,1,0,6,2
99701,7129,4108,1178,2047,684,199,1363,1403,1004,338,3021,929,1119,669,304,2406,615
99702,1443,1423,969,454,0,0,1083,240,100,0,20,11,9,0,0,20,0
99703,1818,1777,1436,341,0,0,1242,426,101,8,41,13,28,0,0,41,0
99704,58,30,2,12,16,0,11,13,0,6,28,8,15,5,0,15,13
99705,5654,4330,1037,2642,606,45,1931,1605,535,259,1324,494,564,191,75,978,346
99709,9760,6086,1333,3520,1127,106,2431,2356,1003,296,3674,1490,1459,609,116,2758,916
99712,3341,2508,335,1745,376,52,1224,930,221,133,833,177,446,182,28,633,200
99714,424,280,26,158,81,15,62,188,21,9,144,43,93,8,0,108,36
99720,66,37,8,18,11,0,21,7,7,2,29,12,7,8,2,25,4
99721,82,63,6,34,23,0,23,14,15,11,19,1,18,0,0,16,3
99722,45,26,11,15,0,0,7,2,15,2,19,3,14,2,0,14,5
99723,1376,947,235,534,149,29,393,168,249,137,429,108,240,75,6,323,106
99724,38,25,2,19,2,2,9,1,10,5,13,11,0,2,0,7,6
99725,74,36,0,36,0,0,13,18,5,0,38,23,15,0,0,23,15
99726,33,19,4,15,0,0,13,3,1,2,14,5,6,3,0,9,5
99727,84,76,22,38,12,4,42,15,14,5,8,0,6,2,0,6,2
99729,120,80,4,50,20,6,23,36,15,6,40,12,21,7,0,30,10
99730,65,38,4,22,9,3,11,23,2,2,27,2,17,8,0,22,5
99732,5,0,0,0,0,0,0,0,0,0,5,0,2,2,1,5,0
99733,24,14,1,10,3,0,1,2,3,8,10,0,2,8,0,10,0
99736,42,27,8,11,4,4,7,4,6,10,15,3,8,4,0,13,2
99737,1227,914,195,502,202,15,421,355,91,47,313,43,143,103,24,262,51
99738,102,51,11,29,11,0,12,25,6,8,51,3,31,17,0,41,10
99739,93,75,13,40,11,11,45,9,7,14,18,5,7,4,2,15,3
99740,258,156,33,85,30,8,37,26,51,42,102,6,61,28,7,95,7
99741,223,155,34,81,38,2,83,40,23,9,68,21,34,13,0,60,8
99742,151,111,24,45,37,5,49,16,24,22,40,9,23,6,2,36,4
99743,425,239,23,179,35,2,110,82,35,12,186,35,127,22,2,167,19
99744,90,64,10,34,20,0,24,23,11,6,26,9,8,9,0,21,5
99745,27,19,3,9,5,2,5,7,7,0,8,2,5,1,0,8,0
99746,94,70,15,37,9,9,18,20,29,3,24,4,16,3,1,21,3
99747,90,71,18,29,22,2,25,15,15,16,19,2,13,2,2,19,0
99748,70,57,12,28,13,4,17,6,24,10,13,0,7,6,0,11,2
99749,89,72,9,47,14,2,26,12,18,16,17,5,8,4,0,15,2
99750,78,63,16,28,12,7,44,9,8,2,15,1,9,5,0,15,0
99751,29,25,10,10,1,4,4,3,13,5,4,2,2,0,0,4,0
99752,887,653,195,317,107,34,246,140,194,73,234,58,132,41,3,171,63
99753,76,58,17,26,15,0,12,10,32,4,18,8,5,4,1,17,1
99754,41,24,11,5,6,2,9,4,5,6,17,3,10,2,2,17,0
99755,97,43,9,29,5,0,11,29,3,0,54,16,36,2,0,43,11
99756,45,17,6,5,4,2,5,9,3,0,28,5,10,13,0,22,6
99757,16,8,2,4,2,0,2,6,0,0,8,0,4,4,0,6,2
99758,74,44,6,21,6,11,12,7,7,18,30,0,17,4,9,28,2
99759,63,44,15,22,7,0,20,9,13,2,19,7,2,10,0,17,2
99760,304,195,30,117,43,5,73,78,26,18,109,18,37,39,15,92,17
99761,102,92,20,46,21,5,50,10,23,9,10,3,7,0,0,7,3
99762,1306,834,156,481,173,24,336,234,179,85,472,106,245,88,33,364,108
99763,141,117,27,45,40,5,60,21,14,22,24,4,15,5,0,24,0
99764,110,76,14,46,16,0,29,16,23,8,34,4,11,15,4,20,14
99765,87,66,10,36,16,4,23,9,22,12,21,1,14,6,0,14,7
99766,186,158,32,84,31,11,61,36,39,22,28,12,11,5,0,19,9
99767,19,11,5,0,6,0,0,4,7,0,8,1,2,5,0,7,1
99768,64,42,11,27,2,2,13,8,21,0,22,2,8,12,0,16,6
99769,151,123,22,53,39,9,70,8,20,25,28,7,14,7,0,18,10
99770,173,153,46,75,21,11,56,12,69,16,20,0,18,2,0,20,0
99771,57,46,3,31,6,6,23,11,4,8,11,6,5,0,0,7,4
99772,146,117,29,51,28,9,25,11,46,35,29,4,14,6,5,27,2
99773,64,60,15,29,8,8,20,18,22,0,4,0,2,2,0,4,0
99774,36,15,4,7,2,2,0,0,8,7,21,0,7,12,2,21,0
99775,113,94,65,29,0,0,41,18,35,0,19,0,19,0,0,19,0
99776,45,31,3,15,9,4,8,8,6,9,14,0,8,6,0,14,0
99777,119,67,10,41,16,0,24,8,23,12,52,6,35,2,9,45,7
99778,72,56,7,29,19,1,12,22,21,1,16,0,8,8,0,13,3
99779,33,20,2,12,4,2,4,3,6,7,13,1,8,2,2,13,0
99780,539,376,67,203,91,15,150,140,69,17,163,33,78,27,25,132,31
99781,66,50,12,24,12,2,18,4,14,14,16,9,2,5,0,10,6
99782,150,117,30,56,25,6,52,23,24,18,33,2,16,15,0,30,3
99783,52,29,8,18,3,0,14,7,8,0,23,2,11,10,0,23,0
99784,64,49,9,19,15,6,12,4,25,8,15,4,6,2,3,15,0
99785,70,60,16,36,7,1,7,5,34,14,10,0,8,2,0,8,2
99786,72,58,15,30,11,2,22,13,21,2,14,4,4,2,4,12,2
99788,31,11,4,2,5,0,4,5,2,0,20,0,9,8,3,16,4
99789,113,93,28,38,23,4,29,18,30,16,20,2,8,8,2,20,0
99791,51,40,14,18,8,0,11,10,15,4,11,2,6,3,0,11,0
99801,10598,7263,1415,4243,1378,227,2868,2867,1094,434,3335,932,1541,596,266,2473,862
99820,193,148,34,64,42,8,54,37,24,33,45,4,23,18,0,41,4
99824,936,491,126,281,63,21,160,170,91,70,445,135,200,56,54,340,105
99825,33,21,0,11,3,7,6,8,0,7,12,0,7,5,0,10,2
99826,205,114,18,72,24,0,43,56,6,9,91,14,49,28,0,78,13
99827,1011,674,79,411,150,34,238,298,93,45,337,60,152,85,40,269,68
99829,330,242,36,121,78,7,84,99,39,20,88,12,45,23,8,72,16
99830,254,182,43,101,35,3,76,66,37,3,72,19,26,16,11,59,13
99832,79,42,7,21,12,2,11,22,7,2,37,8,18,5,6,27,10
99833,1352,931,153,551,169,58,374,369,134,54,421,102,177,91,51,354,67
99835,3247,2227,408,1236,502,81,870,894,290,173,1020,330,329,265,96,791,229
99840,398,207,37,107,50,13,68,105,25,9,191,47,92,38,14,148,43
99841,46,22,0,18,4,0,10,8,4,0,24,2,11,9,2,22,2
99850,12,4,0,0,0,4,0,4,0,0,8,2,4,2,0,8,0
99901,5378,3637,756,1986,763,132,1421,1372,589,255,1741,380,774,452,135,1397,344
99903,8,8,2,2,4,0,2,6,0,0,0,0,0,0,0,0,0
99918,75,48,13,20,15,0,23,22,0,3,27,7,14,6,0,17,10
99919,229,175,30,112,30,3,69,88,9,9,54,10,28,14,2,46,8
99921,705,476,113,268,91,4,199,161,96,20,229,30,144,55,0,173,56
99922,133,98,21,56,19,2,31,31,27,9,35,5,10,17,3,35,0
99923,48,18,4,14,0,0,8,5,5,0,30,0,13,17,0,25,5
99925,347,243,56,116,66,5,98,93,37,15,104,23,55,19,7,89,15
99926,489,355,78,179,83,15,133,120,60,42,134,40,58,19,17,114,20
99927,72,35,0,28,4,3,10,13,6,6,37,3,20,9,5,31,6
99929,968,661,94,371,156,40,255,289,91,26,307,39,110,112,46,260,47
99950,21,11,6,5,0,0,5,6,0,0,10,10,0,0,0,10,0
